step,susceptible_status,infected_status,filtermeanvirulence_pathogen,susceptible_status_is_minority,infected_status_is_minority,filtermeanvirulence_pathogen_is_minority,susceptible_status_#84_f=is_minority,infected_status_#84_f=is_minority,filtermeanvirulence_pathogen_#84_f=is_minority,ensemble,mutation_rate,virulence_init,total_infected,total_minority_infected,total_majority_infected
5000,2684,3106,0.09999999999999994,1093,1286,0.10000000000000003,1591,1820,0.09999999999999984,1,0.0,0.1,7754,3156,4598
5000,1006,682,0.3000000000000003,366,268,0.2999999999999998,640,414,0.2999999999999998,2,0.0,0.3,9511,3814,5697
5000,3123,674,0.5,1212,249,0.5,1911,425,0.5,3,0.0,0.5,7428,2876,4552
5000,9894,39,0.6999999999999998,4007,14,0.7,5887,25,0.6999999999999998,4,0.0,0.7,628,237,391
1293,2974,0,0.0,1205,0,0.0,1769,0,0.0,5,0.0,0.9,69,21,48
5000,3728,1693,0.14092726566520905,1514,668,0.13590100996484133,2214,1025,0.14420291328261944,6,0.8,0.1,6604,2628,3976
5000,4404,1676,0.1560589453622651,1774,675,0.15551503210782522,2630,1001,0.15642572003434005,7,0.8,0.3,6222,2530,3692
5000,3955,1750,0.1498878336110553,1588,724,0.15091048780233132,2367,1026,0.14916619459109043,8,0.8,0.5,6577,2687,3890
1142,2680,0,0.0,1102,0,0.0,1578,0,0.0,9,0.8,0.7,98,35,63
5000,10026,124,0.20806701961858434,4075,48,0.17605197846030476,5951,76,0.22828704561328722,10,0.8,0.9,495,198,297
5000,1785,2779,0.09999999999999999,697,1068,0.10000000000000006,1088,1711,0.09999999999999991,11,0.0,0.1,8695,3449,5246
5000,983,639,0.3000000000000004,369,250,0.2999999999999999,614,389,0.2999999999999999,12,0.0,0.3,9409,3826,5583
5000,2879,704,0.5,1127,279,0.5,1752,425,0.5,13,0.0,0.5,7610,3106,4504
3284,6856,0,0.0,2682,0,0.0,4174,0,0.0,14,0.0,0.7,292,115,177
1599,3633,0,0.0,1424,0,0.0,2209,0,0.0,15,0.0,0.9,100,48,52
5000,3146,1910,0.13576869764917665,1248,748,0.13599091811080555,1898,1162,0.13562565039848948,16,0.8,0.1,7375,2901,4474
5000,3038,1801,0.13804804118975267,1197,738,0.14314299583139667,1841,1063,0.13451081021559155,17,0.8,0.3,7451,2990,4461
5000,4570,1720,0.16517501570166512,1785,727,0.1640402754679012,2785,993,0.16600578725246712,18,0.8,0.5,5602,2263,3339
5000,8582,529,0.22583209700060192,3428,225,0.22472748214328145,5154,304,0.2266496573390792,19,0.8,0.7,1935,768,1167
671,1771,0,0.0,715,0,0.0,1056,0,0.0,20,0.8,0.9,54,27,27
5000,1759,2743,0.09999999999999994,641,1103,0.10000000000000006,1118,1640,0.09999999999999995,21,0.0,0.1,8638,3497,5141
5000,937,650,0.3000000000000003,361,252,0.2999999999999999,576,398,0.2999999999999998,22,0.0,0.3,9486,3828,5658
5000,3066,754,0.5,1246,297,0.5,1820,457,0.5,23,0.0,0.5,7357,2955,4402
3610,7552,0,0.0,3018,0,0.0,4534,0,0.0,24,0.0,0.7,241,93,148
1066,2541,0,0.0,1030,0,0.0,1511,0,0.0,25,0.0,0.9,86,33,53
5000,2573,1873,0.1336621466763592,1060,770,0.1266446131793486,1513,1103,0.13856105945305744,26,0.8,0.1,8035,3205,4830
5000,2216,1666,0.12635399968768812,905,677,0.12329800355713882,1311,989,0.12844592019363543,27,0.8,0.3,8155,3274,4881
5000,3724,1736,0.13824635616336145,1482,709,0.13717944455633335,2242,1027,0.13898290955127077,28,0.8,0.5,6672,2687,3985
5000,4302,1681,0.16259946203623116,1691,643,0.1655237717791005,2611,1038,0.16078796765794115,29,0.8,0.7,6046,2455,3591
1029,2455,0,0.0,987,0,0.0,1468,0,0.0,30,0.8,0.9,81,36,45
5000,1904,3030,0.09999999999999996,750,1244,0.10000000000000007,1154,1786,0.09999999999999987,31,0.0,0.1,8586,3479,5107
5000,963,689,0.30000000000000043,377,276,0.29999999999999993,586,413,0.2999999999999998,32,0.0,0.3,9522,3895,5627
5000,1570,556,0.5,616,228,0.5,954,328,0.5,33,0.0,0.5,8859,3571,5288
2155,4605,0,0.0,1893,0,0.0,2712,0,0.0,34,0.0,0.7,191,74,117
1644,3427,0,0.0,1360,0,0.0,2067,0,0.0,35,0.0,0.9,199,88,111
5000,2736,1961,0.13049031574515854,1086,770,0.1283887507880288,1650,1191,0.131849010133899,36,0.8,0.1,7819,3146,4673
5000,2106,1764,0.11307732115524238,832,726,0.11251093228907398,1274,1038,0.11347346596915206,37,0.8,0.3,8359,3357,5002
5000,3712,1793,0.16040828763852308,1430,697,0.15545249677165277,2282,1096,0.16355991741426062,38,0.8,0.5,6596,2655,3941
5000,6057,1358,0.1899427902918977,2417,571,0.19276573974429353,3640,787,0.18789462747446686,39,0.8,0.7,4449,1830,2619
5000,7951,714,0.2191322932488311,3159,323,0.21902094443698505,4792,391,0.21922427704992126,40,0.8,0.9,2539,1040,1499
5000,2191,2922,0.09999999999999994,828,1158,0.10000000000000005,1363,1764,0.09999999999999994,41,0.0,0.1,8183,3329,4854
5000,905,658,0.3000000000000002,383,264,0.2999999999999998,522,394,0.2999999999999998,42,0.0,0.3,9717,3819,5898
5000,1522,520,0.5,615,170,0.5,907,350,0.5,43,0.0,0.5,8992,3574,5418
2750,5721,0,0.0,2326,0,0.0,3395,0,0.0,44,0.0,0.7,244,98,146
766,1929,0,0.0,756,0,0.0,1173,0,0.0,45,0.0,0.9,35,14,21
5000,3884,1926,0.1444081293728933,1543,764,0.14076808489500092,2341,1162,0.14680141162858154,46,0.8,0.1,6570,2616,3954
5000,3154,1729,0.14259444846423774,1308,674,0.14931677209031366,1846,1055,0.13829980758843194,47,0.8,0.3,7310,2833,4477
5000,5071,1700,0.165347133702597,2026,684,0.1636501782801769,3045,1016,0.1664895721956436,48,0.8,0.5,5468,2182,3286
5000,2513,1716,0.12152736151537769,1011,686,0.1181408391607123,1502,1030,0.12378285116130047,49,0.8,0.7,7999,3195,4804
5000,4095,1522,0.16603719274934597,1620,599,0.1730761962767517,2475,923,0.16146908536807184,50,0.8,0.9,6312,2510,3802
5000,2276,3129,0.09999999999999988,955,1274,0.10000000000000009,1321,1855,0.09999999999999985,51,0.0,0.1,8191,3281,4910
5000,992,633,0.30000000000000027,399,260,0.2999999999999999,593,373,0.2999999999999999,52,0.0,0.3,9332,3681,5651
5000,2360,704,0.5,975,282,0.5,1385,422,0.5,53,0.0,0.5,8091,3205,4886
5000,9999,26,0.6999999999999998,4035,16,0.6999999999999998,5964,10,0.7000000000000001,54,0.0,0.7,814,330,484
726,1897,0,0.0,748,0,0.0,1149,0,0.0,55,0.0,0.9,49,16,33
5000,3032,1836,0.14489552179947315,1233,711,0.1403487162494232,1799,1125,0.1477691029071046,56,0.8,0.1,7468,3034,4434
5000,2619,1705,0.13191553355980432,1104,651,0.1332820018458814,1515,1054,0.13107153844193312,57,0.8,0.3,7911,3173,4738
5000,2654,1756,0.1290641278816759,1089,702,0.12263175886524794,1565,1054,0.13334830534802547,58,0.8,0.5,7911,3199,4712
5000,6400,1302,0.18118782073275685,2578,489,0.19234137732993448,3822,813,0.17447922396028473,59,0.8,0.7,4031,1598,2433
5000,9377,357,0.20809813524899662,3758,134,0.20142785150335357,5619,223,0.21210628781364313,60,0.8,0.9,1237,484,753
5000,1756,2743,0.09999999999999994,662,1114,0.10000000000000007,1094,1629,0.09999999999999988,61,0.0,0.1,8790,3485,5305
5000,834,684,0.3000000000000004,321,289,0.2999999999999998,513,395,0.2999999999999998,62,0.0,0.3,9602,3892,5710
5000,1476,472,0.5,590,185,0.5,886,287,0.5,63,0.0,0.5,9019,3616,5403
2351,4927,0,0.0,2000,0,0.0,2927,0,0.0,64,0.0,0.7,234,101,133
1323,2962,0,0.0,1146,0,0.0,1816,0,0.0,65,0.0,0.9,161,65,96
5000,3206,2084,0.13955733097680997,1331,855,0.1323676506301396,1875,1229,0.14455910208861072,66,0.8,0.1,7200,2889,4311
5000,2510,1814,0.13287818285676242,1013,731,0.13201774105291306,1497,1083,0.1334589612118999,67,0.8,0.3,8056,3264,4792
5000,6535,1157,0.17088110121446876,2571,461,0.16632017092810744,3964,696,0.17390206222310747,68,0.8,0.5,3966,1593,2373
5000,7222,1113,0.20917836345577084,2895,417,0.20555318710148615,4327,696,0.21135034411631218,69,0.8,0.7,3365,1309,2056
5000,9681,367,0.16242850142753237,3916,151,0.1539958175065843,5765,216,0.16832357213152857,70,0.8,0.9,925,354,571
5000,1829,2861,0.09999999999999992,705,1116,0.10000000000000007,1124,1745,0.09999999999999991,71,0.0,0.1,8655,3390,5265
5000,905,661,0.30000000000000027,347,254,0.2999999999999998,558,407,0.2999999999999999,72,0.0,0.3,9582,3844,5738
5000,1594,663,0.5,634,278,0.5,960,385,0.5,73,0.0,0.5,8907,3564,5343
2558,5419,0,0.0,2226,0,0.0,3193,0,0.0,74,0.0,0.7,166,72,94
923,2198,0,0.0,878,0,0.0,1320,0,0.0,75,0.0,0.9,102,41,61
5000,2872,1830,0.13869252689402506,1182,686,0.13521960568552593,1690,1144,0.1407750653110096,76,0.8,0.1,7610,3075,4535
5000,3217,1776,0.1407219785612064,1225,706,0.13760930521393192,1992,1070,0.14277576116230523,77,0.8,0.3,7178,2857,4321
5000,4003,1686,0.18023355228537677,1605,633,0.1803676303290726,2398,1053,0.18015295266366776,78,0.8,0.5,6467,2584,3883
5000,5777,1302,0.17618930207199596,2331,526,0.1748058357715657,3446,776,0.17712706402306086,79,0.8,0.7,4794,1954,2840
1082,2630,0,0.0,1086,0,0.0,1544,0,0.0,80,0.8,0.9,59,22,37
5000,2065,2965,0.09999999999999996,819,1213,0.10000000000000007,1246,1752,0.09999999999999988,81,0.0,0.1,8457,3398,5059
5000,969,680,0.30000000000000027,397,279,0.29999999999999993,572,401,0.29999999999999977,82,0.0,0.3,9513,3770,5743
5000,1406,392,0.5,552,151,0.5,854,241,0.5,83,0.0,0.5,9024,3612,5412
5000,9557,17,0.6999999999999998,3854,6,0.7000000000000001,5703,11,0.7000000000000001,84,0.0,0.7,926,332,594
1874,4068,0,0.0,1675,0,0.0,2393,0,0.0,85,0.0,0.9,117,51,66
5000,3394,1859,0.13536578772278401,1375,742,0.13021042375890646,2019,1117,0.13879038938903043,86,0.8,0.1,6931,2797,4134
5000,4443,1727,0.14313589770311116,1764,691,0.14696456637774613,2679,1036,0.14058222004464327,87,0.8,0.3,6105,2444,3661
5000,2871,1826,0.12420401055346646,1127,728,0.12942065003388384,1744,1098,0.1207452550509675,88,0.8,0.5,7550,3020,4530
5000,9481,275,0.22125199946879717,3819,111,0.24547725661954511,5662,164,0.20485563639725443,89,0.8,0.7,1054,450,604
5000,7104,1037,0.20092667254765692,2829,421,0.2052072506897487,4275,616,0.19800114755119486,90,0.8,0.9,3466,1361,2105
5000,1718,2880,0.0999999999999999,721,1230,0.10000000000000006,997,1650,0.09999999999999991,91,0.0,0.1,8736,3568,5168
5000,883,683,0.3000000000000003,358,271,0.29999999999999977,525,412,0.2999999999999998,92,0.0,0.3,9519,3796,5723
5000,3353,958,0.5,1293,370,0.5,2060,588,0.5,93,0.0,0.5,7223,2950,4273
1364,3063,0,0.0,1215,0,0.0,1848,0,0.0,94,0.0,0.7,54,27,27
2588,5571,0,0.0,2185,0,0.0,3386,0,0.0,95,0.0,0.9,142,51,91
5000,3254,2022,0.14230227387123343,1320,806,0.13366748444835838,1934,1216,0.1480256622551456,96,0.8,0.1,7248,2883,4365
5000,2565,1730,0.13175523763294536,970,647,0.13301333305941812,1595,1083,0.13100363307068513,97,0.8,0.3,8021,3116,4905
5000,3518,1690,0.15322670280520206,1392,705,0.15242178117970376,2126,985,0.1538028142224369,98,0.8,0.5,6793,2696,4097
5000,4947,1610,0.1642805632300884,2017,689,0.17024822237674725,2930,921,0.15981615807042726,99,0.8,0.7,5592,2291,3301
5000,7964,876,0.20235011652261853,3163,373,0.19808686317525984,4801,503,0.20551153500883074,100,0.8,0.9,2410,986,1424
5000,2280,3056,0.09999999999999991,847,1215,0.10000000000000009,1433,1841,0.0999999999999999,101,0.0,0.1,8242,3247,4995
5000,991,630,0.3000000000000002,402,260,0.2999999999999999,589,370,0.29999999999999993,102,0.0,0.3,9482,3776,5706
5000,1567,531,0.5,612,208,0.5,955,323,0.5,103,0.0,0.5,8752,3554,5198
2636,5247,0,0.0,2081,0,0.0,3166,0,0.0,104,0.0,0.7,362,150,212
1992,4254,0,0.0,1661,0,0.0,2593,0,0.0,105,0.0,0.9,174,68,106
5000,3239,2092,0.12607385071006183,1295,862,0.12688161627855163,1944,1230,0.12550775809214457,106,0.8,0.1,7227,2902,4325
5000,2572,1745,0.1334408213975253,1012,737,0.12903062140544488,1560,1008,0.1366653426218937,107,0.8,0.3,7672,3154,4518
5000,3394,1829,0.13431772764175978,1368,752,0.13172228285416407,2026,1077,0.1361299602139714,108,0.8,0.5,6993,2857,4136
5000,5924,1345,0.15988416534382782,2427,532,0.15705304885631846,3497,813,0.16173675325447356,109,0.8,0.7,4568,1832,2736
5000,3391,1851,0.14467336909550063,1361,706,0.14845898551174722,2030,1145,0.14233918115674926,110,0.8,0.9,7121,2814,4307
5000,1844,2914,0.09999999999999995,751,1150,0.10000000000000009,1093,1764,0.09999999999999994,111,0.0,0.1,8587,3391,5196
5000,930,646,0.3000000000000002,355,265,0.2999999999999998,575,381,0.2999999999999998,112,0.0,0.3,9528,3859,5669
5000,5939,681,0.5,2432,265,0.5,3507,416,0.5,113,0.0,0.5,4681,1850,2831
1748,3889,0,0.0,1510,0,0.0,2379,0,0.0,114,0.0,0.7,116,50,66
1259,2881,0,0.0,1125,0,0.0,1756,0,0.0,115,0.0,0.9,96,48,48
5000,3801,1895,0.16014681375887607,1552,781,0.14962685577188833,2249,1114,0.16752211644095621,116,0.8,0.1,6779,2717,4062
5000,2704,1845,0.12731656191403873,1137,776,0.12428588318778346,1567,1069,0.1295165681736964,117,0.8,0.3,7772,3207,4565
5000,4220,1660,0.15781073044319902,1699,651,0.16135231188824947,2521,1009,0.15552572596279476,118,0.8,0.5,6287,2558,3729
5000,6135,1152,0.19356532934088497,2500,491,0.20125119863479288,3635,661,0.18785615865509261,119,0.8,0.7,4318,1766,2552
5000,9168,363,0.15154261009693265,3615,139,0.15352861924080505,5553,224,0.15031022049426193,120,0.8,0.9,1208,480,728
5000,1842,2901,0.09999999999999996,732,1149,0.10000000000000007,1110,1752,0.09999999999999988,121,0.0,0.1,8433,3361,5072
5000,966,691,0.3000000000000002,371,263,0.2999999999999999,595,428,0.2999999999999999,122,0.0,0.3,9616,3830,5786
5000,2025,572,0.5,814,221,0.5,1211,351,0.5,123,0.0,0.5,8481,3366,5115
5000,8824,27,0.6999999999999998,3567,8,0.7000000000000001,5257,19,0.7,124,0.0,0.7,1574,615,959
984,2406,0,0.0,981,0,0.0,1425,0,0.0,125,0.0,0.9,90,31,59
5000,2792,1791,0.1285527774628316,1107,713,0.12497172246096216,1685,1078,0.13092132311805693,126,0.8,0.1,7628,3033,4595
5000,2735,1904,0.119961682188658,1099,782,0.11580617396141342,1636,1122,0.12285794549855576,127,0.8,0.3,7961,3208,4753
5000,6169,1304,0.18951519101768285,2475,504,0.19021761778153706,3694,800,0.1890726621564548,128,0.8,0.5,4228,1690,2538
5000,6920,1133,0.17350625773426037,2801,441,0.17569189682262995,4119,692,0.17211338658112305,129,0.8,0.7,3558,1403,2155
5000,8362,767,0.1831444658097334,3288,305,0.18662681070849463,5074,462,0.18084551517310513,130,0.8,0.9,2081,832,1249
5000,1998,3007,0.09999999999999991,785,1174,0.10000000000000006,1213,1833,0.09999999999999991,131,0.0,0.1,8557,3304,5253
5000,921,687,0.30000000000000043,379,270,0.29999999999999977,542,417,0.2999999999999998,132,0.0,0.3,9550,3857,5693
5000,5837,607,0.5,2373,242,0.5,3464,365,0.5,133,0.0,0.5,4660,1849,2811
5000,10214,4,0.7,4110,1,0.7,6104,3,0.6999999999999998,134,0.0,0.7,359,145,214
1797,3988,0,0.0,1592,0,0.0,2396,0,0.0,135,0.0,0.9,149,62,87
5000,2652,1962,0.13290713443314872,1052,771,0.13493037513653802,1600,1191,0.131597379116345,136,0.8,0.1,7693,3078,4615
5000,3891,1739,0.15468083832507423,1536,701,0.15998545688490615,2355,1038,0.1510984321493109,137,0.8,0.3,6601,2633,3968
5000,3705,1891,0.15026854250892155,1488,800,0.14625362201421804,2217,1091,0.1532125722025628,138,0.8,0.5,6802,2798,4004
5000,7423,803,0.22289596642244677,3011,332,0.214906739721998,4412,471,0.22852743832170133,139,0.8,0.7,3092,1263,1829
5000,9374,316,0.179512505134684,3763,124,0.1928854543594459,5611,192,0.17087580876035866,140,0.8,0.9,1107,418,689
5000,1867,2927,0.09999999999999994,742,1183,0.10000000000000007,1125,1744,0.09999999999999991,141,0.0,0.1,8680,3406,5274
5000,992,668,0.3000000000000004,373,253,0.2999999999999999,619,415,0.2999999999999998,142,0.0,0.3,9362,3712,5650
5000,2038,536,0.5,817,216,0.5,1221,320,0.5,143,0.0,0.5,8233,3284,4949
5000,9314,42,0.6999999999999998,3680,15,0.6999999999999998,5634,27,0.6999999999999998,144,0.0,0.7,1174,446,728
892,2265,0,0.0,918,0,0.0,1347,0,0.0,145,0.0,0.9,51,18,33
5000,3797,1776,0.14305012882914278,1541,684,0.1384225428572573,2256,1092,0.14594872663570832,146,0.8,0.1,6609,2602,4007
5000,3485,1820,0.1351710829136941,1402,711,0.13358015364911374,2083,1109,0.13619105649991284,147,0.8,0.3,7139,2783,4356
5000,4063,1598,0.15977654854544032,1659,655,0.150611335605228,2404,943,0.16614262964389118,148,0.8,0.5,6258,2504,3754
5000,9534,301,0.20912015327665254,3823,121,0.18978059716325127,5711,180,0.22212063266399457,149,0.8,0.7,1000,406,594
1682,3763,0,0.0,1479,0,0.0,2284,0,0.0,150,0.8,0.9,96,37,59
5000,1700,2884,0.0999999999999999,673,1108,0.10000000000000006,1027,1776,0.0999999999999999,151,0.0,0.1,8856,3580,5276
5000,822,769,0.3000000000000005,326,313,0.2999999999999999,496,456,0.3000000000000001,152,0.0,0.3,9714,3830,5884
5000,2619,702,0.5,1013,311,0.5,1606,391,0.5,153,0.0,0.5,7800,3151,4649
4958,9766,0,0.0,3890,0,0.0,5876,0,0.0,154,0.0,0.7,554,237,317
1792,3959,0,0.0,1555,0,0.0,2404,0,0.0,155,0.0,0.9,70,33,37
5000,2452,1805,0.11980098983554432,973,753,0.12023186452311982,1479,1052,0.11949257858103451,156,0.8,0.1,8007,3248,4759
5000,2460,1909,0.12903295182311772,978,753,0.13206566118177782,1482,1156,0.12705749321838503,157,0.8,0.3,8175,3272,4903
5000,2854,1748,0.13845069289621886,1162,726,0.13815167167379372,1692,1022,0.13866310914619998,158,0.8,0.5,7732,3111,4621
5000,6213,1386,0.16797668728530674,2491,556,0.1639034271138789,3722,830,0.17070528084592596,159,0.8,0.7,4131,1708,2423
5000,5919,1253,0.19498360613460788,2365,496,0.21406640816218495,3554,757,0.18248021141112278,160,0.8,0.9,4644,1842,2802
5000,2061,2896,0.09999999999999999,807,1152,0.10000000000000009,1254,1744,0.09999999999999991,161,0.0,0.1,8311,3313,4998
5000,944,679,0.30000000000000027,374,277,0.29999999999999993,570,402,0.29999999999999993,162,0.0,0.3,9481,3822,5659
5000,1336,462,0.5,536,160,0.5,800,302,0.5,163,0.0,0.5,9288,3640,5648
1650,3633,0,0.0,1429,0,0.0,2204,0,0.0,164,0.0,0.7,135,45,90
375,1209,0,0.0,481,0,0.0,728,0,0.0,165,0.0,0.9,36,13,23
5000,3220,1954,0.1485194034724847,1309,822,0.1584983322057153,1911,1132,0.14127322024040367,166,0.8,0.1,7262,2976,4286
5000,4915,1573,0.1705733472485538,1939,635,0.17914512707252322,2976,938,0.164770489905035,167,0.8,0.3,5571,2235,3336
5000,4536,1656,0.15703840055094362,1858,651,0.15935173494914814,2678,1005,0.15553991229897243,168,0.8,0.5,5802,2323,3479
5000,4178,1524,0.16560134522262776,1668,600,0.15815967177109322,2510,924,0.17043360071063723,169,0.8,0.7,6346,2527,3819
5000,10153,22,0.24673828109619825,4027,9,0.24009620022618142,6126,13,0.2513366447754406,170,0.8,0.9,220,85,135
5000,1886,2888,0.1,736,1123,0.10000000000000006,1150,1765,0.09999999999999994,171,0.0,0.1,8607,3386,5221
5000,859,648,0.30000000000000027,330,274,0.29999999999999993,529,374,0.2999999999999999,172,0.0,0.3,9608,3883,5725
5000,1557,568,0.5,652,222,0.5,905,346,0.5,173,0.0,0.5,8961,3520,5441
1782,3902,0,0.0,1608,0,0.0,2294,0,0.0,174,0.0,0.7,138,51,87
2055,4429,0,0.0,1765,0,0.0,2664,0,0.0,175,0.0,0.9,140,55,85
5000,3333,1939,0.13880788780094594,1368,782,0.13848380738604524,1965,1157,0.1390269291876808,176,0.8,0.1,7072,2859,4213
5000,2854,1797,0.12956977859401647,1108,719,0.12875902622898777,1746,1078,0.13011053086716637,177,0.8,0.3,7619,3046,4573
5000,3018,1763,0.14836465949554026,1251,711,0.14697295520200998,1767,1052,0.149305250515217,178,0.8,0.5,7426,3003,4423
5000,6794,1076,0.19195992724323435,2718,430,0.19099086045269084,4076,646,0.19260497170133606,179,0.8,0.7,3720,1462,2258
5000,8280,683,0.1832611504609926,3345,283,0.16893946794807216,4935,400,0.19339374083888378,180,0.8,0.9,2175,875,1300
5000,1982,2984,0.09999999999999994,803,1159,0.10000000000000005,1179,1825,0.09999999999999983,181,0.0,0.1,8421,3333,5088
5000,897,683,0.3000000000000003,364,265,0.2999999999999998,533,418,0.2999999999999999,182,0.0,0.3,9692,3789,5903
5000,2707,838,0.5,1087,311,0.5,1620,527,0.5,183,0.0,0.5,7881,3100,4781
5000,8619,85,0.7000000000000001,3389,35,0.6999999999999998,5230,50,0.6999999999999998,184,0.0,0.7,1921,773,1148
1971,4267,0,0.0,1637,0,0.0,2630,0,0.0,185,0.0,0.9,127,53,74
5000,3235,1882,0.13788977284616913,1265,751,0.14476108026351994,1970,1131,0.13332712751422338,186,0.8,0.1,7048,2811,4237
5000,3386,1814,0.1381181200628289,1323,718,0.13962840887325859,2063,1096,0.13712871553190872,187,0.8,0.3,6950,2718,4232
5000,4811,1575,0.18033192350025004,1961,642,0.1713038801979553,2850,933,0.18654414622272938,188,0.8,0.5,5521,2200,3321
5000,4948,1566,0.16187726758279852,1974,650,0.16813653859173178,2974,916,0.15743564514196154,189,0.8,0.7,5450,2172,3278
1202,2784,0,0.0,1148,0,0.0,1636,0,0.0,190,0.8,0.9,57,20,37
5000,1844,2920,0.09999999999999994,763,1141,0.10000000000000007,1081,1779,0.0999999999999999,191,0.0,0.1,8668,3439,5229
5000,926,650,0.3000000000000003,368,243,0.3,558,407,0.2999999999999999,192,0.0,0.3,9468,3781,5687
5000,1703,557,0.5,706,216,0.5,997,341,0.5,193,0.0,0.5,8640,3510,5130
3207,6426,0,0.0,2584,0,0.0,3842,0,0.0,194,0.0,0.7,337,142,195
1758,3884,0,0.0,1573,0,0.0,2311,0,0.0,195,0.0,0.9,102,46,56
5000,2869,1822,0.13022010800454625,1122,725,0.12942554360451053,1747,1097,0.1307452303290913,196,0.8,0.1,7594,2961,4633
5000,3327,1887,0.14312585293330815,1339,781,0.1430741275435338,1988,1106,0.14316237872843793,197,0.8,0.3,6994,2905,4089
5000,5118,1473,0.16598259623982503,2039,576,0.16719499692372536,3079,897,0.1652040646969861,198,0.8,0.5,5357,2140,3217
5000,5652,1517,0.18707708341372842,2272,631,0.18185313681810558,3380,886,0.19079752393499025,199,0.8,0.7,4825,1985,2840
906,2343,0,0.0,942,0,0.0,1401,0,0.0,200,0.8,0.9,55,22,33
5000,2128,3060,0.09999999999999991,851,1211,0.10000000000000009,1277,1849,0.09999999999999987,201,0.0,0.1,8490,3360,5130
5000,991,672,0.30000000000000043,396,269,0.2999999999999998,595,403,0.29999999999999993,202,0.0,0.3,9414,3742,5672
5000,1685,521,0.5,679,227,0.5,1006,294,0.5,203,0.0,0.5,8901,3590,5311
5000,9312,29,0.6999999999999997,3759,14,0.7,5553,15,0.6999999999999998,204,0.0,0.7,1068,438,630
2845,5888,0,0.0,2404,0,0.0,3484,0,0.0,205,0.0,0.9,381,158,223
5000,3683,1930,0.15684843060548262,1490,789,0.15516583720048005,2193,1141,0.15801194173304348,206,0.8,0.1,6768,2695,4073
5000,2983,1780,0.127733576627997,1180,722,0.1333193067020018,1803,1058,0.12392176461152113,207,0.8,0.3,7729,3108,4621
5000,4524,1756,0.16378571009972417,1791,704,0.1618422433561335,2733,1052,0.16508628100037792,208,0.8,0.5,5763,2338,3425
5000,6510,1358,0.17544054706008289,2601,538,0.17109570709557195,3909,820,0.17829118596362792,209,0.8,0.7,4113,1617,2496
1095,2626,0,0.0,1017,0,0.0,1609,0,0.0,210,0.8,0.9,72,28,44
5000,1866,2854,0.09999999999999995,721,1156,0.10000000000000005,1145,1698,0.09999999999999985,211,0.0,0.1,8675,3505,5170
5000,908,721,0.30000000000000043,367,280,0.2999999999999999,541,441,0.3000000000000001,212,0.0,0.3,9608,3776,5832
5000,1593,563,0.5,642,221,0.5,951,342,0.5,213,0.0,0.5,8916,3544,5372
5000,9738,47,0.6999999999999998,3845,26,0.6999999999999998,5893,21,0.6999999999999998,214,0.0,0.7,642,262,380
2414,5121,0,0.0,2027,0,0.0,3094,0,0.0,215,0.0,0.9,254,99,155
5000,3036,1937,0.13849201246371431,1227,814,0.1398295551175755,1809,1123,0.13752250247240258,216,0.8,0.1,7579,3046,4533
5000,2691,1878,0.1275341155987629,1036,722,0.1280772911103596,1655,1156,0.12719486584152,217,0.8,0.3,7685,3044,4641
5000,2987,1759,0.1494693845767611,1183,731,0.1548603193005104,1804,1028,0.14563594753098208,218,0.8,0.5,7360,2982,4378
5000,4807,1591,0.16538720464325204,1983,607,0.16470190188329661,2824,984,0.16580994730107002,219,0.8,0.7,5568,2237,3331
5000,8094,760,0.23427777074435188,3247,301,0.23855638292445255,4847,459,0.2314719706001027,220,0.8,0.9,2414,957,1457
5000,3002,3150,0.09999999999999996,1213,1307,0.09999999999999995,1789,1843,0.09999999999999988,221,0.0,0.1,7597,3126,4471
5000,944,641,0.30000000000000043,394,247,0.29999999999999993,550,394,0.2999999999999998,222,0.0,0.3,9494,3764,5730
5000,1916,627,0.5,762,265,0.5,1154,362,0.5,223,0.0,0.5,8561,3468,5093
5000,10163,11,0.7000000000000001,3956,4,0.7,6207,7,0.7000000000000001,224,0.0,0.7,449,178,271
1031,2355,0,0.0,943,0,0.0,1412,0,0.0,225,0.0,0.9,111,55,56
5000,4144,1847,0.15123043457988603,1709,745,0.15032943536688598,2435,1102,0.15183954929284865,226,0.8,0.1,6420,2671,3749
5000,4165,1701,0.15501154526704078,1700,658,0.1551066722546083,2465,1043,0.15495153226817268,227,0.8,0.3,6284,2458,3826
5000,7335,930,0.16628477922192006,2882,367,0.16395430808757325,4453,563,0.1678039318086078,228,0.8,0.5,3017,1128,1889
5000,7412,927,0.1944151627815824,2960,391,0.18875658120408023,4452,536,0.1985429713577079,229,0.8,0.7,3028,1228,1800
5000,3473,1626,0.1599734950489166,1418,641,0.16061753711874108,2055,985,0.15955437731616784,230,0.8,0.9,6963,2766,4197
5000,1940,2924,0.09999999999999994,772,1174,0.10000000000000006,1168,1750,0.09999999999999988,231,0.0,0.1,8635,3433,5202
5000,907,669,0.30000000000000043,375,267,0.2999999999999998,532,402,0.29999999999999993,232,0.0,0.3,9527,3851,5676
5000,4125,734,0.5,1572,290,0.5,2553,444,0.5,233,0.0,0.5,6411,2601,3810
4888,9888,0,0.0,4009,0,0.0,5879,0,0.0,234,0.0,0.7,433,137,296
618,1645,0,0.0,647,0,0.0,998,0,0.0,235,0.0,0.9,62,23,39
5000,3663,1919,0.15225249562034854,1449,729,0.15255119100280373,2214,1190,0.15206951332302915,236,0.8,0.1,6766,2693,4073
5000,3702,1883,0.14613253622113068,1499,736,0.14964657704687492,2203,1147,0.14387766782727893,237,0.8,0.3,6668,2687,3981
5000,3829,1900,0.1510149929539566,1541,747,0.14967242004977888,2288,1153,0.15188481251980282,238,0.8,0.5,6687,2665,4022
5000,5203,1489,0.18329816461139628,2120,587,0.1851515351271551,3083,902,0.18209203546200556,239,0.8,0.7,5169,2079,3090
5000,7026,1056,0.18921941897074693,2833,429,0.19492538594576508,4193,627,0.18531533630362926,240,0.8,0.9,3515,1378,2137
5000,2697,3048,0.09999999999999992,1085,1188,0.10000000000000006,1612,1860,0.09999999999999992,241,0.0,0.1,7740,3005,4735
5000,879,648,0.30000000000000027,349,269,0.2999999999999998,530,379,0.2999999999999999,242,0.0,0.3,9557,3870,5687
5000,1337,599,0.5,530,222,0.5,807,377,0.5,243,0.0,0.5,9141,3611,5530
773,2032,0,0.0,808,0,0.0,1224,0,0.0,244,0.0,0.7,41,23,18
1310,3033,0,0.0,1154,0,0.0,1879,0,0.0,245,0.0,0.9,122,56,66
5000,2720,1899,0.11337477723127341,1111,769,0.11800954137227272,1609,1130,0.11022067667868181,246,0.8,0.1,7803,3112,4691
5000,2779,1749,0.13881496323524076,1120,673,0.13801056610969725,1659,1076,0.13931808522919129,247,0.8,0.3,7682,3053,4629
5000,3425,1786,0.17102003661904133,1350,726,0.16839685009079544,2075,1060,0.17281667192046238,248,0.8,0.5,7119,2881,4238
5000,4388,1536,0.16132177936945516,1775,612,0.1582086024212297,2613,924,0.1633837537117864,249,0.8,0.7,6177,2525,3652
5000,9721,246,0.25360116280010675,3943,99,0.27552930840161205,5778,147,0.23883322800725637,250,0.8,0.9,797,332,465
5000,2118,2954,0.09999999999999999,847,1183,0.10000000000000007,1271,1771,0.09999999999999992,251,0.0,0.1,8275,3255,5020
5000,1006,665,0.3000000000000003,401,266,0.2999999999999998,605,399,0.29999999999999977,252,0.0,0.3,9544,3770,5774
5000,2032,510,0.5,846,199,0.5,1186,311,0.5,253,0.0,0.5,8426,3368,5058
1344,2994,0,0.0,1184,0,0.0,1810,0,0.0,254,0.0,0.7,181,86,95
876,2159,0,0.0,836,0,0.0,1323,0,0.0,255,0.0,0.9,60,23,37
5000,3712,1876,0.13315150912798918,1471,771,0.13764906115466516,2241,1105,0.1300133981663899,256,0.8,0.1,6787,2713,4074
5000,4394,1636,0.16706234837878997,1847,656,0.16925219925113896,2547,980,0.16559648901934002,257,0.8,0.3,6047,2411,3636
5000,4622,1777,0.1663157763598019,1819,672,0.1592828400879413,2803,1105,0.1705928199568067,258,0.8,0.5,5949,2300,3649
5000,8312,695,0.2302747433183351,3293,275,0.22408541081141273,5019,420,0.23432728245977233,259,0.8,0.7,2109,850,1259
1997,4408,0,0.0,1752,0,0.0,2656,0,0.0,260,0.8,0.9,92,37,55
5000,2455,2972,0.09999999999999996,988,1184,0.10000000000000007,1467,1788,0.09999999999999987,261,0.0,0.1,7950,3204,4746
5000,987,643,0.3000000000000002,383,277,0.29999999999999993,604,366,0.2999999999999998,262,0.0,0.3,9495,3822,5673
5000,2213,584,0.5,923,231,0.5,1290,353,0.5,263,0.0,0.5,8292,3316,4976
5000,7239,124,0.7000000000000003,2878,45,0.6999999999999997,4361,79,0.7000000000000005,264,0.0,0.7,3293,1325,1968
921,2202,0,0.0,873,0,0.0,1329,0,0.0,265,0.0,0.9,47,16,31
5000,3388,1863,0.1272276816406999,1352,752,0.1343372780471401,2036,1111,0.12241542556721376,266,0.8,0.1,7080,2885,4195
5000,2534,1897,0.124422874433489,1016,805,0.12625821212012758,1518,1092,0.12306990113885156,267,0.8,0.3,7799,3132,4667
5000,4712,1645,0.1505349415136141,1857,661,0.14995003203624535,2855,984,0.15092785326619612,268,0.8,0.5,5713,2291,3422
5000,5319,1427,0.16746833900804226,2157,592,0.16591898243344014,3162,835,0.1685668049866824,269,0.8,0.7,5082,2113,2969
5000,9206,282,0.1912539889004206,3712,114,0.20655899829620697,5494,168,0.18086844681042286,270,0.8,0.9,1170,479,691
5000,1824,2917,0.09999999999999994,735,1159,0.10000000000000005,1089,1758,0.09999999999999987,271,0.0,0.1,8694,3489,5205
5000,916,678,0.30000000000000027,389,285,0.2999999999999999,527,393,0.2999999999999998,272,0.0,0.3,9553,3853,5700
5000,2308,698,0.5,928,281,0.5,1380,417,0.5,273,0.0,0.5,8293,3337,4956
5000,9565,48,0.6999999999999998,3802,23,0.7,5763,25,0.6999999999999998,274,0.0,0.7,991,381,610
1434,3332,0,0.0,1345,0,0.0,1987,0,0.0,275,0.0,0.9,77,31,46
5000,2569,1944,0.13215232931920456,981,800,0.1337811344805958,1588,1144,0.13101330473081912,276,0.8,0.1,7793,3130,4663
5000,2662,1793,0.12515445607879755,1074,696,0.12664977170837005,1588,1097,0.12420574169576892,277,0.8,0.3,7772,3137,4635
5000,5564,1507,0.17364213786120994,2225,601,0.1764125819977357,3339,906,0.17180434875960732,278,0.8,0.5,4866,1941,2925
5000,6671,1209,0.19374231014539506,2720,490,0.19491526015339963,3951,719,0.19294294226789555,279,0.8,0.7,3847,1541,2306
5000,7898,776,0.21645309355999173,3176,317,0.2196329590023486,4722,459,0.21425697733945315,280,0.8,0.9,2421,976,1445
5000,1940,2910,0.09999999999999996,776,1153,0.10000000000000009,1164,1757,0.09999999999999987,281,0.0,0.1,8623,3440,5183
5000,976,664,0.3000000000000003,354,274,0.29999999999999993,622,390,0.2999999999999999,282,0.0,0.3,9506,3814,5692
5000,1711,622,0.5,704,241,0.5,1007,381,0.5,283,0.0,0.5,8876,3577,5299
5000,9387,82,0.7,3720,28,0.6999999999999998,5667,54,0.7000000000000001,284,0.0,0.7,1091,447,644
2140,4288,0,0.0,1780,0,0.0,2508,0,0.0,285,0.0,0.9,447,186,261
5000,2913,1963,0.1312930627773678,1192,792,0.1326288377753647,1721,1171,0.13038961803064394,286,0.8,0.1,7830,3171,4659
5000,2780,1748,0.14603828084432824,1130,678,0.14471612653305574,1650,1070,0.14687605712754576,287,0.8,0.3,7785,3085,4700
5000,2589,1763,0.1298366278263815,1012,680,0.1276311903991591,1577,1083,0.1312213900152192,288,0.8,0.5,7787,3142,4645
5000,4045,1691,0.1592846254322691,1678,695,0.1569969144054541,2367,996,0.16088096997407259,289,0.8,0.7,6401,2592,3809
5000,5924,1615,0.1623325380204621,2371,640,0.15970167367487162,3553,975,0.16405946436013177,290,0.8,0.9,4694,1907,2787
5000,1830,2930,0.09999999999999992,768,1168,0.10000000000000006,1062,1762,0.09999999999999985,291,0.0,0.1,8634,3360,5274
5000,926,633,0.30000000000000027,368,243,0.3,558,390,0.2999999999999999,292,0.0,0.3,9578,3753,5825
5000,1576,509,0.5,631,195,0.5,945,314,0.5,293,0.0,0.5,8866,3541,5325
1205,2765,0,0.0,1126,0,0.0,1639,0,0.0,294,0.0,0.7,112,44,68
2215,4680,0,0.0,1894,0,0.0,2786,0,0.0,295,0.0,0.9,231,86,145
5000,3038,1995,0.12948799799606311,1187,832,0.12575923532833339,1851,1163,0.13215552210573736,296,0.8,0.1,7618,3087,4531
5000,3071,1917,0.12957215681982048,1200,760,0.1342679118374013,1871,1157,0.12648765049885125,297,0.8,0.3,7326,2948,4378
5000,3115,1770,0.13806815436597367,1269,684,0.14058617261017736,1846,1086,0.13648222022321546,298,0.8,0.5,7457,2914,4543
5000,4217,1731,0.16347378689275585,1653,699,0.15904186302445247,2564,1032,0.1664756423035543,299,0.8,0.7,6189,2475,3714
5000,5754,1415,0.18617802058597485,2294,561,0.1905790615556952,3460,854,0.18328693863748177,300,0.8,0.9,4730,1919,2811
5000,2311,2980,0.09999999999999994,916,1200,0.10000000000000007,1395,1780,0.0999999999999999,301,0.0,0.1,7976,3167,4809
5000,876,671,0.30000000000000043,336,236,0.2999999999999998,540,435,0.29999999999999993,302,0.0,0.3,9466,3734,5732
5000,1671,511,0.5,688,185,0.5,983,326,0.5,303,0.0,0.5,8904,3516,5388
5000,9794,1,0.7,3952,0,0.0,5842,1,0.7,304,0.0,0.7,695,266,429
795,1973,0,0.0,806,0,0.0,1167,0,0.0,305,0.0,0.9,105,42,63
5000,3529,1895,0.13319892689485474,1408,708,0.13204164156138629,2121,1187,0.13388920323528916,306,0.8,0.1,6951,2739,4212
5000,2404,1860,0.13498343213922226,946,769,0.1343326149011353,1458,1091,0.13544216582949617,307,0.8,0.3,8048,3259,4789
5000,2120,1737,0.1263450476526719,869,683,0.12344132958534135,1251,1054,0.1282266789999079,308,0.8,0.5,8172,3201,4971
5000,3404,1837,0.14757834555538588,1345,699,0.14054448709450829,2059,1138,0.151898791130213,309,0.8,0.7,7253,2867,4386
5000,6983,1024,0.22321574179995135,2774,393,0.22493176617324445,4209,631,0.2221469659224486,310,0.8,0.9,3554,1416,2138
5000,1917,2932,0.09999999999999992,811,1166,0.10000000000000006,1106,1766,0.09999999999999994,311,0.0,0.1,8525,3452,5073
5000,917,682,0.3000000000000003,354,302,0.29999999999999977,563,380,0.2999999999999999,312,0.0,0.3,9652,3979,5673
5000,2518,593,0.5,961,244,0.5,1557,349,0.5,313,0.0,0.5,7941,3192,4749
5000,10166,25,0.6999999999999998,4103,8,0.7000000000000001,6063,17,0.6999999999999998,314,0.0,0.7,461,186,275
1043,2465,0,0.0,992,0,0.0,1473,0,0.0,315,0.0,0.9,52,26,26
5000,3603,1780,0.13981005198257615,1438,738,0.13884925050670133,2165,1042,0.14049054285512472,316,0.8,0.1,6682,2674,4008
5000,2477,1885,0.13466473134642798,992,751,0.13919048014387247,1485,1134,0.13166752028215914,317,0.8,0.3,7803,3134,4669
5000,2944,1800,0.13743944529987984,1181,707,0.1316453663981872,1763,1093,0.14118730786483563,318,0.8,0.5,7740,3143,4597
5000,5516,1427,0.18946908483344949,2238,560,0.18313722292903103,3278,867,0.19355886876248546,319,0.8,0.7,5006,2014,2992
5000,10026,151,0.12132247460117399,4066,52,0.11482047223951358,5960,99,0.12473766776083395,320,0.8,0.9,510,192,318
5000,1830,2846,0.09999999999999996,741,1079,0.10000000000000009,1089,1767,0.09999999999999994,321,0.0,0.1,8656,3375,5281
5000,1012,646,0.3000000000000002,404,265,0.2999999999999998,608,381,0.2999999999999998,322,0.0,0.3,9546,3846,5700
5000,1572,481,0.5,598,189,0.5,974,292,0.5,323,0.0,0.5,8872,3597,5275
5000,9383,50,0.6999999999999998,3776,24,0.6999999999999998,5607,26,0.6999999999999998,324,0.0,0.7,1122,456,666
1693,3549,0,0.0,1421,0,0.0,2128,0,0.0,325,0.0,0.9,230,105,125
5000,3454,1963,0.13812424180112706,1385,781,0.146750220863498,2069,1182,0.13242467357125243,326,0.8,0.1,7059,2814,4245
5000,3078,1906,0.1511581843082804,1198,783,0.15164716628954167,1880,1123,0.15081724673808652,327,0.8,0.3,7334,3019,4315
5000,2735,1813,0.12685965545187824,1075,714,0.11932509507587295,1660,1099,0.13175472015476072,328,0.8,0.5,8003,3158,4845
5000,5238,1396,0.16240139737716727,2071,544,0.16544929678303133,3167,852,0.1604553207612166,329,0.8,0.7,5006,1970,3036
5000,9421,303,0.20120341461782393,3775,122,0.18852545954315347,5646,181,0.209748776601856,330,0.8,0.9,1069,451,618
5000,1918,3080,0.09999999999999998,794,1221,0.10000000000000005,1124,1859,0.09999999999999988,331,0.0,0.1,8563,3419,5144
5000,981,649,0.30000000000000027,389,265,0.2999999999999998,592,384,0.2999999999999998,332,0.0,0.3,9460,3803,5657
5000,1492,516,0.5,592,204,0.5,900,312,0.5,333,0.0,0.5,9088,3552,5536
5000,8149,87,0.7000000000000002,3264,30,0.6999999999999997,4885,57,0.7000000000000002,334,0.0,0.7,2435,946,1489
1684,3555,0,0.0,1453,0,0.0,2102,0,0.0,335,0.0,0.9,208,73,135
5000,4113,1767,0.15105264965222506,1684,694,0.15452775928232093,2429,1073,0.1488050018579226,336,0.8,0.1,6269,2489,3780
5000,3102,1758,0.13872428893926375,1296,718,0.1412148344609535,1806,1040,0.13700485462717407,337,0.8,0.3,7326,3011,4315
5000,7031,1115,0.21524173804514485,2919,449,0.21796919639413614,4112,666,0.2134029560651192,338,0.8,0.5,3570,1455,2115
5000,9778,213,0.18870067944956442,3981,86,0.22320132062776193,5797,127,0.16533804054149367,339,0.8,0.7,657,264,393
5000,5911,1422,0.1643684010763269,2353,538,0.1710172646666041,3558,884,0.1603219207464976,340,0.8,0.9,4635,1841,2794
5000,2515,3153,0.09999999999999995,986,1299,0.09999999999999998,1529,1854,0.09999999999999985,341,0.0,0.1,7917,3186,4731
5000,878,664,0.3000000000000003,358,295,0.2999999999999999,520,369,0.29999999999999977,342,0.0,0.3,9693,3955,5738
5000,1519,476,0.5,643,187,0.5,876,289,0.5,343,0.0,0.5,8860,3535,5325
3097,6242,0,0.0,2537,0,0.0,3705,0,0.0,344,0.0,0.7,306,131,175
735,1960,0,0.0,781,0,0.0,1179,0,0.0,345,0.0,0.9,35,14,21
5000,4407,1885,0.16477948764119693,1745,764,0.1618645146822879,2662,1121,0.1667661418255023,346,0.8,0.1,5991,2430,3561
5000,3154,1869,0.14103445278525165,1298,733,0.1512430311540306,1856,1136,0.13444740353849544,347,0.8,0.3,7342,2911,4431
5000,3829,1693,0.15465724995421584,1566,724,0.15424418923359928,2263,969,0.1549658732377312,348,0.8,0.5,6482,2684,3798
5000,4588,1519,0.1958363432430416,1920,579,0.18842606321558944,2668,940,0.20040076040888713,349,0.8,0.7,5670,2243,3427
5000,3970,1671,0.16422912335669335,1612,674,0.16314037053331115,2358,997,0.1649651508421092,350,0.8,0.9,6512,2557,3955
5000,1829,2984,0.09999999999999994,755,1256,0.10000000000000006,1074,1728,0.09999999999999985,351,0.0,0.1,8718,3578,5140
5000,915,654,0.3000000000000004,370,282,0.2999999999999999,545,372,0.29999999999999993,352,0.0,0.3,9483,3816,5667
5000,5051,724,0.5,2000,294,0.5,3051,430,0.5,353,0.0,0.5,5376,2102,3274
5000,9412,55,0.7000000000000002,3778,16,0.6999999999999998,5634,39,0.6999999999999998,354,0.0,0.7,1212,473,739
1238,2854,0,0.0,1148,0,0.0,1706,0,0.0,355,0.0,0.9,124,49,75
5000,2592,1916,0.11922908917505028,991,757,0.11791440862676653,1601,1159,0.12008777181098716,356,0.8,0.1,7886,3166,4720
5000,3476,1783,0.14230807982035015,1338,709,0.13760760268875977,2138,1074,0.14541109498450053,357,0.8,0.3,7012,2791,4221
5000,3029,1779,0.1384089866033115,1221,710,0.13547630625881307,1808,1069,0.14035679113520474,358,0.8,0.5,7500,3035,4465
5000,2948,1792,0.13747781388048283,1125,710,0.13381498030613764,1823,1082,0.13988133683592194,359,0.8,0.7,7620,3034,4586
680,1824,0,0.0,710,0,0.0,1114,0,0.0,360,0.8,0.9,37,11,26
5000,1455,2669,0.09999999999999995,600,1075,0.10000000000000007,855,1594,0.0999999999999999,361,0.0,0.1,9048,3685,5363
5000,947,650,0.3000000000000003,388,275,0.29999999999999993,559,375,0.2999999999999999,362,0.0,0.3,9629,3916,5713
5000,1763,549,0.5,681,201,0.5,1082,348,0.5,363,0.0,0.5,8944,3645,5299
5000,9504,4,0.7,3853,1,0.7,5651,3,0.6999999999999998,364,0.0,0.7,836,324,512
1917,4025,0,0.0,1633,0,0.0,2392,0,0.0,365,0.0,0.9,199,77,122
5000,2548,1847,0.11871091500215958,1051,757,0.11893412461755161,1497,1090,0.11855589694816712,366,0.8,0.1,7976,3162,4814
5000,2579,1981,0.11978498229591283,1019,797,0.12246969703672474,1560,1184,0.11797778833609264,367,0.8,0.3,7805,3128,4677
5000,3360,1748,0.12656951385032356,1354,706,0.1200640163690077,2006,1042,0.13097726934150308,368,0.8,0.5,7219,2857,4362
5000,3451,1881,0.15282551077679904,1361,739,0.1543180721252897,2090,1142,0.15185965890592804,369,0.8,0.7,7000,2774,4226
5000,5873,1372,0.19242631377846572,2280,562,0.18778426376572732,3593,810,0.19564709415767434,370,0.8,0.9,4549,1880,2669
5000,1904,2894,0.09999999999999999,738,1140,0.10000000000000007,1166,1754,0.09999999999999987,371,0.0,0.1,8549,3421,5128
5000,809,835,0.3000000000000003,290,307,0.29999999999999993,519,528,0.3000000000000003,372,0.0,0.3,9709,3868,5841
5000,3836,733,0.5,1565,294,0.5,2271,439,0.5,373,0.0,0.5,6660,2671,3989
4306,8509,0,0.0,3441,0,0.0,5068,0,0.0,374,0.0,0.7,608,237,371
666,1762,0,0.0,736,0,0.0,1026,0,0.0,375,0.0,0.9,62,25,37
5000,3356,2000,0.12843939596973014,1331,829,0.12846024159768316,2025,1171,0.12842463847564548,376,0.8,0.1,7132,2876,4256
5000,3355,1883,0.1387220784133854,1354,775,0.14463073291974962,2001,1108,0.13458921989133457,377,0.8,0.3,7111,2816,4295
5000,2373,1641,0.131564170594579,964,648,0.1321496704242605,1409,993,0.13118209215587456,378,0.8,0.5,8171,3211,4960
5000,5686,1307,0.18285527440221375,2247,501,0.185251128037044,3439,806,0.18136604031902528,379,0.8,0.7,4820,1904,2916
5000,8289,698,0.21118035751597827,3319,277,0.2045588898935088,4970,421,0.21553700010843438,380,0.8,0.9,2192,884,1308
5000,2140,2956,0.09999999999999999,871,1251,0.10000000000000006,1269,1705,0.09999999999999994,381,0.0,0.1,8169,3347,4822
5000,910,700,0.3000000000000004,354,262,0.2999999999999999,556,438,0.3,382,0.0,0.3,9389,3712,5677
5000,1776,493,0.5,678,205,0.5,1098,288,0.5,383,0.0,0.5,8578,3489,5089
5000,9619,1,0.7,3864,0,0.0,5755,1,0.7,384,0.0,0.7,816,341,475
1596,3631,0,0.0,1489,0,0.0,2142,0,0.0,385,0.0,0.9,98,44,54
5000,2589,1897,0.12207806109535575,1070,777,0.11881034503568741,1519,1120,0.12434503911175064,386,0.8,0.1,7795,3158,4637
5000,2481,1784,0.12554510316720408,965,726,0.12112233868562255,1516,1058,0.128580005826588,387,0.8,0.3,7854,3133,4721
5000,2891,1795,0.12266165271033863,1218,723,0.12701756445060627,1673,1072,0.11972385029596039,388,0.8,0.5,7573,3072,4501
5000,4510,1595,0.1674747007157655,1858,644,0.1623462959494214,2652,951,0.17094756367005104,389,0.8,0.7,5817,2345,3472
534,1549,0,0.0,631,0,0.0,918,0,0.0,390,0.8,0.9,18,3,15
5000,1847,2956,0.09999999999999999,703,1149,0.10000000000000007,1144,1807,0.09999999999999988,391,0.0,0.1,8545,3313,5232
5000,848,710,0.30000000000000027,336,270,0.29999999999999977,512,440,0.30000000000000004,392,0.0,0.3,9672,3864,5808
5000,2493,806,0.5,1022,361,0.5,1471,445,0.5,393,0.0,0.5,7936,3183,4753
3205,6606,0,0.0,2670,0,0.0,3936,0,0.0,394,0.0,0.7,449,151,298
865,2158,0,0.0,848,0,0.0,1310,0,0.0,395,0.0,0.9,58,20,38
5000,3811,1913,0.1397942924882558,1549,762,0.13754443866176674,2262,1151,0.1412837699997975,396,0.8,0.1,6640,2620,4020
5000,2521,1763,0.11686872604764469,996,743,0.11841427393901582,1525,1020,0.11574290047579298,397,0.8,0.3,7775,3089,4686
5000,2965,1861,0.13543995873827117,1152,761,0.13916723193400687,1813,1100,0.13286136337285762,398,0.8,0.5,7540,3056,4484
5000,6050,1402,0.1910599934450628,2407,524,0.181053994028195,3643,878,0.1970316833020546,399,0.8,0.7,4447,1738,2709
5000,4407,1672,0.161028226658583,1767,665,0.160700459644641,2640,1007,0.16124467657345037,400,0.8,0.9,6147,2484,3663
5000,2320,3058,0.09999999999999991,910,1207,0.10000000000000009,1410,1851,0.09999999999999985,401,0.0,0.1,8141,3240,4901
5000,857,723,0.30000000000000027,325,284,0.2999999999999999,532,439,0.30000000000000004,402,0.0,0.3,9548,3880,5668
5000,1818,573,0.5,727,233,0.5,1091,340,0.5,403,0.0,0.5,8711,3503,5208
5000,9969,5,0.7,3985,3,0.6999999999999998,5984,2,0.7,404,0.0,0.7,413,161,252
1987,4438,0,0.0,1850,0,0.0,2588,0,0.0,405,0.0,0.9,163,71,92
5000,2963,1907,0.13814410424333923,1178,750,0.1418031267071011,1785,1157,0.13577222278454795,406,0.8,0.1,7379,2933,4446
5000,3097,1846,0.1436723604481442,1200,745,0.14526126676730372,1897,1101,0.14259721493699626,407,0.8,0.3,7461,2938,4523
5000,2750,1871,0.13140415959784676,1139,732,0.12931521870198326,1611,1139,0.13274665717095657,408,0.8,0.5,7897,3088,4809
5000,4035,1852,0.15636126295588537,1590,729,0.14974619330687555,2445,1123,0.16065546222046942,409,0.8,0.7,6615,2663,3952
684,1879,0,0.0,777,0,0.0,1102,0,0.0,410,0.8,0.9,15,4,11
5000,1647,2732,0.09999999999999995,643,1069,0.10000000000000006,1004,1663,0.09999999999999987,411,0.0,0.1,8843,3507,5336
5000,958,650,0.3000000000000003,377,291,0.2999999999999999,581,359,0.2999999999999998,412,0.0,0.3,9537,3870,5667
5000,1872,625,0.5,757,214,0.5,1115,411,0.5,413,0.0,0.5,8580,3425,5155
5000,9766,36,0.6999999999999998,3884,11,0.7000000000000001,5882,25,0.6999999999999998,414,0.0,0.7,679,259,420
2482,5227,0,0.0,2120,0,0.0,3107,0,0.0,415,0.0,0.9,149,46,103
5000,2951,2049,0.1438535248974698,1181,859,0.14141519820712076,1770,1190,0.14561362794537713,416,0.8,0.1,7540,3074,4466
5000,3679,1847,0.14908865199115684,1456,743,0.15836191047592618,2223,1104,0.14284768183338173,417,0.8,0.3,6979,2756,4223
5000,3274,1864,0.14174922691943592,1308,726,0.13897246357482035,1966,1138,0.14352069457162475,418,0.8,0.5,7091,2810,4281
5000,5844,1425,0.18736669471161552,2309,571,0.1787896382293538,3535,854,0.19310147135256572,419,0.8,0.7,4605,1820,2785
575,1627,0,0.0,625,0,0.0,1002,0,0.0,420,0.8,0.9,23,9,14
5000,2450,3053,0.09999999999999991,1005,1190,0.10000000000000006,1445,1863,0.09999999999999991,421,0.0,0.1,8079,3210,4869
5000,907,647,0.30000000000000027,349,279,0.29999999999999993,558,368,0.29999999999999977,422,0.0,0.3,9512,3863,5649
5000,1873,593,0.5,746,249,0.5,1127,344,0.5,423,0.0,0.5,8445,3421,5024
5000,9647,2,0.7,3868,1,0.7,5779,1,0.7,424,0.0,0.7,710,301,409
1192,2720,0,0.0,1100,0,0.0,1620,0,0.0,425,0.0,0.9,123,50,73
5000,2943,1975,0.12593536517652254,1186,798,0.13226097413806528,1757,1177,0.12164663454669146,426,0.8,0.1,7456,2975,4481
5000,2835,1683,0.13203716031382617,1138,685,0.12264015923401302,1697,998,0.13848700574435932,427,0.8,0.3,7582,3077,4505
5000,3388,1806,0.146574660609943,1324,710,0.14895757598004214,2064,1096,0.14503098368223277,428,0.8,0.5,7303,2854,4449
5000,5582,1322,0.18728197504017965,2206,524,0.1823739741007282,3376,798,0.1905047726495439,429,0.8,0.7,4820,1958,2862
5000,5235,1376,0.18808429289088702,2058,556,0.1790891030203748,3177,820,0.19418347041284395,430,0.8,0.9,5173,2090,3083
5000,2135,3003,0.09999999999999991,853,1214,0.10000000000000009,1282,1789,0.09999999999999987,431,0.0,0.1,8373,3317,5056
5000,904,731,0.3000000000000004,345,285,0.2999999999999999,559,446,0.3000000000000002,432,0.0,0.3,9586,3871,5715
5000,1564,619,0.5,654,259,0.5,910,360,0.5,433,0.0,0.5,8728,3436,5292
2315,4792,0,0.0,1878,0,0.0,2914,0,0.0,434,0.0,0.7,338,124,214
513,1516,0,0.0,610,0,0.0,906,0,0.0,435,0.0,0.9,26,14,12
5000,3438,1920,0.1458402926536847,1360,750,0.14905106554223319,2078,1170,0.14378210490461513,436,0.8,0.1,6991,2801,4190
5000,2688,1851,0.13544759795657213,1060,747,0.14317446320245666,1628,1104,0.1302193657657426,437,0.8,0.3,7702,3065,4637
5000,4773,1599,0.16562719218094815,1904,661,0.17010902364338965,2869,938,0.16246888664078415,438,0.8,0.5,5751,2294,3457
5000,4869,1668,0.16998610049599258,1936,683,0.1594935325835603,2933,985,0.1772616577388264,439,0.8,0.7,5555,2187,3368
5000,8674,377,0.24620897981939488,3434,155,0.23426792878944777,5240,222,0.25454620013309665,440,0.8,0.9,1663,667,996
5000,1981,2894,0.09999999999999999,794,1187,0.10000000000000006,1187,1707,0.09999999999999992,441,0.0,0.1,8474,3417,5057
5000,890,660,0.30000000000000027,365,279,0.29999999999999993,525,381,0.2999999999999998,442,0.0,0.3,9565,3925,5640
5000,1401,414,0.5,554,172,0.5,847,242,0.5,443,0.0,0.5,9112,3673,5439
465,1327,0,0.0,539,0,0.0,788,0,0.0,444,0.0,0.7,45,12,33
1215,2731,0,0.0,1098,0,0.0,1633,0,0.0,445,0.0,0.9,120,50,70
5000,2748,1804,0.12866328475709468,1116,704,0.13060859908314945,1632,1100,0.12741828358841958,446,0.8,0.1,7860,3162,4698
5000,4116,1702,0.14520100055659696,1692,661,0.146695986932056,2424,1041,0.14425173447189144,447,0.8,0.3,6370,2529,3841
5000,2214,1796,0.12146064782623349,896,718,0.1277274783713073,1318,1078,0.11728663638712122,448,0.8,0.5,8412,3330,5082
5000,6426,1296,0.17879097591914933,2554,499,0.17486078677503633,3872,797,0.18125165895918996,449,0.8,0.7,4176,1672,2504
5000,3021,1733,0.14478452685295426,1242,691,0.14254239185961803,1779,1042,0.1462713937247348,450,0.8,0.9,7177,2923,4254
5000,2023,3028,0.09999999999999996,771,1193,0.10000000000000006,1252,1835,0.09999999999999991,451,0.0,0.1,8566,3415,5151
5000,851,733,0.30000000000000043,368,297,0.2999999999999998,483,436,0.29999999999999993,452,0.0,0.3,9790,3998,5792
5000,1543,559,0.5,620,249,0.5,923,310,0.5,453,0.0,0.5,9082,3649,5433
5000,9657,30,0.6999999999999997,3833,13,0.7,5824,17,0.6999999999999998,454,0.0,0.7,781,315,466
1015,2401,0,0.0,972,0,0.0,1429,0,0.0,455,0.0,0.9,108,37,71
5000,2632,2002,0.12964082279238914,1013,788,0.13331046457385762,1619,1214,0.12725888068052985,456,0.8,0.1,7878,3217,4661
5000,2673,1963,0.13526320476900977,1080,847,0.13624830901835563,1593,1116,0.13451554948299183,457,0.8,0.3,7709,3161,4548
5000,3408,1804,0.14044413291283644,1359,718,0.138160492277341,2049,1086,0.14195394320407553,458,0.8,0.5,7069,2755,4314
1100,2566,0,0.0,978,0,0.0,1588,0,0.0,459,0.8,0.7,100,32,68
711,1873,0,0.0,745,0,0.0,1128,0,0.0,460,0.8,0.9,39,15,24
5000,1682,2694,0.09999999999999996,667,1036,0.10000000000000005,1015,1658,0.09999999999999988,461,0.0,0.1,8827,3473,5354
5000,846,647,0.30000000000000027,313,239,0.29999999999999977,533,408,0.2999999999999999,462,0.0,0.3,9465,3756,5709
5000,2037,588,0.5,782,235,0.5,1255,353,0.5,463,0.0,0.5,8382,3317,5065
5000,9409,27,0.6999999999999998,3741,10,0.7000000000000001,5668,17,0.6999999999999998,464,0.0,0.7,1057,428,629
2568,5463,0,0.0,2160,0,0.0,3303,0,0.0,465,0.0,0.9,173,66,107
5000,3014,1842,0.12578108266539154,1173,738,0.12791259931515547,1841,1104,0.1243562101223428,466,0.8,0.1,7508,2977,4531
5000,3521,1678,0.15311197956089484,1388,702,0.1476721422292096,2133,976,0.1570246494449554,467,0.8,0.3,7088,2774,4314
5000,2679,1658,0.12562044995455518,1070,657,0.13660644060310156,1609,1001,0.11840986468373099,468,0.8,0.5,7642,3128,4514
5000,5434,1555,0.18713244844604657,2165,634,0.17727176810225212,3269,921,0.19392036520822434,469,0.8,0.7,5011,2076,2935
492,1430,0,0.0,573,0,0.0,857,0,0.0,470,0.8,0.9,31,18,13
5000,3465,3097,0.09999999999999994,1406,1244,0.10000000000000007,2059,1853,0.09999999999999985,471,0.0,0.1,6963,2790,4173
5000,892,651,0.3000000000000003,364,251,0.2999999999999999,528,400,0.29999999999999977,472,0.0,0.3,9610,3805,5805
5000,1692,530,0.5,697,212,0.5,995,318,0.5,473,0.0,0.5,8774,3435,5339
5000,9243,9,0.7000000000000001,3696,1,0.7,5547,8,0.7000000000000001,474,0.0,0.7,1112,468,644
959,2228,0,0.0,874,0,0.0,1354,0,0.0,475,0.0,0.9,106,45,61
5000,4213,1756,0.16099738532150704,1724,716,0.16717940755797694,2489,1040,0.15674130078178342,476,0.8,0.1,6456,2591,3865
5000,5851,1477,0.15912344366355502,2298,571,0.15794463368019493,3553,906,0.1598663801983218,477,0.8,0.3,4852,1882,2970
5000,3589,1753,0.16734761802205647,1396,666,0.16315499705655861,2193,1087,0.16991641798803753,478,0.8,0.5,6874,2717,4157
5000,7440,956,0.2006987538251736,2967,396,0.19391350186691927,4473,560,0.20549689628136764,479,0.8,0.7,3108,1239,1869
5000,4815,1694,0.17210030947714391,1931,683,0.17423091431205306,2884,1011,0.1706609394452517,480,0.8,0.9,5649,2276,3373
5000,2145,2866,0.09999999999999992,838,1167,0.10000000000000006,1307,1699,0.09999999999999991,481,0.0,0.1,8112,3263,4849
5000,1022,658,0.3000000000000002,435,281,0.2999999999999999,587,377,0.2999999999999999,482,0.0,0.3,9456,3772,5684
5000,2199,594,0.5,902,236,0.5,1297,358,0.5,483,0.0,0.5,8256,3250,5006
5000,8285,38,0.6999999999999998,3342,16,0.6999999999999998,4943,22,0.6999999999999998,484,0.0,0.7,2123,838,1285
594,1591,0,0.0,627,0,0.0,964,0,0.0,485,0.0,0.9,35,16,19
5000,2651,1876,0.12305295121870359,1061,746,0.1213462125815333,1590,1130,0.12417970079687088,486,0.8,0.1,7641,3047,4594
5000,2509,1787,0.1218234879965753,1019,708,0.119583352065545,1490,1079,0.12329338256485096,487,0.8,0.3,8039,3243,4796
5000,3638,1855,0.16083731136798282,1432,733,0.16264423420222424,2206,1122,0.15965685286753795,488,0.8,0.5,6760,2673,4087
5000,5597,1531,0.17077253068300072,2172,621,0.1726030799040939,3425,910,0.16952333170904593,489,0.8,0.7,4873,1917,2956
5000,10269,29,0.13691552752140587,4145,7,0.12213070526181342,6124,22,0.14161978914945805,490,0.8,0.9,180,68,112
5000,2137,3032,0.09999999999999996,862,1250,0.10000000000000007,1275,1782,0.09999999999999988,491,0.0,0.1,8352,3380,4972
5000,909,713,0.3000000000000003,351,283,0.2999999999999999,558,430,0.29999999999999993,492,0.0,0.3,9630,3922,5708
5000,3657,761,0.5,1437,335,0.5,2220,426,0.5,493,0.0,0.5,6740,2719,4021
1152,2767,0,0.0,1111,0,0.0,1656,0,0.0,494,0.0,0.7,37,14,23
1106,2629,0,0.0,1034,0,0.0,1595,0,0.0,495,0.0,0.9,80,31,49
5000,3285,1708,0.1362396164438313,1302,680,0.1360745205007584,1983,1028,0.13634882387699238,496,0.8,0.1,7152,2898,4254
5000,2313,1855,0.12163699421918142,897,776,0.11945836596956053,1416,1079,0.12320382973512754,497,0.8,0.3,8222,3322,4900
5000,9507,319,0.23732237860382016,3770,144,0.22999252376688176,5737,175,0.24335380201250098,498,0.8,0.5,911,371,540
5000,8716,598,0.2017206183261924,3417,238,0.20334091408192947,5299,360,0.2006494227987884,499,0.8,0.7,1811,722,1089
5000,9336,438,0.20860795956219605,3683,168,0.21062941066780275,5653,270,0.20735016776315193,500,0.8,0.9,1219,464,755
5000,2768,3084,0.09999999999999998,1090,1213,0.10000000000000007,1678,1871,0.0999999999999999,501,0.0,0.1,7630,3006,4624
5000,1116,605,0.3000000000000004,465,255,0.2999999999999998,651,350,0.2999999999999998,502,0.0,0.3,9396,3755,5641
5000,1566,490,0.5,647,192,0.5,919,298,0.5,503,0.0,0.5,8805,3536,5269
5000,9260,23,0.7,3727,8,0.7000000000000001,5533,15,0.6999999999999998,504,0.0,0.7,1214,502,712
840,2053,0,0.0,805,0,0.0,1248,0,0.0,505,0.0,0.9,34,16,18
5000,3885,1745,0.14421302299009955,1562,680,0.14531476224180245,2323,1065,0.1435095650641296,506,0.8,0.1,6629,2622,4007
5000,3047,1921,0.1375099766487847,1237,802,0.13584504886448237,1810,1119,0.1387032492877572,507,0.8,0.3,7228,2909,4319
5000,4602,1649,0.15638827444298414,1818,654,0.15861553726665778,2784,995,0.15492432480812723,508,0.8,0.5,5790,2351,3439
5000,4309,1739,0.15734511470215803,1700,703,0.14617143985701006,2609,1036,0.1649272512042227,509,0.8,0.7,6255,2552,3703
5000,4432,1608,0.1762399053204826,1758,621,0.17773846752002354,2674,987,0.17529704095785337,510,0.8,0.9,6006,2411,3595
5000,1906,2999,0.09999999999999992,775,1197,0.10000000000000006,1131,1802,0.0999999999999999,511,0.0,0.1,8644,3534,5110
5000,886,718,0.3000000000000004,350,296,0.2999999999999998,536,422,0.2999999999999999,512,0.0,0.3,9640,3905,5735
5000,2765,833,0.5,1061,320,0.5,1704,513,0.5,513,0.0,0.5,7696,3062,4634
1277,3004,0,0.0,1214,0,0.0,1790,0,0.0,514,0.0,0.7,78,29,49
385,1237,0,0.0,486,0,0.0,751,0,0.0,515,0.0,0.9,17,7,10
5000,3344,1994,0.1328074520996896,1329,825,0.1290706189932364,2015,1169,0.13544465253837543,516,0.8,0.1,7096,2824,4272
5000,2702,1842,0.11966823038809037,1023,722,0.11733440704349778,1679,1120,0.12117271293701522,517,0.8,0.3,7702,3041,4661
5000,2528,1745,0.11852710336068957,1025,716,0.12281261556543782,1503,1029,0.11554515317740509,518,0.8,0.5,7927,3158,4769
5000,10189,10,0.06068581117844736,4144,6,0.04497543628679546,6045,4,0.08425137351592517,519,0.8,0.7,97,42,55
5000,6956,1087,0.19003567176892003,2773,417,0.19817349692968614,4183,670,0.18497078655692084,520,0.8,0.9,3527,1392,2135
5000,2359,3041,0.09999999999999994,941,1224,0.10000000000000005,1418,1817,0.09999999999999985,521,0.0,0.1,8046,3166,4880
5000,1034,1101,0.30000000000000016,427,414,0.2999999999999998,607,687,0.30000000000000043,522,0.0,0.3,9477,3811,5666
5000,1595,540,0.5,650,205,0.5,945,335,0.5,523,0.0,0.5,9062,3581,5481
2448,5039,0,0.0,2020,0,0.0,3019,0,0.0,524,0.0,0.7,232,95,137
1434,3304,0,0.0,1274,0,0.0,2030,0,0.0,525,0.0,0.9,57,18,39
5000,2669,1790,0.1246928727880344,1048,711,0.12128438847318711,1621,1079,0.12693887125685405,526,0.8,0.1,7696,3078,4618
5000,4081,1850,0.14302820947232714,1605,724,0.13897809521772175,2476,1126,0.14563236819376058,527,0.8,0.3,6241,2454,3787
5000,3221,1865,0.13412877498308487,1274,710,0.13458184823064112,1947,1155,0.133850262423981,528,0.8,0.5,7216,2809,4407
5000,3404,1823,0.1372645105497867,1357,721,0.13741513111414294,2047,1102,0.1371659647903485,529,0.8,0.7,7084,2833,4251
1077,2587,0,0.0,1012,0,0.0,1575,0,0.0,530,0.8,0.9,54,16,38
5000,1960,2923,0.09999999999999995,764,1127,0.10000000000000006,1196,1796,0.09999999999999992,531,0.0,0.1,8541,3399,5142
5000,990,657,0.30000000000000043,432,251,0.2999999999999999,558,406,0.2999999999999999,532,0.0,0.3,9327,3675,5652
5000,1415,566,0.5,557,242,0.5,858,324,0.5,533,0.0,0.5,8983,3558,5425
5000,8607,45,0.6999999999999997,3389,12,0.7000000000000001,5218,33,0.6999999999999997,534,0.0,0.7,1844,729,1115
893,2170,0,0.0,876,0,0.0,1294,0,0.0,535,0.0,0.9,76,32,44
5000,4379,1884,0.13783077318294937,1745,746,0.13497499205329205,2634,1138,0.13970284060186342,536,0.8,0.1,6133,2495,3638
5000,3016,1788,0.15151709002827887,1166,712,0.15517529841595878,1850,1076,0.14909641682007407,537,0.8,0.3,7358,3014,4344
5000,4006,1710,0.16071851486323557,1606,720,0.1561801861515038,2400,990,0.16401911756267692,538,0.8,0.5,6490,2664,3826
5000,9466,275,0.21998070485301338,3749,122,0.21986191641716415,5717,153,0.22007542504369063,539,0.8,0.7,1010,406,604
5000,5241,1569,0.18581762991131298,2110,641,0.17765087898001156,3131,928,0.19145867231105884,540,0.8,0.9,5283,2172,3111
5000,1734,2794,0.09999999999999995,684,1101,0.10000000000000005,1050,1693,0.09999999999999987,541,0.0,0.1,8653,3421,5232
5000,938,638,0.3000000000000004,368,256,0.2999999999999998,570,382,0.2999999999999998,542,0.0,0.3,9575,3840,5735
5000,1433,431,0.5,564,161,0.5,869,270,0.5,543,0.0,0.5,9015,3617,5398
1861,4086,0,0.0,1634,0,0.0,2452,0,0.0,544,0.0,0.7,160,52,108
943,2408,0,0.0,981,0,0.0,1427,0,0.0,545,0.0,0.9,48,15,33
5000,3164,1959,0.138871254471558,1282,773,0.13734500354578583,1882,1186,0.13986602004122228,546,0.8,0.1,7438,2931,4507
5000,3788,1809,0.1630691576654381,1554,727,0.16368301693785167,2234,1082,0.1626567032374855,547,0.8,0.3,6678,2658,4020
5000,4656,1643,0.17173904571143173,1892,666,0.1740820791307893,2764,977,0.170141849951665,548,0.8,0.5,5709,2299,3410
5000,8810,470,0.1665597841326892,3559,194,0.16231382946198575,5251,276,0.16954425951716923,549,0.8,0.7,1667,670,997
5000,5668,1303,0.16224882083490363,2322,529,0.15946307430724693,3346,774,0.16415277421104113,550,0.8,0.9,4900,1961,2939
5000,2120,3064,0.0999999999999999,849,1257,0.10000000000000006,1271,1807,0.09999999999999988,551,0.0,0.1,8323,3346,4977
5000,897,677,0.30000000000000027,358,263,0.2999999999999999,539,414,0.2999999999999998,552,0.0,0.3,9549,3807,5742
5000,2014,607,0.5,812,227,0.5,1202,380,0.5,553,0.0,0.5,8471,3340,5131
2105,4650,0,0.0,1851,0,0.0,2799,0,0.0,554,0.0,0.7,103,37,66
1015,2557,0,0.0,996,0,0.0,1561,0,0.0,555,0.0,0.9,50,20,30
5000,2775,1877,0.1268212121740704,1143,773,0.12253139534040161,1632,1104,0.1298248610983693,556,0.8,0.1,7422,3010,4412
5000,3322,1797,0.1605289336225008,1340,704,0.16539585485001998,1982,1093,0.15739415544850852,557,0.8,0.3,7228,2862,4366
5000,3093,1841,0.14455392117265703,1202,701,0.1516274421326671,1891,1140,0.14020432626654544,558,0.8,0.5,7407,2956,4451
5000,5824,1425,0.17515990674213272,2316,580,0.1789991433555196,3508,845,0.17252469107850626,559,0.8,0.7,4821,1991,2830
5000,9053,414,0.2251878793921999,3514,168,0.2280556876056931,5539,246,0.22322937622200947,560,0.8,0.9,1374,530,844
5000,2623,3221,0.09999999999999994,1051,1310,0.09999999999999994,1572,1911,0.09999999999999987,561,0.0,0.1,7997,3180,4817
5000,965,677,0.30000000000000027,419,271,0.29999999999999977,546,406,0.2999999999999999,562,0.0,0.3,9449,3778,5671
5000,1547,576,0.5,636,209,0.5,911,367,0.5,563,0.0,0.5,9161,3617,5544
802,2007,0,0.0,805,0,0.0,1202,0,0.0,564,0.0,0.7,68,21,47
1991,4460,0,0.0,1809,0,0.0,2651,0,0.0,565,0.0,0.9,148,59,89
5000,3482,1745,0.1426856898036915,1408,705,0.13964235424352067,2074,1040,0.14474872015938428,566,0.8,0.1,6933,2867,4066
5000,3450,1781,0.14703765305384742,1453,688,0.15387456245903075,1997,1093,0.14273409068352155,567,0.8,0.3,7057,2832,4225
5000,3185,1834,0.14722692115584504,1265,750,0.14308536616903297,1920,1084,0.1500923881670157,568,0.8,0.5,7041,2838,4203
5000,3963,1903,0.15067176187458958,1566,802,0.15223678535790822,2397,1101,0.14953175385131842,569,0.8,0.7,6576,2673,3903
5000,10151,37,0.09248377842323324,4017,15,0.08468814313070336,6134,22,0.09779898430450361,570,0.8,0.9,291,134,157
5000,2074,2987,0.09999999999999994,814,1228,0.10000000000000006,1260,1759,0.09999999999999985,571,0.0,0.1,8542,3435,5107
5000,917,657,0.30000000000000043,370,271,0.29999999999999977,547,386,0.2999999999999999,572,0.0,0.3,9578,3798,5780
5000,4078,754,0.5,1676,303,0.5,2402,451,0.5,573,0.0,0.5,6479,2552,3927
5000,8819,65,0.7000000000000005,3439,24,0.6999999999999998,5380,41,0.6999999999999998,574,0.0,0.7,1567,648,919
1652,3605,0,0.0,1391,0,0.0,2214,0,0.0,575,0.0,0.9,150,68,82
5000,2939,1984,0.12686926008707358,1152,794,0.1308915369100756,1787,1190,0.12418548882870072,576,0.8,0.1,7647,3018,4629
5000,3638,1840,0.1558022205674822,1403,741,0.15099312260114423,2235,1099,0.15904475158937142,577,0.8,0.3,6769,2710,4059
5000,3279,1731,0.14601421557081537,1270,721,0.14611228665786236,2009,1010,0.14594420640867584,578,0.8,0.5,7229,2991,4238
5000,4037,1601,0.15733850468108418,1573,650,0.15190796111612218,2464,951,0.16105023266975438,579,0.8,0.7,6373,2576,3797
5000,5751,1362,0.1723906657707131,2326,569,0.17506703370996526,3425,793,0.17047029583700005,580,0.8,0.9,4916,2012,2904
5000,2269,2996,0.09999999999999991,924,1234,0.10000000000000006,1345,1762,0.09999999999999985,581,0.0,0.1,8195,3316,4879
5000,933,634,0.3000000000000003,367,242,0.3,566,392,0.2999999999999998,582,0.0,0.3,9472,3796,5676
5000,2616,777,0.5,1085,295,0.5,1531,482,0.5,583,0.0,0.5,7951,3169,4782
2599,5239,0,0.0,2087,0,0.0,3152,0,0.0,584,0.0,0.7,355,145,210
1622,3701,0,0.0,1498,0,0.0,2203,0,0.0,585,0.0,0.9,94,42,52
5000,3174,1856,0.138825363607547,1257,749,0.1354552465873298,1917,1107,0.14110559635202988,586,0.8,0.1,7202,2873,4329
5000,3909,1728,0.13475936912689232,1484,781,0.14021631376963647,2425,947,0.13025897444264395,587,0.8,0.3,6643,2810,3833
5000,3617,1892,0.14758381836292758,1481,779,0.1427726640314382,2136,1113,0.15095119412593758,588,0.8,0.5,6821,2787,4034
5000,5645,1380,0.1951971824111039,2178,558,0.2064156811454729,3467,822,0.18758170516806516,589,0.8,0.7,4932,2012,2920
5000,5594,1422,0.1954272498240209,2229,575,0.19596398592303446,3365,847,0.19506287761984992,590,0.8,0.9,5078,2029,3049
5000,1710,2822,0.09999999999999995,687,1134,0.10000000000000006,1023,1688,0.0999999999999999,591,0.0,0.1,8741,3482,5259
5000,961,610,0.30000000000000016,337,261,0.2999999999999999,624,349,0.2999999999999998,592,0.0,0.3,9655,3848,5807
5000,1869,517,0.5,727,208,0.5,1142,309,0.5,593,0.0,0.5,8699,3447,5252
3344,6855,0,0.0,2652,0,0.0,4203,0,0.0,594,0.0,0.7,326,124,202
1415,3205,0,0.0,1350,0,0.0,1855,0,0.0,595,0.0,0.9,76,25,51
5000,3032,1892,0.12890506880486793,1210,730,0.13146428051587905,1822,1162,0.12729730241154769,596,0.8,0.1,7418,2977,4441
5000,2583,1681,0.13225038288933513,1024,630,0.1387906661294914,1559,1051,0.12832994669399883,597,0.8,0.3,7803,3084,4719
5000,4392,1686,0.14851138274726075,1795,684,0.15420974050827202,2597,1002,0.1446214858325585,598,0.8,0.5,6124,2491,3633
5000,6442,1277,0.17879147798706277,2562,526,0.18793784631808785,3880,751,0.17238536647958047,599,0.8,0.7,3898,1548,2350
5000,6461,1179,0.18623324900350743,2561,472,0.18798455816538365,3900,707,0.18506405816276403,600,0.8,0.9,3970,1612,2358
5000,1878,2996,0.09999999999999991,738,1179,0.10000000000000007,1140,1817,0.09999999999999985,601,0.0,0.1,8601,3386,5215
5000,967,603,0.3000000000000003,408,244,0.29999999999999993,559,359,0.2999999999999998,602,0.0,0.3,9568,3832,5736
5000,3805,806,0.5,1552,322,0.5,2253,484,0.5,603,0.0,0.5,6692,2726,3966
1500,3282,0,0.0,1358,0,0.0,1924,0,0.0,604,0.0,0.7,155,59,96
2669,5537,0,0.0,2165,0,0.0,3372,0,0.0,605,0.0,0.9,205,87,118
5000,4034,1782,0.15010649768687725,1600,707,0.15441977002816543,2434,1075,0.14726976880753687,606,0.8,0.1,6363,2507,3856
5000,2831,1731,0.12590549490149652,1153,713,0.12690992080027347,1678,1018,0.1252020021059877,607,0.8,0.3,7450,2988,4462
5000,2941,1827,0.12073989522558505,1180,699,0.12095266281407709,1761,1128,0.12060804722526954,608,0.8,0.5,7425,2943,4482
5000,5034,1489,0.17912781639369219,2049,591,0.1770588341908252,2985,898,0.18048947394591308,609,0.8,0.7,5414,2157,3257
5000,6335,1246,0.19227377037869606,2467,475,0.1871003171571159,3868,771,0.1954610470067773,610,0.8,0.9,4123,1647,2476
5000,2524,3194,0.09999999999999988,1055,1238,0.10000000000000006,1469,1956,0.09999999999999991,611,0.0,0.1,7920,3078,4842
5000,926,700,0.3000000000000004,373,273,0.29999999999999977,553,427,0.2999999999999999,612,0.0,0.3,9538,3805,5733
5000,1796,535,0.5,740,213,0.5,1056,322,0.5,613,0.0,0.5,8546,3440,5106
5000,8103,73,0.7000000000000003,3255,30,0.6999999999999997,4848,43,0.6999999999999997,614,0.0,0.7,2250,894,1356
945,2324,0,0.0,928,0,0.0,1396,0,0.0,615,0.0,0.9,81,27,54
5000,3079,1907,0.14128130983216325,1225,757,0.13546512394101082,1854,1150,0.14510987741442608,616,0.8,0.1,7486,2997,4489
5000,3130,1839,0.14055860287627908,1243,764,0.13951495109361467,1887,1075,0.1413003237711214,617,0.8,0.3,7636,3121,4515
5000,2454,1781,0.12529017545343277,995,701,0.1256739969877048,1459,1080,0.12504104684646553,618,0.8,0.5,8074,3202,4872
5000,6694,1104,0.21100424107388688,2758,454,0.21666700725251292,3936,650,0.20704901669681577,619,0.8,0.7,3796,1577,2219
5000,3389,1846,0.13607972309883526,1410,725,0.1407256575484889,1979,1121,0.13307499296859543,620,0.8,0.9,7203,2798,4405
5000,2047,3042,0.09999999999999994,843,1233,0.10000000000000006,1204,1809,0.09999999999999988,621,0.0,0.1,8369,3309,5060
5000,877,692,0.3000000000000002,337,270,0.29999999999999977,540,422,0.2999999999999999,622,0.0,0.3,9614,3808,5806
5000,5771,639,0.5,2323,257,0.5,3448,382,0.5,623,0.0,0.5,4677,1868,2809
2753,5954,0,0.0,2387,0,0.0,3567,0,0.0,624,0.0,0.7,124,51,73
852,2108,0,0.0,817,0,0.0,1291,0,0.0,625,0.0,0.9,36,14,22
5000,2615,1899,0.13136844161440908,1047,729,0.13036834421230425,1568,1170,0.13199157922648977,626,0.8,0.1,7977,3205,4772
5000,2995,2040,0.13635274902188294,1179,816,0.13740388868404468,1816,1224,0.13565198924710833,627,0.8,0.3,7496,3048,4448
5000,3059,1702,0.14782971244830648,1194,682,0.14894962667479505,1865,1020,0.14708090705373283,628,0.8,0.5,7313,2891,4422
1105,2703,0,0.0,1093,0,0.0,1610,0,0.0,629,0.8,0.7,69,25,44
5000,7765,903,0.20601703816337755,3054,373,0.19900143166560216,4711,530,0.21095443669860423,630,0.8,0.9,2767,1111,1656
5000,1992,3015,0.09999999999999996,813,1236,0.10000000000000006,1179,1779,0.0999999999999999,631,0.0,0.1,8406,3349,5057
5000,984,656,0.30000000000000043,400,275,0.29999999999999993,584,381,0.2999999999999998,632,0.0,0.3,9450,3798,5652
5000,4425,838,0.5,1716,331,0.5,2709,507,0.5,633,0.0,0.5,6026,2355,3671
1162,2669,0,0.0,1078,0,0.0,1591,0,0.0,634,0.0,0.7,100,42,58
1068,2489,0,0.0,996,0,0.0,1493,0,0.0,635,0.0,0.9,82,30,52
5000,2474,1977,0.13444300305148693,967,763,0.1393341463152836,1507,1214,0.1313689154812423,636,0.8,0.1,8045,3213,4832
5000,2734,1828,0.13976182024148004,1114,721,0.13342827593181525,1620,1107,0.1438869200131768,637,0.8,0.3,7873,3135,4738
5000,4259,1687,0.1630967930470504,1739,679,0.16188586122440612,2520,1008,0.1639124901775816,638,0.8,0.5,6262,2399,3863
5000,2798,1843,0.12996649773748475,1083,726,0.13090212315675068,1715,1117,0.1293583830961355,639,0.8,0.7,7712,3077,4635
934,2205,0,0.0,884,0,0.0,1321,0,0.0,640,0.8,0.9,90,32,58
5000,1823,2697,0.10000000000000002,748,1065,0.10000000000000005,1075,1632,0.09999999999999987,641,0.0,0.1,8656,3482,5174
5000,1021,693,0.30000000000000027,423,284,0.2999999999999999,598,409,0.2999999999999999,642,0.0,0.3,9450,3787,5663
5000,1584,477,0.5,673,202,0.5,911,275,0.5,643,0.0,0.5,8945,3580,5365
2278,4889,0,0.0,1901,0,0.0,2988,0,0.0,644,0.0,0.7,109,37,72
872,2157,0,0.0,843,0,0.0,1314,0,0.0,645,0.0,0.9,85,32,53
5000,3199,2031,0.13659667082605056,1287,835,0.14109294402280892,1912,1196,0.13345755032496917,646,0.8,0.1,7417,2988,4429
5000,3627,1709,0.14389943160353108,1409,687,0.1491860197179411,2218,1022,0.1403457270686978,647,0.8,0.3,6816,2698,4118
5000,3792,1720,0.1390991511359863,1555,687,0.1392252295548108,2237,1033,0.1390153022746771,648,0.8,0.5,6552,2611,3941
5000,5819,1345,0.20097103866841692,2278,544,0.20702142944802732,3541,801,0.19686190934992986,649,0.8,0.7,4799,1902,2897
5000,5905,1272,0.18449623930054482,2397,509,0.1859515340059125,3508,763,0.1835254070527964,650,0.8,0.9,4588,1844,2744
5000,1862,2757,0.09999999999999994,754,1120,0.10000000000000007,1108,1637,0.09999999999999996,651,0.0,0.1,8534,3479,5055
5000,962,628,0.3000000000000002,380,248,0.29999999999999993,582,380,0.2999999999999999,652,0.0,0.3,9432,3770,5662
5000,1634,440,0.5,648,169,0.5,986,271,0.5,653,0.0,0.5,8867,3582,5285
5000,9615,12,0.7000000000000001,3920,3,0.6999999999999998,5695,9,0.7000000000000001,654,0.0,0.7,814,301,513
2510,5443,0,0.0,2189,0,0.0,3254,0,0.0,655,0.0,0.9,189,83,106
5000,3360,1794,0.1403150213651289,1320,699,0.14185312048478813,2040,1095,0.13933316631066153,656,0.8,0.1,6874,2718,4156
5000,3107,1901,0.1233626494322864,1227,767,0.12702787980768954,1880,1134,0.12088360913428446,657,0.8,0.3,7445,2961,4484
5000,5861,1410,0.19227404690255512,2338,557,0.17767933697500365,3523,853,0.20180423849651313,658,0.8,0.5,4628,1872,2756
5000,4428,1492,0.15711588557121806,1789,582,0.15067887931374324,2639,910,0.16123274012270206,659,0.8,0.7,5964,2375,3589
5000,7374,1025,0.1801272788517473,2966,391,0.18152756210122273,4408,634,0.17926369722628224,660,0.8,0.9,3220,1251,1969
5000,1913,2973,0.09999999999999995,768,1189,0.10000000000000005,1145,1784,0.09999999999999988,661,0.0,0.1,8492,3390,5102
5000,920,684,0.3000000000000004,345,264,0.2999999999999998,575,420,0.2999999999999999,662,0.0,0.3,9617,3849,5768
5000,1727,443,0.5,704,194,0.5,1023,249,0.5,663,0.0,0.5,8739,3483,5256
5000,9073,103,0.7000000000000001,3707,50,0.6999999999999998,5366,53,0.7000000000000001,664,0.0,0.7,1305,527,778
1850,4031,0,0.0,1568,0,0.0,2463,0,0.0,665,0.0,0.9,169,63,106
5000,4401,1772,0.17025084685226488,1754,667,0.1529293303346282,2647,1105,0.1807064590850826,666,0.8,0.1,6237,2471,3766
5000,2957,1673,0.13407941362472578,1202,626,0.1346254046819477,1755,1047,0.13375296624953867,667,0.8,0.3,7525,2987,4538
5000,3422,1852,0.13613695624562624,1354,713,0.13625023071789555,2068,1139,0.136066047818297,668,0.8,0.5,6859,2716,4143
5000,10323,40,0.14897870250418016,4050,15,0.18382363927037068,6273,25,0.12807174044446576,669,0.8,0.7,373,153,220
1156,2711,0,0.0,1073,0,0.0,1638,0,0.0,670,0.8,0.9,78,31,47
5000,2643,3125,0.0999999999999999,1076,1261,0.10000000000000006,1567,1864,0.09999999999999991,671,0.0,0.1,7923,3222,4701
5000,938,654,0.3000000000000004,380,261,0.2999999999999999,558,393,0.2999999999999998,672,0.0,0.3,9507,3810,5697
5000,2202,732,0.5,874,293,0.5,1328,439,0.5,673,0.0,0.5,8213,3333,4880
5000,8699,81,0.7000000000000005,3430,32,0.6999999999999997,5269,49,0.7,674,0.0,0.7,1689,677,1012
755,1984,0,0.0,806,0,0.0,1178,0,0.0,675,0.0,0.9,43,15,28
5000,3266,1925,0.13178283600053337,1331,772,0.1313729377467336,1935,1153,0.1320572865225918,676,0.8,0.1,7335,2933,4402
5000,2352,1792,0.12452117105538361,934,753,0.11832920215864266,1418,1039,0.12900870963021127,677,0.8,0.3,8095,3214,4881
5000,3930,1574,0.16461795945420804,1572,639,0.16189477412271358,2358,935,0.16647904547220269,678,0.8,0.5,6503,2620,3883
5000,4275,1705,0.16644945215620244,1733,683,0.16572092495412494,2542,1022,0.1669363250319548,679,0.8,0.7,6281,2468,3813
785,1984,0,0.0,803,0,0.0,1181,0,0.0,680,0.8,0.9,55,23,32
5000,2361,2984,0.09999999999999994,914,1218,0.10000000000000009,1447,1766,0.09999999999999994,681,0.0,0.1,8126,3344,4782
5000,1075,632,0.30000000000000027,455,252,0.2999999999999999,620,380,0.2999999999999999,682,0.0,0.3,9460,3919,5541
5000,1379,456,0.5,532,186,0.5,847,270,0.5,683,0.0,0.5,9160,3674,5486
1524,3383,0,0.0,1349,0,0.0,2034,0,0.0,684,0.0,0.7,106,52,54
1507,3284,0,0.0,1335,0,0.0,1949,0,0.0,685,0.0,0.9,139,47,92
5000,2981,1813,0.13227416016515003,1215,716,0.13317651147341616,1766,1097,0.13168520525474114,686,0.8,0.1,7278,2957,4321
5000,4401,1650,0.1511327026285279,1790,674,0.14451321794962144,2611,976,0.1557039451219531,687,0.8,0.3,6012,2474,3538
5000,5917,1429,0.18700115418871116,2396,566,0.18344955098139754,3521,863,0.18933047911957976,688,0.8,0.5,4647,1822,2825
5000,3559,1896,0.1368844491599401,1358,765,0.14587519206254623,2201,1131,0.13080317743536563,689,0.8,0.7,6852,2739,4113
5000,7287,1118,0.1785084554902938,2965,437,0.1780789129460464,4322,681,0.1787840943916684,690,0.8,0.9,3412,1367,2045
5000,2132,2971,0.09999999999999996,866,1161,0.10000000000000005,1266,1810,0.09999999999999988,691,0.0,0.1,8253,3291,4962
5000,984,677,0.30000000000000027,392,265,0.2999999999999998,592,412,0.2999999999999998,692,0.0,0.3,9602,3809,5793
5000,3016,911,0.5,1193,362,0.5,1823,549,0.5,693,0.0,0.5,7516,2972,4544
1285,2995,0,0.0,1180,0,0.0,1815,0,0.0,694,0.0,0.7,61,25,36
1980,4273,0,0.0,1690,0,0.0,2583,0,0.0,695,0.0,0.9,189,80,109
5000,3765,1788,0.1404781146550882,1490,731,0.1460938366068388,2275,1057,0.13659439398646975,696,0.8,0.1,6722,2705,4017
5000,3267,1655,0.1397134339012169,1245,678,0.13374102150644898,2022,977,0.14385805580874267,697,0.8,0.3,7353,2987,4366
5000,4120,1627,0.17025881078831245,1662,613,0.18426191866007371,2458,1014,0.16179342111830283,698,0.8,0.5,6378,2522,3856
5000,4223,1874,0.14651515669099832,1705,772,0.14464863355416852,2518,1102,0.1478227391425705,699,0.8,0.7,6450,2565,3885
685,1781,0,0.0,715,0,0.0,1066,0,0.0,700,0.8,0.9,61,20,41
5000,2252,2942,0.0999999999999999,922,1148,0.10000000000000009,1330,1794,0.09999999999999984,701,0.0,0.1,8011,3155,4856
5000,937,691,0.3000000000000002,373,292,0.2999999999999999,564,399,0.29999999999999977,702,0.0,0.3,9539,3923,5616
5000,2213,645,0.5,903,249,0.5,1310,396,0.5,703,0.0,0.5,8232,3312,4920
1472,3247,0,0.0,1295,0,0.0,1952,0,0.0,704,0.0,0.7,130,53,77
2578,5381,0,0.0,2138,0,0.0,3243,0,0.0,705,0.0,0.9,288,115,173
5000,3430,1944,0.13143312172785665,1393,807,0.13313736882148033,2037,1137,0.13022351099385984,706,0.8,0.1,6986,2850,4136
5000,2536,1794,0.13157777591778652,1024,707,0.13276154853870453,1512,1087,0.13080783365192725,707,0.8,0.3,8028,3237,4791
5000,2625,1677,0.13407894613087612,1065,656,0.1355808735056759,1560,1021,0.13311394675980015,708,0.8,0.5,7939,3135,4804
5000,9360,284,0.175913824373582,3782,118,0.1484519021307304,5578,166,0.19543494982332,709,0.8,0.7,1038,413,625
861,2124,0,0.0,856,0,0.0,1268,0,0.0,710,0.8,0.9,41,15,26
5000,1749,2897,0.09999999999999998,694,1166,0.10000000000000006,1055,1731,0.0999999999999999,711,0.0,0.1,8764,3489,5275
5000,909,708,0.30000000000000027,358,308,0.29999999999999993,551,400,0.29999999999999977,712,0.0,0.3,9628,3800,5828
5000,2066,695,0.5,823,283,0.5,1243,412,0.5,713,0.0,0.5,8489,3394,5095
5000,9076,53,0.7000000000000001,3607,20,0.7,5469,33,0.6999999999999997,714,0.0,0.7,1215,512,703
802,1977,0,0.0,794,0,0.0,1183,0,0.0,715,0.0,0.9,44,17,27
5000,3275,1895,0.13400601042097868,1318,758,0.13668332554852508,1957,1137,0.13222113366928112,716,0.8,0.1,7252,2879,4373
5000,3183,1847,0.14828112245571248,1321,732,0.13753648027104554,1862,1115,0.1553350041410723,717,0.8,0.3,7395,2918,4477
5000,2793,1676,0.1414323270448137,1085,669,0.14325516169390776,1708,1007,0.1402213276602617,718,0.8,0.5,7672,3137,4535
5000,9365,419,0.17818633226685243,3714,177,0.1636090748759077,5651,242,0.1888482106065104,719,0.8,0.7,1131,462,669
1621,3615,0,0.0,1385,0,0.0,2230,0,0.0,720,0.8,0.9,63,29,34
5000,2001,2978,0.09999999999999995,789,1202,0.10000000000000007,1212,1776,0.0999999999999999,721,0.0,0.1,8493,3404,5089
5000,903,658,0.3000000000000002,369,265,0.2999999999999998,534,393,0.2999999999999998,722,0.0,0.3,9651,3841,5810
5000,2083,603,0.5,828,238,0.5,1255,365,0.5,723,0.0,0.5,8533,3430,5103
5000,9147,31,0.6999999999999997,3681,15,0.6999999999999998,5466,16,0.6999999999999998,724,0.0,0.7,1246,521,725
795,2022,0,0.0,797,0,0.0,1225,0,0.0,725,0.0,0.9,76,19,57
5000,3783,1764,0.13743913730637244,1508,721,0.13449808561870014,2275,1043,0.13947221330523318,726,0.8,0.1,6795,2740,4055
5000,3615,1909,0.14962000217166976,1459,736,0.15224348436788124,2156,1173,0.14797389569561542,727,0.8,0.3,6852,2778,4074
5000,5361,1604,0.181017630405664,2166,636,0.18587893940124067,3195,968,0.1778236298672478,728,0.8,0.5,5376,2149,3227
5000,9980,166,0.17645985739117043,3975,53,0.1709002382103343,6005,113,0.17906746638749182,729,0.8,0.7,482,171,311
5000,10101,88,0.2904922761177321,3997,42,0.2824068165563525,6104,46,0.29787465223899184,730,0.8,0.9,292,128,164
5000,2098,2967,0.09999999999999998,832,1232,0.10000000000000006,1266,1735,0.09999999999999994,731,0.0,0.1,8358,3393,4965
5000,1004,674,0.3000000000000002,382,279,0.29999999999999993,622,395,0.2999999999999998,732,0.0,0.3,9660,3891,5769
5000,4115,767,0.5,1636,302,0.5,2479,465,0.5,733,0.0,0.5,6238,2505,3733
1048,2425,0,0.0,968,0,0.0,1457,0,0.0,734,0.0,0.7,89,35,54
755,1946,0,0.0,806,0,0.0,1140,0,0.0,735,0.0,0.9,48,15,33
5000,3816,1830,0.13812343879999933,1556,738,0.13148795581501796,2260,1092,0.14260785861951966,736,0.8,0.1,6632,2653,3979
5000,2435,1743,0.11663405242097727,949,708,0.11527031321180568,1486,1035,0.11756692909739609,737,0.8,0.3,8233,3326,4907
5000,3186,1810,0.1429068702164929,1266,737,0.14697079999788407,1920,1073,0.14011552236105454,738,0.8,0.5,7271,2950,4321
5000,9520,284,0.19423487454124128,3871,113,0.18690252673291088,5649,171,0.1990802271865122,739,0.8,0.7,1013,402,611
1675,3709,0,0.0,1514,0,0.0,2195,0,0.0,740,0.8,0.9,124,42,82
5000,2201,2852,0.09999999999999995,912,1124,0.10000000000000006,1289,1728,0.09999999999999985,741,0.0,0.1,8286,3341,4945
5000,868,724,0.3000000000000003,333,282,0.2999999999999999,535,442,0.3000000000000001,742,0.0,0.3,9423,3709,5714
5000,2487,678,0.5,1006,283,0.5,1481,395,0.5,743,0.0,0.5,7894,3151,4743
2188,4625,0,0.0,1895,0,0.0,2730,0,0.0,744,0.0,0.7,200,71,129
3692,7401,0,0.0,2893,0,0.0,4508,0,0.0,745,0.0,0.9,450,195,255
5000,2522,1925,0.13122159716437637,1040,757,0.1305621668533332,1482,1168,0.1316489847889138,746,0.8,0.1,7928,3188,4740
5000,3079,1797,0.12673272147826348,1244,719,0.12152962180425464,1835,1078,0.1302030634686274,747,0.8,0.3,7492,3047,4445
5000,4964,1628,0.16361121493559524,1994,645,0.16382803207821087,2970,983,0.16346894936388906,748,0.8,0.5,5729,2232,3497
5000,8052,915,0.16714415122316914,3220,339,0.17251463416654847,4832,576,0.1639833982408677,749,0.8,0.7,2781,1072,1709
5000,9509,270,0.20913287650840326,3744,113,0.19147869617402422,5765,157,0.22183938846881626,750,0.8,0.9,1014,401,613
5000,1787,2959,0.09999999999999999,693,1193,0.10000000000000006,1094,1766,0.09999999999999994,751,0.0,0.1,8800,3568,5232
5000,901,618,0.30000000000000027,359,230,0.2999999999999999,542,388,0.2999999999999999,752,0.0,0.3,9468,3853,5615
5000,7351,457,0.5,2927,179,0.5,4424,278,0.5,753,0.0,0.5,3142,1208,1934
2514,5314,0,0.0,2160,0,0.0,3154,0,0.0,754,0.0,0.7,111,47,64
2826,5932,0,0.0,2325,0,0.0,3607,0,0.0,755,0.0,0.9,209,88,121
5000,3979,1957,0.13735059959355825,1556,787,0.14004301874383684,2423,1170,0.13553954500272983,756,0.8,0.1,6436,2594,3842
5000,2730,1914,0.12757782691274597,1104,770,0.1241119106874487,1626,1144,0.1299106551413114,757,0.8,0.3,7910,3174,4736
5000,3599,1789,0.12863841389612934,1436,693,0.12533490534791117,2163,1096,0.13072721993984762,758,0.8,0.5,6833,2686,4147
515,1497,0,0.0,604,0,0.0,893,0,0.0,759,0.8,0.7,15,5,10
512,1488,0,0.0,584,0,0.0,904,0,0.0,760,0.8,0.9,26,11,15
5000,2386,3009,0.09999999999999988,952,1207,0.10000000000000009,1434,1802,0.0999999999999999,761,0.0,0.1,7999,3198,4801
5000,1116,673,0.3000000000000005,478,275,0.29999999999999993,638,398,0.2999999999999998,762,0.0,0.3,9329,3814,5515
5000,2014,691,0.5,789,288,0.5,1225,403,0.5,763,0.0,0.5,8467,3353,5114
5000,9318,18,0.7,3712,6,0.7000000000000001,5606,12,0.7000000000000001,764,0.0,0.7,1165,496,669
1636,3671,0,0.0,1443,0,0.0,2228,0,0.0,765,0.0,0.9,149,62,87
5000,4072,1827,0.13391737852686011,1642,747,0.13871039807577867,2430,1080,0.1306022066721914,766,0.8,0.1,6479,2566,3913
5000,3154,1762,0.14719497640358725,1276,700,0.14654466006484118,1878,1062,0.14762362182460625,767,0.8,0.3,7337,2916,4421
5000,2954,1942,0.1324771501987378,1170,816,0.13670115134563784,1784,1126,0.12941606233384392,768,0.8,0.5,7572,3035,4537
5000,6750,1114,0.1993751044935126,2696,451,0.20352898863527372,4054,663,0.19654946083147004,769,0.8,0.7,3543,1414,2129
5000,8275,672,0.2041835835630117,3378,249,0.20126450076124935,4897,423,0.20590190890021906,770,0.8,0.9,2352,923,1429
5000,1900,2855,0.09999999999999996,740,1141,0.10000000000000007,1160,1714,0.09999999999999991,771,0.0,0.1,8467,3345,5122
5000,975,642,0.30000000000000016,384,264,0.2999999999999998,591,378,0.2999999999999999,772,0.0,0.3,9596,3847,5749
5000,2964,708,0.5,1199,278,0.5,1765,430,0.5,773,0.0,0.5,7546,2986,4560
5000,9925,2,0.7,3989,1,0.7,5936,1,0.7,774,0.0,0.7,508,201,307
1339,3134,0,0.0,1309,0,0.0,1825,0,0.0,775,0.0,0.9,121,41,80
5000,2530,1784,0.13071389471186085,986,696,0.12917688950074083,1544,1088,0.1316971259866214,776,0.8,0.1,7882,3172,4710
5000,3632,1860,0.15554375818608682,1456,744,0.15506403661760157,2176,1116,0.15586357256507694,777,0.8,0.3,6642,2711,3931
5000,3520,1781,0.15569293450770136,1387,668,0.1563924121119465,2133,1113,0.1552731222528623,778,0.8,0.5,6958,2730,4228
5000,7341,919,0.17258381916351223,2892,376,0.15990574023307733,4449,543,0.18136274674701772,779,0.8,0.7,3137,1223,1914
5000,7154,1039,0.1743624844985702,2803,425,0.18017664271258507,4351,614,0.17033802645141005,780,0.8,0.9,3420,1334,2086
5000,2304,2994,0.09999999999999992,923,1191,0.10000000000000006,1381,1803,0.0999999999999999,781,0.0,0.1,8178,3252,4926
5000,931,667,0.3000000000000004,357,267,0.2999999999999998,574,400,0.29999999999999977,782,0.0,0.3,9592,3805,5787
5000,2624,701,0.5,1019,267,0.5,1605,434,0.5,783,0.0,0.5,7854,3090,4764
5000,9435,24,0.6999999999999998,3806,10,0.7000000000000001,5629,14,0.7,784,0.0,0.7,1082,451,631
2302,4846,0,0.0,1979,0,0.0,2867,0,0.0,785,0.0,0.9,309,111,198
5000,2146,1953,0.11628796516421493,819,803,0.11569995071686774,1327,1150,0.11669855264353647,786,0.8,0.1,8468,3437,5031
5000,2811,1798,0.1400255039451699,1098,737,0.13640185886440503,1713,1061,0.14254258822841565,787,0.8,0.3,7842,3151,4691
5000,3236,1759,0.1518427363836287,1278,694,0.15014730342946553,1958,1065,0.15294755372652924,788,0.8,0.5,7024,2867,4157
5000,3885,1806,0.15240862453505305,1577,769,0.15220839000518624,2308,1037,0.15255711089326662,789,0.8,0.7,6469,2649,3820
5000,5728,1293,0.19465009054000101,2317,566,0.18354143658557623,3411,727,0.20329864368746248,790,0.8,0.9,4802,1945,2857
5000,2752,3113,0.09999999999999991,1114,1262,0.10000000000000007,1638,1851,0.09999999999999985,791,0.0,0.1,7811,3077,4734
5000,904,626,0.30000000000000016,361,242,0.3,543,384,0.2999999999999998,792,0.0,0.3,9423,3814,5609
5000,1571,489,0.5,620,184,0.5,951,305,0.5,793,0.0,0.5,9057,3682,5375
5000,9031,29,0.6999999999999997,3599,13,0.7,5432,16,0.6999999999999998,794,0.0,0.7,1322,494,828
629,1682,0,0.0,657,0,0.0,1025,0,0.0,795,0.0,0.9,44,18,26
5000,3107,1901,0.1395464991593161,1266,788,0.13084180801053225,1841,1113,0.14570938920894927,796,0.8,0.1,7524,3003,4521
5000,2596,1814,0.13694602923149773,1050,729,0.13482941019022943,1546,1085,0.13836816313111486,797,0.8,0.3,7858,3114,4744
5000,3735,1565,0.14098042454275664,1523,604,0.14024664902135844,2212,961,0.14144161123882795,798,0.8,0.5,6590,2650,3940
5000,3473,1756,0.15008830072077825,1374,700,0.1503360350950329,2099,1056,0.14992408285905626,799,0.8,0.7,7093,2827,4266
5000,7613,743,0.2195637236274503,3159,296,0.23396140718612887,4454,447,0.21002968708747524,800,0.8,0.9,2782,1104,1678
5000,2330,3077,0.09999999999999991,890,1271,0.10000000000000009,1440,1806,0.09999999999999988,801,0.0,0.1,8170,3398,4772
5000,854,715,0.3000000000000004,350,289,0.2999999999999998,504,426,0.2999999999999998,802,0.0,0.3,9617,3782,5835
5000,1732,622,0.5,704,240,0.5,1028,382,0.5,803,0.0,0.5,8979,3556,5423
2282,4839,0,0.0,1956,0,0.0,2883,0,0.0,804,0.0,0.7,196,90,106
2873,6088,0,0.0,2365,0,0.0,3723,0,0.0,805,0.0,0.9,142,55,87
5000,3208,1761,0.14821221232591134,1246,676,0.1488685103136853,1962,1085,0.1478033114597957,806,0.8,0.1,7151,2783,4368
5000,2936,1790,0.1336511685687871,1152,685,0.13925438886468391,1784,1105,0.1301776790640909,807,0.8,0.3,7481,3038,4443
5000,3055,1778,0.13534548791386192,1284,730,0.13474752802333997,1771,1048,0.13576200577653463,808,0.8,0.5,7354,2958,4396
5000,4563,1701,0.16047903817536932,1818,666,0.15580867976666532,2745,1035,0.16348431228183968,809,0.8,0.7,5929,2329,3600
5000,8002,836,0.20086410935627969,3222,321,0.1987608914330763,4780,515,0.20217504712977138,810,0.8,0.9,2685,1083,1602
5000,1967,2801,0.09999999999999992,822,1132,0.10000000000000006,1145,1669,0.09999999999999995,811,0.0,0.1,8507,3432,5075
5000,915,714,0.3000000000000003,380,277,0.29999999999999993,535,437,0.3,812,0.0,0.3,9576,3913,5663
5000,1539,448,0.5,600,180,0.5,939,268,0.5,813,0.0,0.5,9054,3616,5438
5000,8929,53,0.7000000000000001,3587,20,0.7,5342,33,0.6999999999999997,814,0.0,0.7,1555,627,928
1786,3892,0,0.0,1524,0,0.0,2368,0,0.0,815,0.0,0.9,100,29,71
5000,2837,2004,0.1295354561527299,1137,818,0.1303412586465299,1700,1186,0.12897968343778174,816,0.8,0.1,7825,3143,4682
5000,3607,1880,0.1410376080438492,1442,729,0.1439280706011782,2165,1151,0.13920689804880768,817,0.8,0.3,6918,2752,4166
5000,5888,1385,0.18265310141564528,2411,533,0.18588976528036735,3477,852,0.18062828704956918,818,0.8,0.5,4511,1754,2757
5000,8480,706,0.2151866170866451,3358,272,0.22535308246984465,5122,434,0.20881500744556153,819,0.8,0.7,2004,793,1211
5000,3717,1626,0.16482926584838287,1472,660,0.17261770703922383,2245,966,0.15950797062482694,820,0.8,0.9,6650,2710,3940
5000,2131,3034,0.09999999999999995,875,1231,0.10000000000000006,1256,1803,0.0999999999999999,821,0.0,0.1,8277,3265,5012
5000,902,712,0.3000000000000003,350,300,0.2999999999999998,552,412,0.2999999999999998,822,0.0,0.3,9556,3829,5727
5000,1650,423,0.5,652,169,0.5,998,254,0.5,823,0.0,0.5,8948,3615,5333
3566,7224,0,0.0,2810,0,0.0,4414,0,0.0,824,0.0,0.7,413,164,249
502,1502,0,0.0,581,0,0.0,921,0,0.0,825,0.0,0.9,26,8,18
5000,2759,1829,0.12408629702113197,1106,742,0.13274165597351892,1653,1087,0.11817803911619075,826,0.8,0.1,7733,3125,4608
5000,2449,1620,0.12366963257987999,979,642,0.11821913946590389,1470,978,0.12724756364242878,827,0.8,0.3,7849,3155,4694
5000,5473,1492,0.17569805404587555,2162,618,0.18070008347008779,3311,874,0.17216114994500234,828,0.8,0.5,4979,1979,3000
5000,4967,1543,0.19430123535862534,1990,631,0.1947088635009962,2977,912,0.1940192031680157,829,0.8,0.7,5499,2237,3262
5000,9297,405,0.201570396854829,3748,172,0.21229473045275293,5549,233,0.19365372140915127,830,0.8,0.9,1310,535,775
5000,1709,2890,0.1,690,1147,0.10000000000000009,1019,1743,0.09999999999999991,831,0.0,0.1,8622,3456,5166
5000,894,719,0.30000000000000043,372,296,0.2999999999999998,522,423,0.2999999999999998,832,0.0,0.3,9582,3833,5749
5000,1651,552,0.5,668,213,0.5,983,339,0.5,833,0.0,0.5,8704,3470,5234
1016,2471,0,0.0,990,0,0.0,1481,0,0.0,834,0.0,0.7,43,15,28
1654,3545,0,0.0,1430,0,0.0,2115,0,0.0,835,0.0,0.9,233,92,141
5000,3949,1764,0.14307158497982062,1597,721,0.13780457681881472,2352,1043,0.14671253693004616,836,0.8,0.1,6566,2643,3923
5000,2898,1863,0.13066700620670083,1185,777,0.13159091129723907,1713,1086,0.13000598018888473,837,0.8,0.3,7611,3135,4476
5000,2899,1862,0.13490431401055003,1154,769,0.1351725943655878,1745,1093,0.13471556049451705,838,0.8,0.5,7430,2969,4461
5000,3269,1710,0.14307426202005774,1379,677,0.14463967060503202,1890,1033,0.14204833596775607,839,0.8,0.7,7120,2890,4230
5000,8927,460,0.21694783693472575,3618,191,0.22803977535754114,5309,269,0.20907214831480828,840,0.8,0.9,1502,614,888
5000,2073,3026,0.09999999999999996,837,1212,0.10000000000000009,1236,1814,0.09999999999999987,841,0.0,0.1,8421,3343,5078
5000,906,635,0.3000000000000003,360,249,0.2999999999999999,546,386,0.2999999999999999,842,0.0,0.3,9687,3873,5814
5000,1983,577,0.5,827,230,0.5,1156,347,0.5,843,0.0,0.5,8364,3353,5011
1414,3293,0,0.0,1333,0,0.0,1960,0,0.0,844,0.0,0.7,58,23,35
1818,3935,0,0.0,1564,0,0.0,2371,0,0.0,845,0.0,0.9,131,49,82
5000,2350,1902,0.11391993430937605,938,711,0.11264107870632145,1412,1191,0.11468338211271091,846,0.8,0.1,8237,3307,4930
5000,2654,1724,0.14922445746670895,1047,681,0.14915427450261487,1607,1043,0.14927028162639067,847,0.8,0.3,7655,3095,4560
5000,3330,1665,0.14226846077985636,1331,688,0.1436791804711904,1999,977,0.1412750368825813,848,0.8,0.5,7076,2906,4170
5000,8071,810,0.2245011658862379,3225,314,0.24248880631468808,4846,496,0.21311382900209788,849,0.8,0.7,2439,934,1505
5000,8635,564,0.18053864587602034,3513,210,0.19098210889208858,5122,354,0.17434337120547144,850,0.8,0.9,1828,704,1124
5000,1819,2817,0.0999999999999999,757,1160,0.10000000000000005,1062,1657,0.0999999999999999,851,0.0,0.1,8604,3462,5142
5000,969,638,0.3000000000000004,402,255,0.2999999999999998,567,383,0.2999999999999998,852,0.0,0.3,9519,3798,5721
5000,1596,642,0.5,628,267,0.5,968,375,0.5,853,0.0,0.5,8829,3485,5344
5000,10010,16,0.6999999999999998,4032,5,0.7,5978,11,0.7000000000000001,854,0.0,0.7,432,173,259
1195,2769,0,0.0,1104,0,0.0,1665,0,0.0,855,0.0,0.9,59,18,41
5000,5637,1538,0.16423388773710246,2153,624,0.16391692388752574,3484,914,0.16445028318801702,856,0.8,0.1,4646,1874,2772
5000,3739,1878,0.1501820474980495,1467,745,0.1533214341928766,2272,1133,0.14811775527594334,857,0.8,0.3,6998,2807,4191
5000,5447,1457,0.16528479529462578,2162,569,0.16138996202219494,3285,888,0.16778047111896488,858,0.8,0.5,5123,1983,3140
5000,6964,1019,0.19887791693402831,2810,402,0.19413341656985347,4154,617,0.20196914731716967,859,0.8,0.7,3460,1351,2109
5000,4706,1651,0.16435871154505557,1911,648,0.15968822484322392,2795,1003,0.1673761346585022,860,0.8,0.9,5769,2316,3453
5000,2350,3106,0.09999999999999994,967,1214,0.10000000000000009,1383,1892,0.09999999999999992,861,0.0,0.1,8080,3231,4849
5000,869,757,0.30000000000000027,364,315,0.2999999999999999,505,442,0.3000000000000001,862,0.0,0.3,9841,3989,5852
5000,1907,440,0.5,781,168,0.5,1126,272,0.5,863,0.0,0.5,8611,3464,5147
5000,8349,89,0.7000000000000002,3300,34,0.7,5049,55,0.7000000000000002,864,0.0,0.7,1845,725,1120
1034,2487,0,0.0,972,0,0.0,1515,0,0.0,865,0.0,0.9,37,15,22
5000,3022,1894,0.13275243755324362,1185,728,0.1297903532950725,1837,1166,0.1346018349288427,866,0.8,0.1,7491,2972,4519
5000,3132,1934,0.1541281980671097,1248,769,0.17075833039115054,1884,1165,0.14315088325407324,867,0.8,0.3,7525,2958,4567
5000,3045,1714,0.1246895700187862,1226,689,0.12657567962516367,1819,1025,0.12342173634191396,868,0.8,0.5,7398,2935,4463
5000,3656,1655,0.15453543372276687,1448,656,0.15367369228176317,2208,999,0.15510130197631897,869,0.8,0.7,6639,2605,4034
5000,8509,590,0.2245636806527073,3373,242,0.2271119359545514,5136,348,0.2227916180577463,870,0.8,0.9,1814,680,1134
5000,1787,2977,0.09999999999999994,719,1162,0.10000000000000005,1068,1815,0.09999999999999985,871,0.0,0.1,8782,3493,5289
5000,903,758,0.3000000000000003,352,282,0.2999999999999999,551,476,0.3000000000000002,872,0.0,0.3,9717,3860,5857
5000,2306,648,0.5,900,251,0.5,1406,397,0.5,873,0.0,0.5,8148,3234,4914
1891,4201,0,0.0,1681,0,0.0,2520,0,0.0,874,0.0,0.7,149,65,84
1465,3330,0,0.0,1384,0,0.0,1946,0,0.0,875,0.0,0.9,82,26,56
5000,3984,1841,0.13460686805423258,1676,698,0.13947866683898302,2308,1143,0.13163178883134913,876,0.8,0.1,6742,2689,4053
5000,4954,1646,0.17536670656761605,2004,663,0.17456063889929538,2950,983,0.17591037173963708,877,0.8,0.3,5537,2196,3341
5000,3132,1803,0.14665984572758645,1218,705,0.15211952368519288,1914,1098,0.14315431479852214,878,0.8,0.5,7286,2875,4411
5000,3658,1715,0.1614688328106853,1506,703,0.1617244301203319,2152,1012,0.1612912785530948,879,0.8,0.7,6906,2780,4126
877,2275,0,0.0,937,0,0.0,1338,0,0.0,880,0.8,0.9,55,18,37
5000,2021,2942,0.0999999999999999,829,1189,0.10000000000000005,1192,1753,0.09999999999999988,881,0.0,0.1,8407,3369,5038
5000,904,653,0.3000000000000004,367,272,0.29999999999999977,537,381,0.2999999999999998,882,0.0,0.3,9644,3844,5800
5000,2038,485,0.5,824,211,0.5,1214,274,0.5,883,0.0,0.5,8572,3344,5228
1544,3508,0,0.0,1445,0,0.0,2063,0,0.0,884,0.0,0.7,128,53,75
1348,3076,0,0.0,1224,0,0.0,1852,0,0.0,885,0.0,0.9,119,49,70
5000,3195,1890,0.13418348586330933,1283,731,0.12891337480124543,1912,1159,0.13750742994128065,886,0.8,0.1,7347,2859,4488
5000,4200,1794,0.16753980230974214,1677,761,0.16794318344654488,2523,1033,0.1672426357607517,887,0.8,0.3,6220,2582,3638
5000,4465,1552,0.17481275471064828,1761,614,0.17567428761123702,2704,938,0.17424880886740568,888,0.8,0.5,5881,2348,3533
943,2338,0,0.0,942,0,0.0,1396,0,0.0,889,0.8,0.7,29,13,16
5000,7350,914,0.2276354143664003,2985,332,0.23022202909590672,4365,582,0.22615988843822812,890,0.8,0.9,3134,1241,1893
5000,2604,3125,0.0999999999999999,1084,1236,0.10000000000000006,1520,1889,0.09999999999999984,891,0.0,0.1,7783,3110,4673
5000,836,670,0.30000000000000043,339,291,0.2999999999999999,497,379,0.2999999999999999,892,0.0,0.3,9651,3876,5775
5000,1920,730,0.5,756,276,0.5,1164,454,0.5,893,0.0,0.5,8559,3347,5212
1065,2619,0,0.0,1036,0,0.0,1583,0,0.0,894,0.0,0.7,64,25,39
1110,2592,0,0.0,1014,0,0.0,1578,0,0.0,895,0.0,0.9,99,44,55
5000,2894,1942,0.13003115722153266,1159,779,0.1300762815423724,1735,1163,0.13000093207455568,896,0.8,0.1,7664,3081,4583
5000,3298,1883,0.13150680265552855,1293,748,0.14044460864981081,2005,1135,0.12561651289013373,897,0.8,0.3,7211,2830,4381
5000,4813,1604,0.18428769213156124,1977,670,0.1833004369957075,2836,934,0.18499589442387598,898,0.8,0.5,5649,2290,3359
5000,8773,609,0.20857546358082885,3448,274,0.19283474341958273,5325,335,0.2214499630559972,899,0.8,0.7,1805,737,1068
5000,8705,502,0.19116607104836647,3522,213,0.1849708964834541,5183,289,0.19573206475883823,900,0.8,0.9,1743,698,1045
5000,2029,2879,0.09999999999999991,834,1152,0.10000000000000009,1195,1727,0.09999999999999987,901,0.0,0.1,8344,3342,5002
5000,938,606,0.3000000000000004,387,239,0.29999999999999977,551,367,0.29999999999999977,902,0.0,0.3,9397,3800,5597
5000,2865,654,0.5,1158,244,0.5,1707,410,0.5,903,0.0,0.5,7601,3024,4577
2549,5330,0,0.0,2167,0,0.0,3163,0,0.0,904,0.0,0.7,285,114,171
1077,2603,0,0.0,1036,0,0.0,1567,0,0.0,905,0.0,0.9,77,26,51
5000,2871,2025,0.12622037661695615,1166,796,0.12764419942864363,1705,1229,0.125298193575375,906,0.8,0.1,7666,3083,4583
5000,3841,1785,0.1339619450454643,1548,704,0.13569210989885402,2293,1081,0.1328351771853474,907,0.8,0.3,6489,2605,3884
5000,7345,943,0.22354835905717058,2945,383,0.22389021439252133,4400,560,0.22331455442602868,908,0.8,0.5,3193,1334,1859
5000,6389,1114,0.15664317835682087,2578,469,0.15667636063535093,3811,645,0.15661905046747104,909,0.8,0.7,4101,1663,2438
5000,7863,844,0.1834256535274562,3098,335,0.18783553569696015,4765,509,0.1805232752823012,910,0.8,0.9,2615,1069,1546
5000,1951,2951,0.09999999999999996,764,1172,0.10000000000000006,1187,1779,0.0999999999999999,911,0.0,0.1,8648,3480,5168
5000,879,678,0.30000000000000027,335,281,0.2999999999999999,544,397,0.2999999999999998,912,0.0,0.3,9447,3767,5680
5000,2171,649,0.5,858,271,0.5,1313,378,0.5,913,0.0,0.5,8372,3368,5004
839,2071,0,0.0,812,0,0.0,1259,0,0.0,914,0.0,0.7,44,21,23
1725,3848,0,0.0,1496,0,0.0,2352,0,0.0,915,0.0,0.9,107,50,57
5000,2722,1895,0.1272893890414739,1087,791,0.12504014837502686,1635,1104,0.12890093738129246,916,0.8,0.1,7707,3147,4560
5000,2669,1764,0.1522603751948654,1053,701,0.16312422171288046,1616,1063,0.14509616408561934,917,0.8,0.3,7838,3065,4773
5000,3384,1835,0.14939141172001846,1309,728,0.14985303083288332,2075,1107,0.1490878356457947,918,0.8,0.5,7207,2887,4320
5000,8280,658,0.238126093676396,3366,277,0.24345660936332317,4914,381,0.23425062689088721,919,0.8,0.7,2188,874,1314
829,2129,0,0.0,867,0,0.0,1262,0,0.0,920,0.8,0.9,45,17,28
5000,1508,2557,0.10000000000000009,569,1021,0.09999999999999984,939,1536,0.09999999999999988,921,0.0,0.1,9130,3714,5416
5000,887,693,0.30000000000000027,358,286,0.2999999999999998,529,407,0.2999999999999999,922,0.0,0.3,9421,3855,5566
5000,2029,515,0.5,845,200,0.5,1184,315,0.5,923,0.0,0.5,8436,3373,5063
864,2212,0,0.0,870,0,0.0,1342,0,0.0,924,0.0,0.7,56,23,33
1354,3039,0,0.0,1246,0,0.0,1793,0,0.0,925,0.0,0.9,106,41,65
5000,3352,1991,0.158140480912046,1375,783,0.16050152963560177,1977,1208,0.15661009916490673,926,0.8,0.1,7292,2978,4314
5000,2353,1870,0.12833122577650763,941,755,0.12293988459209791,1412,1115,0.13198186487447122,927,0.8,0.3,7985,3247,4738
5000,3988,1676,0.15920580536728443,1577,652,0.15850334452112308,2411,1024,0.15965307535917633,928,0.8,0.5,6515,2605,3910
5000,4100,1658,0.16465131783351025,1659,677,0.1621014256620042,2441,981,0.16641102935248026,929,0.8,0.7,6084,2391,3693
780,2002,0,0.0,789,0,0.0,1213,0,0.0,930,0.8,0.9,38,15,23
5000,1950,2870,0.09999999999999992,791,1167,0.10000000000000006,1159,1703,0.09999999999999994,931,0.0,0.1,8419,3372,5047
5000,995,628,0.3000000000000002,404,244,0.29999999999999993,591,384,0.2999999999999998,932,0.0,0.3,9485,3783,5702
5000,1439,469,0.5,538,187,0.5,901,282,0.5,933,0.0,0.5,8965,3546,5419
2754,5573,0,0.0,2228,0,0.0,3345,0,0.0,934,0.0,0.7,301,110,191
1568,3412,0,0.0,1375,0,0.0,2037,0,0.0,935,0.0,0.9,105,39,66
5000,2765,1968,0.11732423263961318,1059,802,0.11229010967665345,1706,1166,0.12078681121276387,936,0.8,0.1,7618,3097,4521
5000,2721,1694,0.1296870608746889,1067,656,0.12947001627158547,1654,1038,0.1298242297182687,937,0.8,0.3,7797,3129,4668
5000,3141,1753,0.14882857100216643,1291,709,0.150810843060672,1850,1044,0.14748237283216595,938,0.8,0.5,7383,2907,4476
5000,7209,1174,0.183622949165136,2876,471,0.1858199858996368,4333,703,0.1821509658053211,939,0.8,0.7,3352,1376,1976
5000,7463,1026,0.18070267556128544,2931,392,0.20062950772425217,4532,634,0.1683819843816594,940,0.8,0.9,2983,1193,1790
5000,1994,2929,0.09999999999999991,775,1167,0.10000000000000006,1219,1762,0.09999999999999985,941,0.0,0.1,8392,3357,5035
5000,921,712,0.3000000000000003,385,287,0.2999999999999998,536,425,0.2999999999999998,942,0.0,0.3,9632,3813,5819
5000,3046,688,0.5,1204,259,0.5,1842,429,0.5,943,0.0,0.5,7304,2845,4459
4088,8218,0,0.0,3328,0,0.0,4890,0,0.0,944,0.0,0.7,317,119,198
2160,4508,0,0.0,1849,0,0.0,2659,0,0.0,945,0.0,0.9,165,66,99
5000,3080,1873,0.12797025178485075,1234,745,0.131985408301236,1846,1128,0.12531839752535875,946,0.8,0.1,7329,2963,4366
5000,3452,1691,0.14757917593751652,1416,653,0.14485092190394036,2036,1038,0.1492955053054599,947,0.8,0.3,7067,2783,4284
5000,3534,1822,0.15385733078722938,1411,748,0.14975851692318964,2123,1074,0.15671199817112288,948,0.8,0.5,6987,2788,4199
5000,8839,512,0.2245630581733467,3488,194,0.23411544099675874,5351,318,0.21873550387227145,949,0.8,0.7,1558,610,948
777,1988,0,0.0,772,0,0.0,1216,0,0.0,950,0.8,0.9,51,18,33
5000,2405,3090,0.09999999999999996,955,1249,0.10000000000000007,1450,1841,0.0999999999999999,951,0.0,0.1,8050,3279,4771
5000,856,694,0.30000000000000027,366,254,0.2999999999999998,490,440,0.30000000000000004,952,0.0,0.3,9655,3849,5806
5000,8101,316,0.5,3325,143,0.5,4776,173,0.5,953,0.0,0.5,2446,964,1482
2872,5794,0,0.0,2325,0,0.0,3469,0,0.0,954,0.0,0.7,346,134,212
2027,4372,0,0.0,1803,0,0.0,2569,0,0.0,955,0.0,0.9,138,51,87
5000,2761,2016,0.12480705934104218,1113,805,0.12918923700362195,1648,1211,0.12189405106822908,956,0.8,0.1,7885,3135,4750
5000,3756,1759,0.12956127841676518,1499,674,0.11900219990095431,2257,1085,0.1361205585270477,957,0.8,0.3,6890,2693,4197
5000,5075,1615,0.16201395203831753,2086,653,0.1630670265757949,2989,962,0.16129913117244152,958,0.8,0.5,5511,2217,3294
5000,4348,1767,0.16954279063741848,1747,700,0.17206587476111973,2601,1067,0.16788753394895464,959,0.8,0.7,6140,2455,3685
5000,7128,1018,0.2080722589818519,2931,408,0.198143714444562,4197,610,0.21471299041007172,960,0.8,0.9,3431,1349,2082
5000,1975,2809,0.09999999999999991,805,1101,0.10000000000000005,1170,1708,0.09999999999999992,961,0.0,0.1,8426,3372,5054
5000,908,670,0.30000000000000043,375,265,0.2999999999999998,533,405,0.2999999999999999,962,0.0,0.3,9506,3782,5724
5000,1765,472,0.5,695,171,0.5,1070,301,0.5,963,0.0,0.5,8698,3425,5273
5000,9979,34,0.7,4039,20,0.7,5940,14,0.7,964,0.0,0.7,555,215,340
2257,4836,0,0.0,1927,0,0.0,2909,0,0.0,965,0.0,0.9,159,74,85
5000,2762,1809,0.12359048166331782,1121,706,0.12712144696426003,1641,1103,0.12133040777169028,966,0.8,0.1,7649,3113,4536
5000,2313,1812,0.12481516058359904,916,746,0.12608619399571203,1397,1066,0.1239256756629271,967,0.8,0.3,8148,3283,4865
5000,3385,1774,0.14207153732553948,1419,742,0.14497349550926644,1966,1032,0.13998505188723967,968,0.8,0.5,6931,2779,4152
5000,4713,1826,0.15829060751298715,1892,730,0.14750752858784494,2821,1096,0.1654727677459741,969,0.8,0.7,5878,2341,3537
5000,10293,16,0.22353328618666524,4178,5,0.30172647416672965,6115,11,0.18799092801390874,970,0.8,0.9,142,52,90
5000,1915,2927,0.09999999999999994,788,1161,0.10000000000000005,1127,1766,0.09999999999999994,971,0.0,0.1,8628,3489,5139
5000,870,668,0.3000000000000004,348,280,0.2999999999999999,522,388,0.2999999999999999,972,0.0,0.3,9443,3814,5629
5000,1413,524,0.5,545,178,0.5,868,346,0.5,973,0.0,0.5,8944,3540,5404
5000,9511,75,0.7000000000000004,3818,43,0.6999999999999997,5693,32,0.6999999999999997,974,0.0,0.7,898,385,513
999,2433,0,0.0,944,0,0.0,1489,0,0.0,975,0.0,0.9,73,24,49
5000,3066,1958,0.12181841247388614,1265,790,0.11697676962738567,1801,1168,0.1250931537827349,976,0.8,0.1,7420,2988,4432
5000,3680,1797,0.17454024367799145,1437,722,0.16094248745642953,2243,1075,0.18367287622865905,977,0.8,0.3,6701,2676,4025
5000,2967,1743,0.14419672503201228,1198,696,0.14607902492648694,1769,1047,0.1429454540419889,978,0.8,0.5,7472,3025,4447
1263,2896,0,0.0,1188,0,0.0,1708,0,0.0,979,0.8,0.7,106,43,63
5000,5324,1578,0.16273733888575284,2140,621,0.16745196689432346,3184,957,0.1596780034695331,980,0.8,0.9,5131,2020,3111
5000,2232,3081,0.09999999999999996,905,1185,0.10000000000000007,1327,1896,0.09999999999999991,981,0.0,0.1,8413,3293,5120
5000,927,647,0.30000000000000027,356,255,0.2999999999999998,571,392,0.2999999999999998,982,0.0,0.3,9458,3780,5678
5000,2131,798,0.5,904,310,0.5,1227,488,0.5,983,0.0,0.5,8248,3415,4833
759,1896,0,0.0,795,0,0.0,1101,0,0.0,984,0.0,0.7,32,11,21
1616,3574,0,0.0,1400,0,0.0,2174,0,0.0,985,0.0,0.9,115,50,65
5000,3015,2032,0.13296326335870143,1254,804,0.1291356672494997,1761,1228,0.13546927905234807,986,0.8,0.1,7364,2930,4434
5000,2732,1831,0.13785281610353442,1097,673,0.13213368772466383,1635,1158,0.14117662732890568,987,0.8,0.3,7634,2999,4635
5000,2926,2002,0.13602890516980662,1179,799,0.13749940402543218,1747,1203,0.13505223967883,988,0.8,0.5,7650,3083,4567
5000,4769,1670,0.1620159408817871,1987,697,0.1576266226409914,2782,973,0.16516019043351862,989,0.8,0.7,5685,2248,3437
889,2140,0,0.0,821,0,0.0,1319,0,0.0,990,0.8,0.9,83,33,50
5000,1707,2842,0.09999999999999998,696,1127,0.10000000000000006,1011,1715,0.0999999999999999,991,0.0,0.1,8742,3464,5278
5000,921,651,0.3000000000000003,383,279,0.29999999999999993,538,372,0.29999999999999993,992,0.0,0.3,9355,3739,5616
5000,1680,476,0.5,666,192,0.5,1014,284,0.5,993,0.0,0.5,8921,3580,5341
4211,8444,0,0.0,3353,0,0.0,5091,0,0.0,994,0.0,0.7,511,209,302
943,2311,0,0.0,909,0,0.0,1402,0,0.0,995,0.0,0.9,92,37,55
5000,2782,1826,0.12628012086783738,1157,733,0.12323272148076188,1625,1093,0.12832380225002069,996,0.8,0.1,7618,3094,4524
5000,2401,1849,0.11803069234913031,964,739,0.11804908838533312,1437,1110,0.11801844489800074,997,0.8,0.3,8258,3231,5027
5000,5613,1305,0.18992810031268154,2259,551,0.1942697461514868,3354,754,0.18675535912278549,998,0.8,0.5,5018,2050,2968
5000,4665,1591,0.1661655601169367,1898,641,0.17849861687684201,2767,950,0.15784399234525326,999,0.8,0.7,5877,2351,3526
626,1650,0,0.0,665,0,0.0,985,0,0.0,1000,0.8,0.9,40,13,27
