step,susceptible_status,infected_status,filtermeanvirulence_pathogen,susceptible_status_is_minority,infected_status_is_minority,filtermeanvirulence_pathogen_is_minority,susceptible_status_#84_f=is_minority,infected_status_#84_f=is_minority,filtermeanvirulence_pathogen_#84_f=is_minority,ensemble,mutation_rate,virulence_init,total_infected,total_minority_infected,total_majority_infected
5000,1934,2919,0.09999999999999995,784,1190,0.10000000000000006,1150,1729,0.09999999999999985,1,0.0,0.1,8654,3456,5198
5000,973,749,0.3000000000000004,419,297,0.2999999999999998,554,452,0.3,2,0.0,0.3,9668,3940,5728
5000,4244,870,0.5,1620,320,0.5,2624,550,0.5,3,0.0,0.5,6151,2466,3685
2914,6119,0,0.0,2449,0,0.0,3670,0,0.0,4,0.0,0.7,291,126,165
896,2184,0,0.0,853,0,0.0,1331,0,0.0,5,0.0,0.9,44,26,18
5000,3196,1864,0.1402066655692926,1278,742,0.1450881134051681,1918,1122,0.1369784710111645,6,0.8,0.1,7445,3005,4440
5000,2363,1919,0.12352353895775747,947,787,0.1193898013325543,1416,1132,0.12639743605231127,7,0.8,0.3,7989,3210,4779
5000,3936,1777,0.1423159887832699,1667,686,0.15227848908193603,2269,1091,0.136051758531313,8,0.8,0.5,6520,2576,3944
5000,6797,1244,0.18595706745108506,2792,513,0.17759277720830022,4005,731,0.19182694555580282,9,0.8,0.7,3813,1538,2275
1395,3331,0,0.0,1378,0,0.0,1953,0,0.0,10,0.8,0.9,51,7,44
5000,1840,2899,0.09999999999999999,751,1163,0.10000000000000006,1089,1736,0.09999999999999994,11,0.0,0.1,8774,3466,5308
5000,950,615,0.3000000000000002,396,233,0.2999999999999998,554,382,0.2999999999999998,12,0.0,0.3,9695,3891,5804
5000,1453,617,0.5,511,264,0.5,942,353,0.5,13,0.0,0.5,9103,3675,5428
1078,2595,0,0.0,1051,0,0.0,1544,0,0.0,14,0.0,0.7,69,30,39
1347,2901,0,0.0,1139,0,0.0,1762,0,0.0,15,0.0,0.9,136,46,90
5000,2987,1909,0.13009516702863505,1191,739,0.13641704857875192,1796,1170,0.12610211534868945,16,0.8,0.1,7426,2905,4521
5000,3941,1770,0.15217241367341938,1542,697,0.14571011463759065,2399,1073,0.1563701978560592,17,0.8,0.3,6553,2606,3947
5000,2794,1790,0.14205410533564036,1126,714,0.14320935962558748,1668,1076,0.1412875146636866,18,0.8,0.5,7783,3178,4605
5000,5190,1668,0.1704189838005543,1972,680,0.17279496744893497,3218,988,0.16878369141098057,19,0.8,0.7,5369,2178,3191
852,2133,0,0.0,887,0,0.0,1246,0,0.0,20,0.8,0.9,39,16,23
5000,2499,3098,0.09999999999999995,973,1269,0.10000000000000007,1526,1829,0.09999999999999992,21,0.0,0.1,7770,3124,4646
5000,899,615,0.3000000000000002,371,238,0.29999999999999977,528,377,0.2999999999999999,22,0.0,0.3,9657,3907,5750
5000,1518,510,0.5,595,207,0.5,923,303,0.5,23,0.0,0.5,8952,3570,5382
4140,8127,0,0.0,3384,0,0.0,4743,0,0.0,24,0.0,0.7,635,196,439
1608,3545,0,0.0,1392,0,0.0,2153,0,0.0,25,0.0,0.9,80,40,40
5000,2975,1835,0.12098576484771995,1186,700,0.11638128801606862,1789,1135,0.12382553029455337,26,0.8,0.1,7439,3004,4435
5000,2854,1741,0.15428352573035473,1153,683,0.15061252735697575,1701,1058,0.15665336683528636,27,0.8,0.3,7568,3037,4531
5000,3589,1706,0.1564235607896111,1409,634,0.16037157212913966,2180,1072,0.15408863617276303,28,0.8,0.5,6775,2638,4137
5000,3264,1852,0.1500409034727,1348,770,0.14671156757124043,1916,1082,0.15241020905876615,29,0.8,0.7,7112,2825,4287
5000,4816,1421,0.17554372559511672,1868,554,0.178283355246333,2948,867,0.1737931433266349,30,0.8,0.9,5632,2252,3380
5000,1968,2853,0.09999999999999995,829,1057,0.10000000000000007,1139,1796,0.09999999999999992,31,0.0,0.1,8480,3320,5160
5000,1038,674,0.3000000000000002,433,236,0.2999999999999998,605,438,0.3,32,0.0,0.3,9466,3701,5765
5000,2333,510,0.5,987,209,0.5,1346,301,0.5,33,0.0,0.5,8317,3251,5066
1665,3683,0,0.0,1481,0,0.0,2202,0,0.0,34,0.0,0.7,166,72,94
1121,2638,0,0.0,1072,0,0.0,1566,0,0.0,35,0.0,0.9,54,10,44
5000,3651,1842,0.13861195578910548,1508,726,0.14512315719402924,2143,1116,0.13437617422998832,36,0.8,0.1,6901,2703,4198
5000,2593,1854,0.13116887982830383,1019,748,0.12834896385057498,1574,1106,0.1330760201098058,37,0.8,0.3,7837,3139,4698
5000,5022,1385,0.19033504373703938,2003,555,0.1902976009162867,3019,830,0.19036008080392824,38,0.8,0.5,5375,2136,3239
5000,5119,1516,0.16961889074731748,2068,599,0.15708758628036068,3051,917,0.17780455200763065,39,0.8,0.7,5319,2102,3217
1112,2604,0,0.0,1050,0,0.0,1554,0,0.0,40,0.8,0.9,114,43,71
5000,2411,2951,0.09999999999999996,1018,1212,0.10000000000000009,1393,1739,0.09999999999999992,41,0.0,0.1,8111,3200,4911
5000,885,855,0.3000000000000004,363,378,0.2999999999999999,522,477,0.3000000000000002,42,0.0,0.3,9466,3873,5593
5000,8225,310,0.5,3418,126,0.5,4807,184,0.5,43,0.0,0.5,2130,781,1349
903,2211,0,0.0,851,0,0.0,1360,0,0.0,44,0.0,0.7,47,19,28
980,2267,0,0.0,879,0,0.0,1388,0,0.0,45,0.0,0.9,91,29,62
5000,2795,1817,0.12942958857382153,1088,719,0.13147308913475367,1707,1098,0.12809144931761918,46,0.8,0.1,7665,3118,4547
5000,2652,1818,0.13538643497791666,1035,723,0.13632038374641595,1617,1095,0.1347697729143322,47,0.8,0.3,7840,3155,4685
5000,2388,1779,0.14118593808365595,944,699,0.13846936082978098,1444,1080,0.14294416725074727,48,0.8,0.5,7858,3132,4726
5000,5685,1327,0.21119034798988146,2225,519,0.2086762738871688,3460,808,0.21280520499397537,49,0.8,0.7,4845,1995,2850
1650,3744,0,0.0,1525,0,0.0,2219,0,0.0,50,0.8,0.9,42,17,25
5000,2126,3018,0.09999999999999999,821,1256,0.10000000000000006,1305,1762,0.09999999999999985,51,0.0,0.1,8389,3441,4948
5000,884,707,0.3000000000000002,328,255,0.2999999999999998,556,452,0.3,52,0.0,0.3,9547,3904,5643
5000,9424,104,0.5,3859,40,0.5,5565,64,0.5,53,0.0,0.5,855,271,584
2873,5932,0,0.0,2380,0,0.0,3552,0,0.0,54,0.0,0.7,331,136,195
592,1645,0,0.0,667,0,0.0,978,0,0.0,55,0.0,0.9,46,15,31
5000,2823,2091,0.13593530532684492,1091,790,0.1292977167238145,1732,1301,0.13996581646934608,56,0.8,0.1,7849,3079,4770
5000,3682,1856,0.1424577366712777,1453,757,0.14584363348267412,2229,1099,0.14012550383576614,57,0.8,0.3,6763,2752,4011
5000,3137,1844,0.1346667772118318,1305,736,0.12744632060968783,1832,1108,0.13946303719303935,58,0.8,0.5,7236,2913,4323
5000,3086,1716,0.14268350953017753,1235,720,0.14051791352272178,1851,996,0.14424900061990467,59,0.8,0.7,7405,2982,4423
5000,9887,126,0.2731174765876616,3924,57,0.3459417990501185,5963,69,0.21295825368389293,60,0.8,0.9,639,259,380
5000,2410,3219,0.09999999999999996,998,1290,0.10000000000000002,1412,1929,0.09999999999999988,61,0.0,0.1,8026,3190,4836
5000,973,654,0.3000000000000004,383,251,0.2999999999999999,590,403,0.29999999999999993,62,0.0,0.3,9360,3730,5630
5000,1710,559,0.5,696,218,0.5,1014,341,0.5,63,0.0,0.5,8778,3511,5267
2121,4462,0,0.0,1785,0,0.0,2677,0,0.0,64,0.0,0.7,245,94,151
2297,4848,0,0.0,1949,0,0.0,2899,0,0.0,65,0.0,0.9,157,74,83
5000,2991,1899,0.11756911514214845,1174,765,0.1160458484307753,1817,1134,0.1185967157014081,66,0.8,0.1,7487,3007,4480
5000,2714,1694,0.12995909837670533,1050,630,0.14011476947467008,1664,1064,0.12394587206869993,67,0.8,0.3,7868,3136,4732
5000,3324,1822,0.15707808112517296,1303,738,0.1500911365192597,2021,1084,0.16183487551554554,68,0.8,0.5,7122,2913,4209
5000,6214,1121,0.20794990149816023,2499,413,0.2064562801604785,3715,708,0.20882118061180788,69,0.8,0.7,4237,1718,2519
5000,8245,893,0.21431690318978217,3259,356,0.24193705500489315,4986,537,0.19600633699577913,70,0.8,0.9,2506,1019,1487
5000,2074,3068,0.0999999999999999,811,1189,0.10000000000000005,1263,1879,0.09999999999999987,71,0.0,0.1,8435,3362,5073
5000,883,671,0.30000000000000043,336,253,0.2999999999999999,547,418,0.2999999999999999,72,0.0,0.3,9639,3786,5853
5000,1759,428,0.5,727,176,0.5,1032,252,0.5,73,0.0,0.5,8770,3469,5301
1479,3264,0,0.0,1371,0,0.0,1893,0,0.0,74,0.0,0.7,153,53,100
500,1426,0,0.0,558,0,0.0,868,0,0.0,75,0.0,0.9,39,14,25
5000,2388,1895,0.11468315973603606,955,740,0.11544092215256106,1433,1155,0.11419766693237503,76,0.8,0.1,8138,3252,4886
5000,3316,1896,0.14228591482498693,1363,738,0.14239713493861617,1953,1158,0.14221503361267393,77,0.8,0.3,7125,2796,4329
5000,2797,1682,0.12857243077039995,1117,632,0.13117718018547567,1680,1050,0.12700461969389726,78,0.8,0.5,7903,3109,4794
5000,7181,1071,0.2137436031141017,2805,441,0.20842220078427404,4376,630,0.21746858474498107,79,0.8,0.7,3403,1391,2012
2535,5325,0,0.0,2195,0,0.0,3130,0,0.0,80,0.8,0.9,165,53,112
5000,2442,3316,0.09999999999999988,989,1312,0.09999999999999992,1453,2004,0.09999999999999987,81,0.0,0.1,8195,3246,4949
5000,840,688,0.30000000000000043,348,292,0.2999999999999999,492,396,0.2999999999999998,82,0.0,0.3,9629,3782,5847
5000,1537,375,0.5,630,146,0.5,907,229,0.5,83,0.0,0.5,8979,3523,5456
3260,6391,0,0.0,2548,0,0.0,3843,0,0.0,84,0.0,0.7,569,209,360
1561,3502,0,0.0,1419,0,0.0,2083,0,0.0,85,0.0,0.9,73,26,47
5000,3841,1751,0.14266440601177013,1586,689,0.1427637656989797,2255,1062,0.1425999438418197,86,0.8,0.1,6513,2669,3844
5000,2739,1755,0.13400625372975727,1123,663,0.12734504797367538,1616,1092,0.13805055722452136,87,0.8,0.3,7629,3074,4555
5000,3431,1669,0.15779533816890237,1455,648,0.15613472404790565,1976,1021,0.15884928327214037,88,0.8,0.5,7016,2730,4286
5000,7739,986,0.1986855300753624,3133,412,0.1809134856998534,4606,574,0.21144177098600636,89,0.8,0.7,2885,1176,1709
5000,10434,49,0.1406724193910975,4221,9,0.20166100849947705,6213,40,0.1269499868417121,90,0.8,0.9,211,36,175
5000,3006,3149,0.09999999999999995,1187,1310,0.09999999999999994,1819,1839,0.0999999999999999,91,0.0,0.1,7383,2979,4404
5000,938,687,0.30000000000000043,378,276,0.29999999999999993,560,411,0.2999999999999999,92,0.0,0.3,9565,3839,5726
5000,2095,654,0.5,896,247,0.5,1199,407,0.5,93,0.0,0.5,8449,3373,5076
3772,7332,0,0.0,2937,0,0.0,4395,0,0.0,94,0.0,0.7,614,208,406
1225,2705,0,0.0,1091,0,0.0,1614,0,0.0,95,0.0,0.9,153,70,83
5000,3235,2077,0.14103348560527162,1295,829,0.15046893676568251,1940,1248,0.1347658662046461,96,0.8,0.1,7184,2880,4304
5000,3228,1859,0.12560962751621363,1336,701,0.11632999321325849,1892,1158,0.13122709180496284,97,0.8,0.3,7317,2858,4459
5000,2696,1866,0.14055589812361408,1051,725,0.14389917286609336,1645,1141,0.13843155615315178,98,0.8,0.5,7822,3153,4669
5000,4038,1571,0.15675426014145505,1606,615,0.15747663550693314,2432,956,0.15628955213960466,99,0.8,0.7,6515,2590,3925
5000,10336,1,0.017795606219357107,4222,0,0.0,6114,1,0.017795606219357107,100,0.8,0.9,64,15,49
5000,1537,2610,0.09999999999999995,584,1012,0.0999999999999999,953,1598,0.09999999999999988,101,0.0,0.1,8909,3542,5367
5000,921,739,0.30000000000000027,362,302,0.29999999999999977,559,437,0.3,102,0.0,0.3,9575,3799,5776
5000,1627,593,0.5,625,222,0.5,1002,371,0.5,103,0.0,0.5,8868,3514,5354
5000,6589,154,0.7000000000000003,2554,59,0.7000000000000003,4035,95,0.7000000000000003,104,0.0,0.7,3871,1576,2295
2046,4348,0,0.0,1686,0,0.0,2662,0,0.0,105,0.0,0.9,192,71,121
5000,2791,1953,0.1266647165764887,1132,824,0.1300635625239839,1659,1129,0.12418407081852936,106,0.8,0.1,7594,3034,4560
5000,2669,1873,0.13376231355116142,1058,725,0.13503522121923986,1611,1148,0.13295843022419546,107,0.8,0.3,7917,3096,4821
5000,3597,1705,0.1461610457730289,1429,675,0.14350428282423558,2168,1030,0.14790212828801486,108,0.8,0.5,6950,2742,4208
5000,10092,119,0.18425633035919645,4103,47,0.2192326433819795,5989,72,0.16142457046932418,109,0.8,0.7,400,148,252
5000,7213,1038,0.21889355778361083,2814,428,0.23547137929025574,4399,610,0.20726190597239105,110,0.8,0.9,3368,1412,1956
5000,1742,2910,0.09999999999999996,715,1159,0.10000000000000005,1027,1751,0.09999999999999988,111,0.0,0.1,8787,3549,5238
5000,950,684,0.3000000000000004,395,279,0.29999999999999993,555,405,0.2999999999999999,112,0.0,0.3,9704,3915,5789
5000,1482,529,0.5,600,204,0.5,882,325,0.5,113,0.0,0.5,8897,3602,5295
1846,4103,0,0.0,1611,0,0.0,2492,0,0.0,114,0.0,0.7,167,50,117
1871,4116,0,0.0,1673,0,0.0,2443,0,0.0,115,0.0,0.9,106,36,70
5000,2844,1976,0.132290702360368,1119,775,0.12787542029900262,1725,1201,0.13513986438997505,116,0.8,0.1,7695,3072,4623
5000,3819,1949,0.155234763342296,1558,793,0.1561399933761406,2261,1156,0.15461378806821385,117,0.8,0.3,6735,2666,4069
5000,4707,1694,0.17248353006137793,1817,699,0.17248662945952303,2890,995,0.1724813526952437,118,0.8,0.5,5786,2325,3461
5000,6176,1223,0.204439662844982,2472,459,0.18943495355494683,3704,764,0.2134542722221105,119,0.8,0.7,4406,1764,2642
971,2343,0,0.0,994,0,0.0,1349,0,0.0,120,0.8,0.9,87,30,57
5000,1704,2813,0.09999999999999991,720,1136,0.10000000000000007,984,1677,0.09999999999999992,121,0.0,0.1,8904,3562,5342
5000,938,683,0.3000000000000003,357,300,0.2999999999999998,581,383,0.2999999999999998,122,0.0,0.3,9512,3859,5653
5000,1695,553,0.5,672,239,0.5,1023,314,0.5,123,0.0,0.5,8630,3490,5140
1802,3880,0,0.0,1548,0,0.0,2332,0,0.0,124,0.0,0.7,213,99,114
715,1835,0,0.0,743,0,0.0,1092,0,0.0,125,0.0,0.9,86,23,63
5000,2620,1759,0.12219238350735263,1111,657,0.1205224131350228,1509,1102,0.12318800105238048,126,0.8,0.1,7953,3145,4808
5000,2875,1796,0.1367711483306633,1063,716,0.13028211034531664,1812,1080,0.14107314018020795,127,0.8,0.3,7447,2993,4454
5000,6440,1277,0.17266475573842305,2573,569,0.17220740112629762,3867,708,0.17303231897895893,128,0.8,0.5,4011,1656,2355
5000,7313,1075,0.1707065196674461,2915,423,0.15887154971032963,4398,652,0.1783847287040416,129,0.8,0.7,3262,1352,1910
922,2287,0,0.0,917,0,0.0,1370,0,0.0,130,0.8,0.9,33,6,27
5000,1732,2916,0.09999999999999995,664,1160,0.10000000000000005,1068,1756,0.09999999999999987,131,0.0,0.1,8744,3461,5283
5000,893,657,0.30000000000000043,347,268,0.2999999999999998,546,389,0.2999999999999999,132,0.0,0.3,9641,3839,5802
5000,1476,511,0.5,613,231,0.5,863,280,0.5,133,0.0,0.5,9024,3645,5379
2991,6040,0,0.0,2422,0,0.0,3618,0,0.0,134,0.0,0.7,369,158,211
1636,3679,0,0.0,1452,0,0.0,2227,0,0.0,135,0.0,0.9,184,94,90
5000,2419,1889,0.1230353543788972,977,782,0.12664342990364041,1442,1107,0.12048656028644082,136,0.8,0.1,8170,3352,4818
5000,2715,1604,0.12050526565489836,1046,642,0.12365256204995857,1669,962,0.1184048869796087,137,0.8,0.3,7645,3023,4622
5000,10371,34,0.14807272163087404,4200,9,0.12177174856583488,6171,25,0.15754107193428812,138,0.8,0.5,100,28,72
5000,7598,908,0.19570928835003903,3024,341,0.18269803029453643,4574,567,0.20353440121939778,139,0.8,0.7,2794,1095,1699
5000,9024,581,0.14823576721345977,3541,253,0.14601068678107332,5483,328,0.14995206401039202,140,0.8,0.9,1277,545,732
5000,1762,2810,0.09999999999999992,704,1114,0.10000000000000007,1058,1696,0.09999999999999987,141,0.0,0.1,8736,3511,5225
5000,888,701,0.3000000000000004,356,295,0.2999999999999999,532,406,0.2999999999999999,142,0.0,0.3,9676,3975,5701
5000,1758,437,0.5,709,190,0.5,1049,247,0.5,143,0.0,0.5,8760,3513,5247
2239,4630,0,0.0,1836,0,0.0,2794,0,0.0,144,0.0,0.7,224,81,143
661,1819,0,0.0,749,0,0.0,1070,0,0.0,145,0.0,0.9,56,16,40
5000,3489,1795,0.14305413944321646,1401,758,0.1444063868855818,2088,1037,0.14206570785082206,146,0.8,0.1,6964,2817,4147
5000,1964,1808,0.11871510063292272,785,732,0.12245739707244667,1179,1076,0.1161692261034324,147,0.8,0.3,8576,3431,5145
5000,2467,1829,0.1356293283830056,915,739,0.13188686607472205,1552,1090,0.13816664915898863,148,0.8,0.5,7867,3162,4705
5000,3311,1758,0.1363159104587022,1366,723,0.13624014878045693,1945,1035,0.13636883383394027,149,0.8,0.7,7130,2886,4244
5000,8696,703,0.22621407357908097,3530,284,0.22193911878965833,5166,419,0.22911165630031233,150,0.8,0.9,1879,750,1129
5000,2174,2958,0.09999999999999998,897,1216,0.10000000000000009,1277,1742,0.09999999999999991,151,0.0,0.1,8272,3310,4962
5000,947,667,0.3000000000000004,359,269,0.2999999999999998,588,398,0.2999999999999998,152,0.0,0.3,9427,3731,5696
5000,1431,477,0.5,566,187,0.5,865,290,0.5,153,0.0,0.5,8896,3530,5366
4666,9384,0,0.0,3879,0,0.0,5505,0,0.0,154,0.0,0.7,434,131,303
1662,3581,0,0.0,1400,0,0.0,2181,0,0.0,155,0.0,0.9,176,92,84
5000,2555,1912,0.11841964385653117,1029,736,0.1200917178467049,1526,1176,0.11737317578104829,156,0.8,0.1,7975,3211,4764
5000,2613,1876,0.12794641700494763,1032,737,0.12927262205313858,1581,1139,0.1270882843267064,157,0.8,0.3,7869,3137,4732
5000,2399,1732,0.12288791953589884,994,691,0.12059827701785705,1405,1041,0.12440774948783631,158,0.8,0.5,7999,3208,4791
5000,2700,1815,0.14426467407023788,1027,680,0.1355551047974963,1673,1135,0.1494827420045676,159,0.8,0.7,7696,3124,4572
1394,3265,0,0.0,1367,0,0.0,1898,0,0.0,160,0.8,0.9,75,24,51
5000,1838,2793,0.09999999999999994,713,1126,0.10000000000000006,1125,1667,0.09999999999999991,161,0.0,0.1,8447,3389,5058
5000,917,714,0.3000000000000003,367,294,0.2999999999999999,550,420,0.2999999999999999,162,0.0,0.3,9621,3861,5760
5000,1965,528,0.5,796,219,0.5,1169,309,0.5,163,0.0,0.5,8445,3427,5018
5000,8927,53,0.7000000000000001,3604,22,0.6999999999999998,5323,31,0.6999999999999997,164,0.0,0.7,1640,663,977
641,1755,0,0.0,689,0,0.0,1066,0,0.0,165,0.0,0.9,30,11,19
5000,3124,1994,0.13188299043713891,1216,802,0.1203969325689658,1908,1192,0.13961102601622852,166,0.8,0.1,7317,2973,4344
5000,2942,1932,0.13009702123401629,1232,786,0.12976006983045701,1710,1146,0.1303281240291276,167,0.8,0.3,7595,2996,4599
5000,2515,1829,0.12423944066049847,998,789,0.12265307387319513,1517,1040,0.12544294392509683,168,0.8,0.5,7892,3177,4715
5000,7697,994,0.1825455576437488,3085,405,0.17807298657017964,4612,589,0.18562092485053228,169,0.8,0.7,2746,1102,1644
5000,9535,277,0.23889259982770292,3858,116,0.27219279967874294,5677,161,0.21489990925179833,170,0.8,0.9,933,340,593
5000,3018,3042,0.09999999999999994,1260,1261,0.10000000000000006,1758,1781,0.09999999999999988,171,0.0,0.1,7557,2978,4579
5000,853,711,0.3000000000000003,378,308,0.29999999999999993,475,403,0.29999999999999993,172,0.0,0.3,9662,3927,5735
5000,2104,447,0.5,882,171,0.5,1222,276,0.5,173,0.0,0.5,8652,3436,5216
5000,9193,79,0.7000000000000005,3743,37,0.6999999999999998,5450,42,0.6999999999999998,174,0.0,0.7,1323,520,803
3638,7382,0,0.0,2919,0,0.0,4463,0,0.0,175,0.0,0.9,415,175,240
5000,3347,1846,0.13688214739943272,1342,745,0.1366437231972536,2005,1101,0.1370434789440498,176,0.8,0.1,7195,2873,4322
5000,2965,1886,0.13496005189561114,1158,767,0.14055361069004818,1807,1119,0.1311260397460729,177,0.8,0.3,7655,3185,4470
5000,3358,1738,0.15179722529711112,1337,678,0.14913419579017986,2021,1060,0.15350055926475203,178,0.8,0.5,7156,2849,4307
5000,6733,1117,0.17064884445911466,2748,459,0.17053610350996795,3985,658,0.17072748898139178,179,0.8,0.7,3713,1484,2229
5000,3393,2048,0.14606820683059987,1317,832,0.14432778465997861,2076,1216,0.14725902199997218,180,0.8,0.9,7148,2910,4238
5000,2617,3024,0.09999999999999998,1093,1202,0.10000000000000007,1524,1822,0.09999999999999984,181,0.0,0.1,7900,3105,4795
5000,1033,663,0.3000000000000003,414,227,0.29999999999999993,619,436,0.29999999999999993,182,0.0,0.3,9364,3711,5653
5000,1608,493,0.5,658,192,0.5,950,301,0.5,183,0.0,0.5,8866,3532,5334
5000,9583,14,0.7,3882,9,0.7000000000000001,5701,5,0.7,184,0.0,0.7,1064,399,665
1509,3285,0,0.0,1287,0,0.0,1998,0,0.0,185,0.0,0.9,125,55,70
5000,7091,1166,0.19696841492164205,2844,486,0.21502710031233072,4247,680,0.18406176624535578,186,0.8,0.1,3438,1393,2045
5000,2932,2029,0.15396363403791455,1086,828,0.1537149926905622,1846,1201,0.15413505371785427,187,0.8,0.3,7646,3093,4553
5000,3351,1844,0.13519063678603288,1372,729,0.12892568176631275,1979,1115,0.1392867374222445,188,0.8,0.5,7187,2879,4308
5000,5589,1517,0.192997455969466,2256,614,0.19242865531581868,3333,903,0.1933842152179039,189,0.8,0.7,4807,1944,2863
5000,5565,1544,0.19536692665131805,2097,650,0.19936372275513473,3468,894,0.19246097870111578,190,0.8,0.9,4974,2064,2910
5000,1954,2989,0.09999999999999992,771,1193,0.10000000000000006,1183,1796,0.09999999999999992,191,0.0,0.1,8710,3526,5184
5000,1048,974,0.3000000000000005,415,410,0.2999999999999999,633,564,0.30000000000000016,192,0.0,0.3,9492,3836,5656
5000,1592,508,0.5,631,176,0.5,961,332,0.5,193,0.0,0.5,9068,3557,5511
5000,9583,19,0.7,3844,10,0.7000000000000001,5739,9,0.7000000000000001,194,0.0,0.7,866,341,525
1260,2933,0,0.0,1142,0,0.0,1791,0,0.0,195,0.0,0.9,82,44,38
5000,3333,1769,0.13692150366388842,1396,701,0.13186943842730667,1937,1068,0.14023751277516538,196,0.8,0.1,7162,2806,4356
5000,6863,1146,0.1982402337075442,2727,449,0.2239117325144745,4136,697,0.18170292672861788,197,0.8,0.3,3489,1439,2050
5000,6919,1276,0.1709931692100979,2761,539,0.17584710483444532,4158,737,0.1674432759922916,198,0.8,0.5,3567,1404,2163
5000,6782,1131,0.17939315867983094,2812,426,0.19265417587200015,3970,705,0.1713801185041372,199,0.8,0.7,3570,1424,2146
5000,8679,680,0.19920275975961826,3359,303,0.20284871299950225,5320,377,0.19627245781880953,200,0.8,0.9,1746,818,928
5000,2640,3057,0.09999999999999991,1112,1191,0.10000000000000006,1528,1866,0.09999999999999991,201,0.0,0.1,7828,3107,4721
5000,1002,679,0.30000000000000027,411,259,0.2999999999999999,591,420,0.2999999999999999,202,0.0,0.3,9380,3738,5642
5000,2539,657,0.5,953,260,0.5,1586,397,0.5,203,0.0,0.5,7959,3189,4770
4358,8321,0,0.0,3350,0,0.0,4971,0,0.0,204,0.0,0.7,931,420,511
1808,3913,0,0.0,1560,0,0.0,2353,0,0.0,205,0.0,0.9,181,70,111
5000,2582,1978,0.1150095642905521,999,767,0.1069443256175563,1583,1211,0.12011777078286238,206,0.8,0.1,8027,3285,4742
5000,4207,1718,0.1550030505368298,1759,670,0.15924021380147663,2448,1048,0.1522941770756528,207,0.8,0.3,6437,2546,3891
5000,3541,1715,0.1670191544584025,1368,701,0.16161098397661589,2173,1014,0.17075793898279343,208,0.8,0.5,6942,2787,4155
5000,2472,1668,0.14128257385893003,908,666,0.13790631670108658,1564,1002,0.1435266729279158,209,0.8,0.7,7926,3170,4756
5000,9723,178,0.20402454488888383,3918,68,0.2534140953987417,5805,110,0.17349282275551717,210,0.8,0.9,826,306,520
5000,1650,2804,0.09999999999999994,655,1098,0.10000000000000005,995,1706,0.09999999999999994,211,0.0,0.1,8846,3542,5304
5000,877,663,0.3000000000000003,347,289,0.2999999999999998,530,374,0.2999999999999999,212,0.0,0.3,9568,3847,5721
5000,1914,768,0.5,728,313,0.5,1186,455,0.5,213,0.0,0.5,8389,3353,5036
2082,4518,0,0.0,1844,0,0.0,2674,0,0.0,214,0.0,0.7,229,83,146
647,1758,0,0.0,692,0,0.0,1066,0,0.0,215,0.0,0.9,36,12,24
5000,3658,1961,0.15056845202551114,1527,812,0.15156956464561633,2131,1149,0.14986096425568907,216,0.8,0.1,6863,2667,4196
5000,2369,1955,0.12179496441660802,904,789,0.1210854335042089,1465,1166,0.12227508439077865,217,0.8,0.3,7960,3268,4692
5000,2599,1657,0.13834554604070975,1027,661,0.1436082143790706,1572,996,0.13485295189246027,218,0.8,0.5,7774,3081,4693
5000,7718,898,0.2119625744954468,3103,347,0.21174718237658197,4615,551,0.21209822071186438,219,0.8,0.7,2766,1077,1689
1898,4105,0,0.0,1625,0,0.0,2480,0,0.0,220,0.8,0.9,79,18,61
5000,1879,2936,0.09999999999999991,765,1175,0.10000000000000007,1114,1761,0.09999999999999985,221,0.0,0.1,8476,3357,5119
5000,921,684,0.3000000000000004,373,293,0.2999999999999999,548,391,0.2999999999999998,222,0.0,0.3,9527,3876,5651
5000,2097,740,0.5,784,321,0.5,1313,419,0.5,223,0.0,0.5,8543,3531,5012
1577,3441,0,0.0,1368,0,0.0,2073,0,0.0,224,0.0,0.7,133,55,78
1573,3475,0,0.0,1396,0,0.0,2079,0,0.0,225,0.0,0.9,141,68,73
5000,3962,1789,0.1404244716797334,1661,707,0.14335057728312423,2301,1082,0.13851249694627923,226,0.8,0.1,6544,2552,3992
5000,2888,1871,0.13006790688821748,1109,736,0.1304118043972617,1779,1135,0.12984490374578883,227,0.8,0.3,7807,3165,4642
5000,3200,1748,0.15164588728832867,1240,732,0.15263098003783174,1960,1016,0.15093615511053707,228,0.8,0.5,7343,2959,4384
1430,3301,0,0.0,1344,0,0.0,1957,0,0.0,229,0.8,0.7,47,8,39
5000,7217,957,0.2013333140046228,2858,386,0.2070959546061887,4359,571,0.19743772858920325,230,0.8,0.9,3440,1390,2050
5000,1807,2892,0.09999999999999999,716,1142,0.10000000000000007,1091,1750,0.09999999999999988,231,0.0,0.1,8548,3371,5177
5000,981,611,0.30000000000000016,392,246,0.29999999999999993,589,365,0.2999999999999998,232,0.0,0.3,9361,3748,5613
5000,1342,484,0.5,516,187,0.5,826,297,0.5,233,0.0,0.5,9090,3608,5482
1478,3368,0,0.0,1352,0,0.0,2016,0,0.0,234,0.0,0.7,86,18,68
1270,2849,0,0.0,1167,0,0.0,1682,0,0.0,235,0.0,0.9,177,39,138
5000,3804,2123,0.13696161702141307,1501,859,0.13364794569355049,2303,1264,0.13921355030514246,236,0.8,0.1,6740,2691,4049
5000,3423,1820,0.14515564468716274,1410,720,0.14671497983083936,2013,1100,0.14413498895675622,237,0.8,0.3,6939,2738,4201
5000,4054,1857,0.16186365015195953,1590,735,0.15817945830966476,2464,1122,0.1642770913320723,238,0.8,0.5,6494,2616,3878
5000,9783,309,0.1294895108899541,3942,111,0.1408168243964234,5841,198,0.12313935028784256,239,0.8,0.7,871,278,593
5000,8332,737,0.18569716723910343,3377,254,0.16604332313506967,4955,483,0.19603272914888512,240,0.8,0.9,2005,684,1321
5000,1960,2857,0.09999999999999994,816,1144,0.10000000000000007,1144,1713,0.09999999999999991,241,0.0,0.1,8424,3312,5112
5000,967,670,0.30000000000000043,394,256,0.2999999999999998,573,414,0.2999999999999998,242,0.0,0.3,9400,3804,5596
5000,3043,755,0.5,1219,315,0.5,1824,440,0.5,243,0.0,0.5,7591,3063,4528
5000,8685,93,0.7000000000000003,3403,57,0.7000000000000002,5282,36,0.6999999999999998,244,0.0,0.7,1766,714,1052
977,2348,0,0.0,914,0,0.0,1434,0,0.0,245,0.0,0.9,87,39,48
5000,2602,1955,0.1252415140451493,1044,765,0.11808616229102203,1558,1190,0.1298413830299454,246,0.8,0.1,8023,3190,4833
5000,2911,2015,0.12520795631857762,1190,787,0.12134127180385355,1721,1228,0.12768603507516382,247,0.8,0.3,7616,2962,4654
5000,3835,1862,0.15471707433743564,1516,746,0.13986336721373452,2319,1116,0.16464616530005297,248,0.8,0.5,6683,2688,3995
5000,6751,1145,0.19690524562669157,2645,433,0.1953170588301166,4106,712,0.19787109518135026,249,0.8,0.7,3685,1444,2241
1795,3956,0,0.0,1554,0,0.0,2402,0,0.0,250,0.8,0.9,87,34,53
5000,3089,3134,0.09999999999999988,1232,1282,0.10000000000000007,1857,1852,0.09999999999999985,251,0.0,0.1,7243,2886,4357
5000,805,693,0.30000000000000027,306,305,0.29999999999999977,499,388,0.2999999999999999,252,0.0,0.3,9578,3850,5728
5000,1863,639,0.5,758,289,0.5,1105,350,0.5,253,0.0,0.5,8673,3502,5171
1069,2595,0,0.0,999,0,0.0,1596,0,0.0,254,0.0,0.7,46,20,26
879,2137,0,0.0,874,0,0.0,1263,0,0.0,255,0.0,0.9,27,6,21
5000,2824,2032,0.12893136504079128,1081,792,0.12823755106374332,1743,1240,0.12937451074226053,256,0.8,0.1,7735,3210,4525
5000,4827,1561,0.17453540300274414,1958,614,0.1883908061457883,2869,947,0.16555206875794043,257,0.8,0.3,5676,2223,3453
5000,2739,1620,0.13153358743745353,1138,667,0.13266870679248202,1601,953,0.13073912299904428,258,0.8,0.5,7844,3101,4743
5000,7671,945,0.16646847509909116,3032,406,0.18310735477993592,4639,539,0.1539352930018314,259,0.8,0.7,2853,1212,1641
1415,3228,0,0.0,1264,0,0.0,1964,0,0.0,260,0.8,0.9,63,18,45
5000,1600,2614,0.09999999999999995,665,976,0.09999999999999983,935,1638,0.09999999999999995,261,0.0,0.1,8867,3474,5393
5000,871,731,0.3000000000000004,413,286,0.2999999999999998,458,445,0.3000000000000002,262,0.0,0.3,9568,3898,5670
5000,2002,502,0.5,769,215,0.5,1233,287,0.5,263,0.0,0.5,8318,3198,5120
704,1853,0,0.0,726,0,0.0,1127,0,0.0,264,0.0,0.7,44,12,32
1252,2899,0,0.0,1187,0,0.0,1712,0,0.0,265,0.0,0.9,101,40,61
5000,2373,1796,0.12127812807019149,965,750,0.11863160798646205,1408,1046,0.12317572851263611,266,0.8,0.1,8220,3328,4892
5000,6070,1416,0.1558550750566504,2495,580,0.16240479491085758,3575,836,0.151311011042966,267,0.8,0.3,4422,1723,2699
5000,3553,1724,0.15315305611988125,1389,721,0.1491985608426861,2164,1003,0.15599571922542238,268,0.8,0.5,6926,2863,4063
5000,4084,1593,0.17634709683412053,1641,602,0.1727959462876451,2443,991,0.17850430433056666,269,0.8,0.7,6401,2508,3893
5000,4803,1454,0.14463347254125064,1899,553,0.14142437360653218,2904,901,0.14660309708164942,270,0.8,0.9,5681,2157,3524
5000,2534,3129,0.09999999999999988,1001,1267,0.10000000000000007,1533,1862,0.09999999999999992,271,0.0,0.1,7967,3165,4802
5000,967,626,0.30000000000000016,412,256,0.2999999999999998,555,370,0.29999999999999993,272,0.0,0.3,9357,3740,5617
5000,2086,412,0.5,894,160,0.5,1192,252,0.5,273,0.0,0.5,8302,3248,5054
5000,7733,98,0.7,3037,33,0.6999999999999997,4696,65,0.7000000000000005,274,0.0,0.7,2749,1156,1593
738,1964,0,0.0,785,0,0.0,1179,0,0.0,275,0.0,0.9,32,11,21
5000,2260,1825,0.11626851939329455,867,729,0.1189387358744197,1393,1096,0.11449243562072138,276,0.8,0.1,8140,3348,4792
5000,2447,1817,0.11865027635429162,922,728,0.1160961015236871,1525,1089,0.12035775043756075,277,0.8,0.3,8157,3267,4890
5000,2621,1827,0.12822698832953122,1046,693,0.12104871400167146,1575,1134,0.13261371152989004,278,0.8,0.5,7941,3114,4827
5000,7756,851,0.1713922126878116,3137,315,0.16159809118177929,4619,536,0.17714808633408055,279,0.8,0.7,2670,999,1671
5000,9368,341,0.18196032580320395,3790,113,0.16144771838829172,5578,228,0.19212666193427894,280,0.8,0.9,903,300,603
5000,1906,2941,0.0999999999999999,791,1172,0.10000000000000006,1115,1769,0.09999999999999992,281,0.0,0.1,8694,3436,5258
5000,979,720,0.30000000000000043,395,291,0.2999999999999999,584,429,0.29999999999999993,282,0.0,0.3,9614,3888,5726
5000,1819,517,0.5,723,211,0.5,1096,306,0.5,283,0.0,0.5,8630,3441,5189
492,1389,0,0.0,552,0,0.0,837,0,0.0,284,0.0,0.7,32,17,15
772,1945,0,0.0,773,0,0.0,1172,0,0.0,285,0.0,0.9,83,34,49
5000,2664,1958,0.1355229793048951,1070,814,0.13061472947689373,1594,1144,0.13901538783635753,286,0.8,0.1,7626,3176,4450
5000,4004,1657,0.14916363285788325,1581,681,0.15334476257178908,2423,976,0.1462462667357831,287,0.8,0.3,6347,2579,3768
5000,6241,1306,0.20855124252210397,2460,522,0.21198247680040666,3781,784,0.2062666707194586,288,0.8,0.5,4190,1690,2500
5000,7176,899,0.1952197845077756,2901,346,0.20026096117550776,4275,553,0.1920656305710027,289,0.8,0.7,3149,1179,1970
5000,5393,1392,0.1621675837932076,2237,555,0.1572752944080218,3156,837,0.16541157496259604,290,0.8,0.9,5054,1957,3097
5000,2199,2988,0.09999999999999992,936,1204,0.10000000000000007,1263,1784,0.09999999999999988,291,0.0,0.1,8299,3285,5014
5000,899,645,0.3000000000000002,353,262,0.2999999999999999,546,383,0.2999999999999998,292,0.0,0.3,9445,3745,5700
5000,3703,816,0.5,1527,334,0.5,2176,482,0.5,293,0.0,0.5,6816,2696,4120
5000,9079,55,0.7000000000000002,3629,29,0.6999999999999997,5450,26,0.6999999999999998,294,0.0,0.7,1444,622,822
1247,2914,0,0.0,1135,0,0.0,1779,0,0.0,295,0.0,0.9,65,15,50
5000,3167,1684,0.153078614049985,1382,632,0.15359006213258486,1785,1052,0.15277135626652188,296,0.8,0.1,7210,2759,4451
5000,2935,1791,0.13125359801236403,1234,667,0.1259354276955917,1701,1124,0.13440948733735256,297,0.8,0.3,7442,2814,4628
5000,3363,1746,0.16129256588347257,1370,699,0.15868824609234172,1993,1047,0.16303126648901253,298,0.8,0.5,7217,2860,4357
5000,10263,11,0.12795531488452946,4045,1,0.106597368762142,6218,10,0.13009110949676822,299,0.8,0.7,225,63,162
5000,4905,1456,0.16583587502794683,1939,596,0.16732779344113546,2966,860,0.16480194087183023,300,0.8,0.9,5644,2314,3330
5000,2076,3039,0.09999999999999995,860,1243,0.10000000000000007,1216,1796,0.09999999999999992,301,0.0,0.1,8289,3336,4953
5000,906,609,0.30000000000000043,343,285,0.2999999999999999,563,324,0.2999999999999999,302,0.0,0.3,9507,3870,5637
5000,1692,633,0.5,651,266,0.5,1041,367,0.5,303,0.0,0.5,8817,3452,5365
1100,2605,0,0.0,1041,0,0.0,1564,0,0.0,304,0.0,0.7,90,43,47
899,2192,0,0.0,897,0,0.0,1295,0,0.0,305,0.0,0.9,68,33,35
5000,5421,1610,0.19378047930722542,2192,625,0.1815676864297314,3229,985,0.20152971336654896,306,0.8,0.1,4903,1919,2984
5000,2352,1915,0.12352136626799036,953,768,0.11805692068665928,1399,1147,0.12718021038870728,307,0.8,0.3,8097,3249,4848
5000,6992,1101,0.17862191011793307,2869,451,0.17697660260483974,4123,650,0.179763500407787,308,0.8,0.5,3469,1363,2106
5000,7015,1095,0.1926483850717968,2845,438,0.19990034206656465,4170,657,0.18781374707528486,309,0.8,0.7,3547,1397,2150
5000,7098,977,0.19331150331151362,2859,412,0.18884358569077267,4239,565,0.19656952465619526,310,0.8,0.9,3369,1322,2047
5000,2081,3051,0.09999999999999994,805,1232,0.10000000000000006,1276,1819,0.09999999999999985,311,0.0,0.1,8434,3396,5038
5000,855,748,0.3000000000000004,316,291,0.2999999999999999,539,457,0.3000000000000001,312,0.0,0.3,9498,3806,5692
5000,2648,676,0.5,1093,289,0.5,1555,387,0.5,313,0.0,0.5,7757,3053,4704
1460,3194,0,0.0,1299,0,0.0,1895,0,0.0,314,0.0,0.7,145,70,75
905,2198,0,0.0,932,0,0.0,1266,0,0.0,315,0.0,0.9,67,29,38
5000,2335,1902,0.11996458477861607,924,743,0.12400984270797662,1411,1159,0.11737129173157994,316,0.8,0.1,8018,3259,4759
5000,2797,1831,0.14921148854909513,1124,745,0.14962721327265582,1673,1086,0.14892629985751793,317,0.8,0.3,7606,2985,4621
5000,3325,1882,0.14215905242481738,1351,798,0.1397422578001533,1974,1084,0.14393820566326918,318,0.8,0.5,7051,2879,4172
5000,7228,1037,0.21339968312187838,2865,417,0.21368964193765896,4363,620,0.21320466243449043,319,0.8,0.7,3260,1332,1928
5000,10342,1,0.002628261001801399,4113,0,0.0,6229,1,0.002628261001801399,320,0.8,0.9,35,9,26
5000,1822,2928,0.09999999999999992,688,1176,0.10000000000000006,1134,1752,0.09999999999999988,321,0.0,0.1,8840,3560,5280
5000,968,669,0.30000000000000043,394,270,0.29999999999999977,574,399,0.29999999999999977,322,0.0,0.3,9577,3828,5749
5000,1989,736,0.5,750,307,0.5,1239,429,0.5,323,0.0,0.5,8469,3427,5042
3245,6580,0,0.0,2645,0,0.0,3935,0,0.0,324,0.0,0.7,405,171,234
551,1582,0,0.0,635,0,0.0,947,0,0.0,325,0.0,0.9,21,7,14
5000,2506,1816,0.11337903093916035,981,762,0.11416395504125693,1525,1054,0.11281156209115503,326,0.8,0.1,8019,3180,4839
5000,2418,1935,0.12082177159449439,925,811,0.11514001371739001,1493,1124,0.12492133177094607,327,0.8,0.3,7833,3223,4610
5000,8034,721,0.18741216726200566,3332,258,0.1939790252343815,4702,463,0.18375288139402945,328,0.8,0.5,2435,841,1594
5000,3167,1722,0.15387858971810556,1260,711,0.16537548984825826,1907,1011,0.14579323265328006,329,0.8,0.7,7124,2854,4270
5000,5191,1754,0.18414481550909287,1994,695,0.17211237927155726,3197,1059,0.19204145685478416,330,0.8,0.9,5282,2150,3132
5000,1815,2981,0.09999999999999994,710,1220,0.10000000000000005,1105,1761,0.09999999999999985,331,0.0,0.1,8864,3606,5258
5000,914,625,0.30000000000000043,397,233,0.2999999999999998,517,392,0.2999999999999998,332,0.0,0.3,9540,3728,5812
5000,1829,522,0.5,736,197,0.5,1093,325,0.5,333,0.0,0.5,8737,3441,5296
5000,10199,20,0.7,4084,9,0.7000000000000001,6115,11,0.7000000000000001,334,0.0,0.7,418,148,270
1115,2581,0,0.0,1049,0,0.0,1532,0,0.0,335,0.0,0.9,74,31,43
5000,2923,1787,0.1254190134060046,1243,700,0.12535803528403477,1680,1087,0.1254582817458196,336,0.8,0.1,7499,2959,4540
5000,3218,1770,0.1494506267076002,1317,701,0.1593882445329732,1901,1069,0.14293400360602249,337,0.8,0.3,7149,2868,4281
5000,3286,1931,0.15134360658120088,1339,723,0.1527913503596501,1947,1208,0.1504771175482383,338,0.8,0.5,7199,2869,4330
5000,5009,1650,0.17918038276175427,1987,685,0.17420077787973548,3022,965,0.18271512819614075,339,0.8,0.7,5463,2241,3222
5000,7920,703,0.2331474042590312,3130,316,0.24257844823842778,4790,387,0.2254466034903248,340,0.8,0.9,2600,1080,1520
5000,1818,2877,0.0999999999999999,697,1187,0.10000000000000006,1121,1690,0.09999999999999988,341,0.0,0.1,8665,3456,5209
5000,913,713,0.3000000000000003,355,306,0.29999999999999993,558,407,0.2999999999999999,342,0.0,0.3,9545,3835,5710
5000,9275,112,0.5,3693,45,0.5,5582,67,0.5,343,0.0,0.5,1087,408,679
5000,8163,30,0.6999999999999997,3238,16,0.6999999999999998,4925,14,0.7,344,0.0,0.7,2259,861,1398
2177,4552,0,0.0,1820,0,0.0,2732,0,0.0,345,0.0,0.9,202,74,128
5000,4031,1773,0.15207887172277376,1692,696,0.1498239678976479,2339,1077,0.15353607976575195,346,0.8,0.1,6510,2582,3928
5000,4445,1729,0.1518634831158307,1891,708,0.15238217155149275,2554,1021,0.15150380494496998,347,0.8,0.3,6082,2370,3712
5000,4959,1621,0.15827488753488891,2004,644,0.14956039148424322,2955,977,0.1640191408169932,348,0.8,0.5,5647,2286,3361
5000,3275,1810,0.1571761690308856,1306,738,0.1499897583577684,1969,1072,0.16212353010995317,349,0.8,0.7,7286,2928,4358
5000,4034,1794,0.14587682865009174,1624,755,0.1414254546881099,2410,1039,0.1491114651672199,350,0.8,0.9,6473,2618,3855
5000,1615,2895,0.1,653,1171,0.10000000000000006,962,1724,0.09999999999999987,351,0.0,0.1,8903,3602,5301
5000,879,695,0.30000000000000027,345,262,0.2999999999999999,534,433,0.3,352,0.0,0.3,9542,3796,5746
5000,2782,758,0.5,1159,293,0.5,1623,465,0.5,353,0.0,0.5,8019,3179,4840
5000,8681,57,0.7000000000000002,3460,19,0.7,5221,38,0.6999999999999998,354,0.0,0.7,1766,729,1037
1055,2542,0,0.0,1040,0,0.0,1502,0,0.0,355,0.0,0.9,91,20,71
5000,2817,1858,0.1410380115190452,1126,754,0.14112487427559453,1691,1104,0.14097868677408287,356,0.8,0.1,7505,3066,4439
5000,2555,1665,0.125130736424982,1038,640,0.12528053826969165,1517,1025,0.12503720161462673,357,0.8,0.3,7969,3188,4781
5000,2308,1750,0.13313315233294193,931,683,0.13210921173572482,1377,1067,0.1337885894724914,358,0.8,0.5,8204,3277,4927
5000,9668,166,0.14962191766543054,3804,53,0.125899318070088,5864,113,0.16074844667917532,359,0.8,0.7,591,229,362
5000,10093,96,0.2093237790572302,4045,39,0.2382727086491855,6048,57,0.1895166167048397,360,0.8,0.9,399,132,267
5000,1596,2679,0.09999999999999995,641,1072,0.10000000000000007,955,1607,0.09999999999999996,361,0.0,0.1,8793,3480,5313
5000,829,671,0.30000000000000043,336,264,0.2999999999999998,493,407,0.2999999999999999,362,0.0,0.3,9571,3812,5759
2116,4418,0,0.0,1816,0,0.0,2602,0,0.0,363,0.0,0.5,182,44,138
2286,4924,0,0.0,1982,0,0.0,2942,0,0.0,364,0.0,0.7,181,54,127
1048,2489,0,0.0,1010,0,0.0,1479,0,0.0,365,0.0,0.9,103,22,81
5000,4811,1800,0.1636805191997489,1971,693,0.16164945792569946,2840,1107,0.16495199658269036,366,0.8,0.1,5673,2208,3465
5000,7894,803,0.20754905091426093,3250,331,0.19931265735928372,4644,472,0.2133249963945521,367,0.8,0.3,2667,1051,1616
5000,3748,1691,0.13566323800225163,1447,677,0.13450874609783456,2301,1014,0.13643403782403704,368,0.8,0.5,6581,2564,4017
5000,8197,683,0.17085203151914363,3326,256,0.1748873544751783,4871,427,0.1684327278265326,369,0.8,0.7,2402,923,1479
5000,2907,1820,0.14350684326413676,1122,694,0.13835686305142597,1785,1126,0.14668098737392465,370,0.8,0.9,7654,3101,4553
5000,1743,2907,0.09999999999999998,673,1201,0.10000000000000006,1070,1706,0.09999999999999994,371,0.0,0.1,8754,3565,5189
5000,1079,675,0.3000000000000002,445,275,0.29999999999999993,634,400,0.29999999999999977,372,0.0,0.3,9574,3896,5678
5000,2012,697,0.5,816,247,0.5,1196,450,0.5,373,0.0,0.5,8511,3462,5049
5000,9214,42,0.6999999999999998,3624,14,0.7,5590,28,0.6999999999999998,374,0.0,0.7,1363,556,807
5000,9683,10,0.9000000000000001,3799,2,0.9,5884,8,0.9000000000000001,375,0.0,0.9,691,297,394
5000,3878,1867,0.13319219844233596,1623,737,0.13310935081604977,2255,1130,0.13324623269063054,376,0.8,0.1,6583,2665,3918
5000,6027,1332,0.18898896744989832,2469,546,0.20560011831612104,3558,786,0.17744992371840013,377,0.8,0.3,4405,1708,2697
5000,3152,1694,0.1346468727882705,1279,710,0.13189228514720466,1873,984,0.1366344309439177,378,0.8,0.5,7153,2873,4280
5000,5580,1349,0.1842573702159405,2285,534,0.1866591936732774,3295,815,0.18268366012242165,379,0.8,0.7,4907,1925,2982
457,1341,0,0.0,528,0,0.0,813,0,0.0,380,0.8,0.9,11,0,11
5000,1669,2864,0.09999999999999994,640,1203,0.10000000000000007,1029,1661,0.09999999999999988,381,0.0,0.1,8711,3530,5181
5000,992,685,0.3000000000000004,390,257,0.2999999999999998,602,428,0.2999999999999999,382,0.0,0.3,9561,3814,5747
5000,2757,631,0.5,1135,230,0.5,1622,401,0.5,383,0.0,0.5,7684,3071,4613
1841,3995,0,0.0,1550,0,0.0,2445,0,0.0,384,0.0,0.7,221,70,151
449,1382,0,0.0,536,0,0.0,846,0,0.0,385,0.0,0.9,36,23,13
5000,2775,1783,0.11710752654767762,1083,733,0.11868759560348434,1692,1050,0.1160044878639573,386,0.8,0.1,7903,3165,4738
5000,4512,1724,0.14770290027345984,1904,669,0.14872445847430452,2608,1055,0.1470551064949147,387,0.8,0.3,5763,2209,3554
5000,2958,1918,0.13656534322729622,1153,781,0.13123287162005112,1805,1137,0.14022819311758505,388,0.8,0.5,7490,3056,4434
5000,4262,1642,0.15324512884242825,1725,637,0.143675296401113,2537,1005,0.1593107838325954,389,0.8,0.7,6202,2449,3753
5000,10280,20,0.12514422413285653,4048,2,0.1785222770561052,6232,18,0.1192133293636067,390,0.8,0.9,164,61,103
5000,2063,3035,0.09999999999999996,852,1218,0.10000000000000009,1211,1817,0.09999999999999985,391,0.0,0.1,8425,3339,5086
5000,914,681,0.3000000000000003,345,264,0.2999999999999998,569,417,0.2999999999999998,392,0.0,0.3,9587,3896,5691
5000,1696,527,0.5,712,202,0.5,984,325,0.5,393,0.0,0.5,8878,3627,5251
5000,7682,113,0.7000000000000003,3023,34,0.7,4659,79,0.7000000000000005,394,0.0,0.7,2725,1133,1592
1372,3067,0,0.0,1211,0,0.0,1856,0,0.0,395,0.0,0.9,138,67,71
5000,3740,1872,0.14854042778200705,1519,715,0.1523194247734147,2221,1157,0.14620509256259784,396,0.8,0.1,6839,2720,4119
5000,2651,1778,0.12320875489268658,1026,716,0.1265187883837787,1625,1062,0.12097713155970924,397,0.8,0.3,7760,3076,4684
5000,3511,1740,0.1580372829593108,1338,683,0.1471100953068249,2173,1057,0.16509808633362275,398,0.8,0.5,7049,2843,4206
1423,3185,0,0.0,1269,0,0.0,1916,0,0.0,399,0.8,0.7,82,28,54
1251,2929,0,0.0,1169,0,0.0,1760,0,0.0,400,0.8,0.9,42,5,37
5000,1915,2938,0.09999999999999991,750,1175,0.10000000000000007,1165,1763,0.0999999999999999,401,0.0,0.1,8509,3443,5066
5000,799,697,0.3000000000000003,290,285,0.2999999999999999,509,412,0.2999999999999998,402,0.0,0.3,9696,3928,5768
5000,1553,446,0.5,642,176,0.5,911,270,0.5,403,0.0,0.5,8883,3450,5433
2008,4513,0,0.0,1802,0,0.0,2711,0,0.0,404,0.0,0.7,92,26,66
3383,6869,0,0.0,2747,0,0.0,4122,0,0.0,405,0.0,0.9,233,108,125
5000,2099,1784,0.11447171660663175,899,662,0.11051989091038666,1200,1122,0.11680336420994217,406,0.8,0.1,8569,3442,5127
5000,4713,1529,0.17555091766525394,1861,632,0.18571539214944252,2852,897,0.16838932583247,407,0.8,0.3,5756,2323,3433
5000,4153,1548,0.13879186193038878,1693,636,0.14341354949043092,2460,912,0.13556884297404362,408,0.8,0.5,6304,2496,3808
1716,3798,0,0.0,1572,0,0.0,2226,0,0.0,409,0.8,0.7,116,34,82
5000,5266,1619,0.1761699014972124,2063,647,0.16580400205756132,3203,972,0.18306983661805004,410,0.8,0.9,5176,2174,3002
5000,3267,3065,0.0999999999999999,1365,1200,0.10000000000000007,1902,1865,0.09999999999999991,411,0.0,0.1,7332,2815,4517
5000,1013,644,0.3000000000000002,409,283,0.2999999999999999,604,361,0.2999999999999998,412,0.0,0.3,9351,3786,5565
5000,5251,668,0.5,2154,268,0.5,3097,400,0.5,413,0.0,0.5,5312,2098,3214
677,1775,0,0.0,678,0,0.0,1097,0,0.0,414,0.0,0.7,32,17,15
618,1642,0,0.0,655,0,0.0,987,0,0.0,415,0.0,0.9,40,18,22
5000,2387,1868,0.12365170328460155,959,749,0.12141799510687581,1428,1119,0.1251468305635261,416,0.8,0.1,8117,3254,4863
5000,2951,1961,0.14222358208930225,1177,827,0.15109849283603022,1774,1134,0.1357513147281523,417,0.8,0.3,7492,3063,4429
5000,3653,1655,0.14866810637598266,1447,646,0.15924463800038463,2206,1009,0.14189661041031007,418,0.8,0.5,6834,2758,4076
5000,7566,1121,0.18252867755531915,2971,471,0.1633188206557133,4595,650,0.1964484354010336,419,0.8,0.7,2905,1199,1706
5000,10384,1,0.14332710825631836,4146,0,0.0,6238,1,0.14332710825631836,420,0.8,0.9,70,40,30
5000,1775,2964,0.09999999999999998,693,1155,0.10000000000000007,1082,1809,0.09999999999999988,421,0.0,0.1,8653,3425,5228
5000,979,733,0.30000000000000043,374,308,0.29999999999999993,605,425,0.2999999999999998,422,0.0,0.3,9509,3835,5674
5000,5851,587,0.5,2458,223,0.5,3393,364,0.5,423,0.0,0.5,4512,1714,2798
2216,4682,0,0.0,1903,0,0.0,2779,0,0.0,424,0.0,0.7,254,90,164
2462,5059,0,0.0,1961,0,0.0,3098,0,0.0,425,0.0,0.9,275,117,158
5000,2650,1880,0.12141951916603577,1101,735,0.1268394137990086,1549,1145,0.11794037282958605,426,0.8,0.1,7782,3140,4642
5000,2802,1862,0.12711277844255275,1144,737,0.12059306135097274,1658,1125,0.13138391755054782,427,0.8,0.3,7630,3016,4614
5000,9809,182,0.17176721389954053,3972,72,0.19214638921892843,5837,110,0.15842811732685022,428,0.8,0.5,544,159,385
5000,6351,1170,0.22397098135604684,2546,483,0.2291707219485398,3805,687,0.22031526853774397,429,0.8,0.7,4141,1685,2456
5000,4587,1623,0.15690837627538956,1851,641,0.1615823514971573,2736,982,0.1538574413292051,430,0.8,0.9,5838,2366,3472
5000,1810,2834,0.09999999999999999,773,1148,0.10000000000000009,1037,1686,0.0999999999999999,431,0.0,0.1,8506,3435,5071
5000,872,734,0.30000000000000043,340,287,0.2999999999999998,532,447,0.30000000000000027,432,0.0,0.3,9490,3812,5678
5000,2611,623,0.5,1143,225,0.5,1468,398,0.5,433,0.0,0.5,7720,2984,4736
5000,8625,54,0.7000000000000001,3395,25,0.6999999999999998,5230,29,0.6999999999999997,434,0.0,0.7,1751,741,1010
1094,2580,0,0.0,1034,0,0.0,1546,0,0.0,435,0.0,0.9,64,18,46
5000,3571,1855,0.13713432383799298,1487,751,0.13957442169732773,2084,1104,0.13547443842824608,436,0.8,0.1,6876,2753,4123
5000,2898,1838,0.12299955185651786,1193,725,0.11843971859709201,1705,1113,0.125969793647249,437,0.8,0.3,7657,3025,4632
5000,3244,1843,0.14195942051750246,1256,753,0.1496973058664118,1988,1090,0.13661389054710898,438,0.8,0.5,7189,2884,4305
5000,3595,1850,0.1397520116243346,1384,780,0.1319651531171062,2211,1070,0.14542841315296834,439,0.8,0.7,6953,2772,4181
1053,2466,0,0.0,952,0,0.0,1514,0,0.0,440,0.8,0.9,74,29,45
5000,1614,2764,0.1,626,1079,0.10000000000000009,988,1685,0.0999999999999999,441,0.0,0.1,8801,3521,5280
5000,1001,673,0.3000000000000005,413,285,0.2999999999999999,588,388,0.2999999999999999,442,0.0,0.3,9496,3822,5674
5000,1551,449,0.5,636,181,0.5,915,268,0.5,443,0.0,0.5,8948,3648,5300
1185,2720,0,0.0,1092,0,0.0,1628,0,0.0,444,0.0,0.7,102,30,72
1414,3249,0,0.0,1282,0,0.0,1967,0,0.0,445,0.0,0.9,53,25,28
5000,3046,1920,0.1147457555427223,1248,738,0.11026424906337023,1798,1182,0.11754385349683556,446,0.8,0.1,7385,2892,4493
5000,7215,1136,0.19818317528343868,2907,456,0.2183995517377714,4308,680,0.1846263110728862,447,0.8,0.3,3353,1356,1997
5000,5957,1375,0.196782942997697,2386,557,0.19583947163860127,3571,818,0.19742538009673896,448,0.8,0.5,4429,1775,2654
5000,9927,136,0.25001956219183363,4032,51,0.2866273649011537,5895,85,0.2280548805662417,449,0.8,0.7,469,175,294
5000,6972,1212,0.17415493790706504,2711,515,0.1769647590872725,4261,697,0.17207881465339672,450,0.8,0.9,3627,1522,2105
5000,1974,2936,0.09999999999999991,828,1173,0.10000000000000006,1146,1763,0.0999999999999999,451,0.0,0.1,8441,3375,5066
5000,863,709,0.30000000000000027,310,281,0.2999999999999999,553,428,0.2999999999999999,452,0.0,0.3,9524,3771,5753
5000,1540,402,0.5,594,163,0.5,946,239,0.5,453,0.0,0.5,8952,3558,5394
5000,9551,23,0.7,3819,7,0.7000000000000001,5732,16,0.6999999999999998,454,0.0,0.7,930,395,535
1262,2867,0,0.0,1171,0,0.0,1696,0,0.0,455,0.0,0.9,99,26,73
5000,5060,1457,0.14880932936176117,2065,529,0.14590583039318797,2995,928,0.1504644489246656,456,0.8,0.1,5167,1980,3187
5000,2865,1842,0.12844595938867898,1119,768,0.13342106248699392,1746,1074,0.12488834376530292,457,0.8,0.3,7547,3057,4490
5000,2206,1700,0.13835077933343845,884,653,0.13265150673199216,1322,1047,0.14190533999126498,458,0.8,0.5,8304,3360,4944
5000,4677,1765,0.164981531223603,1857,722,0.15249595281495026,2820,1043,0.17362447236554665,459,0.8,0.7,5906,2409,3497
5000,8031,706,0.2402392118185126,3319,254,0.24987221724522818,4712,452,0.23482597425571217,460,0.8,0.9,2347,867,1480
5000,1885,2659,0.09999999999999999,813,1053,0.10000000000000006,1072,1606,0.09999999999999996,461,0.0,0.1,8441,3312,5129
5000,994,645,0.3000000000000002,396,243,0.3,598,402,0.29999999999999993,462,0.0,0.3,9414,3679,5735
5000,1793,579,0.5,771,232,0.5,1022,347,0.5,463,0.0,0.5,8623,3404,5219
932,2289,0,0.0,951,0,0.0,1338,0,0.0,464,0.0,0.7,33,12,21
1737,3863,0,0.0,1543,0,0.0,2320,0,0.0,465,0.0,0.9,190,77,113
5000,2049,1781,0.1183205062156566,848,676,0.12046641363238726,1201,1105,0.11700771579600962,466,0.8,0.1,8443,3338,5105
5000,2565,1952,0.11876200849337938,1028,739,0.11482354278655238,1537,1213,0.1211614529759393,467,0.8,0.3,7857,3126,4731
5000,5503,1482,0.19274127644360728,2242,594,0.19944695599152465,3261,888,0.18825572052979772,468,0.8,0.5,4942,1951,2991
5000,4152,1957,0.15032539747744209,1700,788,0.15167192910576438,2452,1169,0.14941772688452673,469,0.8,0.7,6358,2641,3717
1916,4141,0,0.0,1637,0,0.0,2504,0,0.0,470,0.8,0.9,98,27,71
5000,2430,3066,0.0999999999999999,931,1227,0.10000000000000006,1499,1839,0.0999999999999999,471,0.0,0.1,7999,3257,4742
5000,946,644,0.3000000000000002,362,242,0.3,584,402,0.29999999999999993,472,0.0,0.3,9580,3873,5707
5000,5074,754,0.5,2140,322,0.5,2934,432,0.5,473,0.0,0.5,5429,2175,3254
2167,4546,0,0.0,1793,0,0.0,2753,0,0.0,474,0.0,0.7,186,59,127
2669,5656,0,0.0,2331,0,0.0,3325,0,0.0,475,0.0,0.9,201,85,116
5000,3836,1889,0.13148737034640168,1578,786,0.13226866362293851,2258,1103,0.13093061919920496,476,0.8,0.1,6662,2628,4034
5000,3195,1830,0.14043662207907817,1203,739,0.14151698498598925,1992,1091,0.13970482722279284,477,0.8,0.3,7246,2971,4275
5000,3451,1681,0.14674153581900226,1343,693,0.15360924947428037,2108,988,0.14192440468225365,478,0.8,0.5,6959,2813,4146
5000,7298,970,0.17367290808827596,2873,391,0.18592624053103987,4425,579,0.16539820517787746,479,0.8,0.7,3247,1268,1979
5000,6306,1283,0.17833117247949443,2567,528,0.17259172623458818,3739,755,0.18234498389315076,480,0.8,0.9,4196,1620,2576
5000,2153,2905,0.09999999999999996,897,1159,0.10000000000000005,1256,1746,0.0999999999999999,481,0.0,0.1,8257,3249,5008
5000,814,749,0.3000000000000004,322,292,0.2999999999999999,492,457,0.3000000000000001,482,0.0,0.3,9567,3799,5768
5000,1772,550,0.5,760,218,0.5,1012,332,0.5,483,0.0,0.5,8678,3441,5237
957,2327,0,0.0,950,0,0.0,1377,0,0.0,484,0.0,0.7,48,12,36
2720,5472,0,0.0,2244,0,0.0,3228,0,0.0,485,0.0,0.9,300,126,174
5000,3561,1766,0.14505448305823063,1320,656,0.1458213073768808,2241,1110,0.14460129679423553,486,0.8,0.1,7068,2894,4174
5000,2741,1740,0.11983631603856304,1163,684,0.1168404030837041,1578,1056,0.12177685056614214,487,0.8,0.3,7784,3108,4676
5000,3694,1858,0.14755691314164812,1437,765,0.14916545048429666,2257,1093,0.14643108416897999,488,0.8,0.5,6721,2757,3964
5000,3072,1762,0.14805325534653613,1100,732,0.15120093813643826,1972,1030,0.14581626136380954,489,0.8,0.7,7386,3005,4381
5000,5752,1484,0.1592765087196448,2322,605,0.15753405166053733,3430,879,0.1604758107910442,490,0.8,0.9,4810,1932,2878
5000,1873,2924,0.09999999999999994,734,1162,0.10000000000000005,1139,1762,0.09999999999999985,491,0.0,0.1,8708,3442,5266
5000,886,671,0.30000000000000043,355,264,0.2999999999999998,531,407,0.2999999999999999,492,0.0,0.3,9657,3871,5786
5000,1290,367,0.5,520,149,0.5,770,218,0.5,493,0.0,0.5,9250,3725,5525
2059,4329,0,0.0,1725,0,0.0,2604,0,0.0,494,0.0,0.7,268,93,175
2500,5226,0,0.0,2043,0,0.0,3183,0,0.0,495,0.0,0.9,209,101,108
5000,2882,1715,0.132172389865869,1169,723,0.12473394032671188,1713,992,0.1375937598424926,496,0.8,0.1,7533,2988,4545
5000,2924,1839,0.1348725268382692,1194,756,0.13006331351450587,1730,1083,0.13822965082050845,497,0.8,0.3,7526,3036,4490
5000,2082,1888,0.12180872539121622,793,752,0.12458412129091824,1289,1136,0.11997149148577965,498,0.8,0.5,8332,3413,4919
5000,6734,1053,0.20192282386472402,2750,402,0.20417313461534883,3984,651,0.2005332310509742,499,0.8,0.7,3734,1471,2263
5000,8948,432,0.2317589828288917,3594,152,0.2350800992415355,5354,280,0.22995609106202797,500,0.8,0.9,1481,577,904
5000,1662,2836,0.09999999999999999,670,1118,0.10000000000000007,992,1718,0.0999999999999999,501,0.0,0.1,8968,3538,5430
5000,897,674,0.3000000000000002,349,264,0.2999999999999998,548,410,0.2999999999999999,502,0.0,0.3,9543,3805,5738
5000,1759,571,0.5,650,222,0.5,1109,349,0.5,503,0.0,0.5,8995,3593,5402
5000,9627,29,0.6999999999999997,3834,12,0.7000000000000001,5793,17,0.6999999999999998,504,0.0,0.7,893,403,490
1269,2895,0,0.0,1153,0,0.0,1742,0,0.0,505,0.0,0.9,124,48,76
5000,3052,1917,0.13478116340333748,1185,790,0.1423134754451307,1867,1127,0.12950119311672115,506,0.8,0.1,7403,2985,4418
5000,2590,1754,0.15323492202646724,964,705,0.15877568933389835,1626,1049,0.14951114609535285,507,0.8,0.3,7790,3126,4664
5000,5705,1500,0.19324448689490661,2301,592,0.19476661589865762,3404,908,0.1922520856061173,508,0.8,0.5,4660,1884,2776
5000,3569,1721,0.15770236881092947,1445,677,0.15906716331621218,2124,1044,0.15681734402158415,509,0.8,0.7,7022,2849,4173
5000,8781,552,0.1780853595618321,3612,183,0.17323985110776519,5169,369,0.18048841660002787,510,0.8,0.9,1660,626,1034
5000,2365,2966,0.09999999999999996,938,1207,0.10000000000000009,1427,1759,0.09999999999999985,511,0.0,0.1,7899,3093,4806
5000,964,773,0.3000000000000003,399,293,0.2999999999999999,565,480,0.3000000000000003,512,0.0,0.3,9551,3742,5809
5000,2421,591,0.5,1022,221,0.5,1399,370,0.5,513,0.0,0.5,7976,3137,4839
955,2280,0,0.0,925,0,0.0,1355,0,0.0,514,0.0,0.7,75,25,50
1224,2702,0,0.0,1117,0,0.0,1585,0,0.0,515,0.0,0.9,125,50,75
5000,2587,1739,0.11829505272674692,1072,710,0.11714958139015165,1515,1029,0.11908541681710907,516,0.8,0.1,7787,3138,4649
5000,4657,1699,0.16438177919433553,1912,718,0.1677726200549587,2745,981,0.16190000168370602,517,0.8,0.3,5943,2348,3595
5000,4740,1650,0.1592994149541217,1917,670,0.15040804652812897,2823,980,0.1653782076535249,518,0.8,0.5,5560,2177,3383
5000,5372,1463,0.16545784829275023,2243,586,0.16846327216304235,3129,877,0.16344966312970438,519,0.8,0.7,5189,2112,3077
703,1847,0,0.0,727,0,0.0,1120,0,0.0,520,0.8,0.9,22,4,18
5000,1741,2835,0.1,690,1126,0.10000000000000006,1051,1709,0.09999999999999992,521,0.0,0.1,8942,3509,5433
5000,877,618,0.30000000000000027,350,242,0.3,527,376,0.2999999999999999,522,0.0,0.3,9530,3779,5751
5000,1656,532,0.5,675,191,0.5,981,341,0.5,523,0.0,0.5,8583,3403,5180
3307,6493,0,0.0,2546,0,0.0,3947,0,0.0,524,0.0,0.7,506,220,286
2582,4955,0,0.0,1942,0,0.0,3013,0,0.0,525,0.0,0.9,603,299,304
5000,3500,1887,0.1457224285949127,1423,771,0.14814574232669797,2077,1116,0.14404825754902872,526,0.8,0.1,6823,2672,4151
5000,2431,1726,0.13330859237167175,976,694,0.1365148519081248,1455,1032,0.13115244497021983,527,0.8,0.3,8128,3198,4930
5000,3433,1743,0.16675574923896402,1409,674,0.16843468950965645,2024,1069,0.16569718446586132,528,0.8,0.5,7040,2767,4273
5000,4982,1430,0.1862064150153437,2025,567,0.1911880160767422,2957,863,0.18293345116619772,529,0.8,0.7,5489,2190,3299
675,1791,0,0.0,727,0,0.0,1064,0,0.0,530,0.8,0.9,36,4,32
5000,1806,2611,0.09999999999999996,753,1047,0.10000000000000007,1053,1564,0.0999999999999999,531,0.0,0.1,8567,3410,5157
5000,823,826,0.3000000000000004,339,328,0.2999999999999998,484,498,0.3,532,0.0,0.3,9620,3809,5811
5000,1534,356,0.5,620,134,0.5,914,222,0.5,533,0.0,0.5,9020,3674,5346
2345,5013,0,0.0,2008,0,0.0,3005,0,0.0,534,0.0,0.7,244,67,177
4463,8769,0,0.0,3432,0,0.0,5337,0,0.0,535,0.0,0.9,610,263,347
5000,3518,1943,0.14707694090527393,1437,747,0.14916494478127124,2081,1196,0.14577281139409495,536,0.8,0.1,7010,2767,4243
5000,2835,1816,0.1321456378559072,1194,707,0.1315542857559172,1641,1109,0.1325226314850261,537,0.8,0.3,7659,3029,4630
5000,2489,2012,0.12334745219538287,989,797,0.12117197953647334,1500,1215,0.12477449063912849,538,0.8,0.5,8254,3306,4948
5000,7313,977,0.2085681401398066,2947,433,0.20861206891276646,4366,544,0.2085331747745644,539,0.8,0.7,3217,1293,1924
5000,8317,689,0.1932732772566661,3364,273,0.1896451337285921,4953,416,0.19565424644696444,540,0.8,0.9,2102,796,1306
5000,1825,2904,0.09999999999999998,736,1167,0.10000000000000006,1089,1737,0.09999999999999992,541,0.0,0.1,8867,3491,5376
5000,966,658,0.3000000000000002,386,266,0.2999999999999998,580,392,0.2999999999999998,542,0.0,0.3,9568,3862,5706
5000,1811,568,0.5,722,220,0.5,1089,348,0.5,543,0.0,0.5,8764,3498,5266
5000,10022,13,0.7,3995,4,0.7,6027,9,0.7000000000000001,544,0.0,0.7,482,180,302
1691,3779,0,0.0,1477,0,0.0,2302,0,0.0,545,0.0,0.9,64,16,48
5000,3596,1987,0.13638636099288917,1455,825,0.13347049159704433,2141,1162,0.13845657807685818,546,0.8,0.1,6961,2749,4212
5000,2317,1766,0.11322108223227083,978,717,0.11541690090329046,1339,1049,0.1117202223780086,547,0.8,0.3,8115,3229,4886
5000,7620,933,0.2017621240398389,3051,363,0.2067577589294223,4569,570,0.19858069339963044,548,0.8,0.5,2878,1093,1785
5000,10220,15,0.22001521593996992,4156,0,0.0,6064,15,0.22001521593996992,549,0.8,0.7,141,30,111
1091,2581,0,0.0,1072,0,0.0,1509,0,0.0,550,0.8,0.9,71,27,44
5000,1778,2777,0.09999999999999998,730,1139,0.10000000000000007,1048,1638,0.09999999999999995,551,0.0,0.1,8282,3355,4927
5000,914,639,0.3000000000000004,360,280,0.2999999999999999,554,359,0.2999999999999998,552,0.0,0.3,9511,3858,5653
5000,2123,596,0.5,886,245,0.5,1237,351,0.5,553,0.0,0.5,8368,3344,5024
5000,10038,1,0.7,4061,0,0.0,5977,1,0.7,554,0.0,0.7,447,153,294
2046,4165,0,0.0,1707,0,0.0,2458,0,0.0,555,0.0,0.9,286,119,167
5000,2844,1930,0.1274119012528892,1103,790,0.12353287433105302,1741,1140,0.13009999885661777,556,0.8,0.1,7497,2980,4517
5000,3233,1753,0.13349159129999041,1392,666,0.13807936440159213,1841,1087,0.13068068340149291,557,0.8,0.3,7267,2756,4511
5000,3691,1746,0.15404145293231378,1493,734,0.16326158501259982,2198,1012,0.14735412393337113,558,0.8,0.5,6879,2711,4168
5000,6216,1222,0.1764249418958139,2589,437,0.18027559487008607,3627,785,0.1742813299852956,559,0.8,0.7,4095,1501,2594
5000,10361,1,0.05,4194,0,0.0,6167,1,0.05,560,0.8,0.9,103,35,68
5000,1769,2897,0.09999999999999998,712,1166,0.10000000000000006,1057,1731,0.0999999999999999,561,0.0,0.1,8669,3497,5172
5000,929,663,0.3000000000000003,395,256,0.2999999999999998,534,407,0.2999999999999999,562,0.0,0.3,9473,3821,5652
5000,1522,424,0.5,610,164,0.5,912,260,0.5,563,0.0,0.5,8920,3467,5453
5000,6889,161,0.7000000000000004,2691,65,0.7000000000000005,4198,96,0.7000000000000003,564,0.0,0.7,3538,1448,2090
2149,4664,0,0.0,1892,0,0.0,2772,0,0.0,565,0.0,0.9,103,34,69
5000,3567,1774,0.14565605783562507,1551,754,0.1519772813642452,2016,1020,0.14098331024682156,566,0.8,0.1,6713,2558,4155
5000,3449,1800,0.15256544858584853,1400,747,0.16423367907318562,2049,1053,0.14428798593243838,567,0.8,0.3,7189,2852,4337
5000,2911,1778,0.1348320421476659,1194,691,0.13430725347606462,1717,1087,0.1351656474577638,568,0.8,0.5,7563,3013,4550
5000,4809,1531,0.19852015191730193,1897,592,0.21354355728610547,2912,939,0.18904852680725756,569,0.8,0.7,5740,2320,3420
5000,7904,805,0.2286127197492368,3147,340,0.22524081101973917,4757,465,0.23107820140091223,570,0.8,0.9,2334,982,1352
5000,2147,2948,0.0999999999999999,825,1170,0.10000000000000006,1322,1778,0.0999999999999999,571,0.0,0.1,8218,3352,4866
5000,978,619,0.3000000000000003,394,241,0.29999999999999977,584,378,0.2999999999999999,572,0.0,0.3,9447,3778,5669
5000,1738,568,0.5,657,210,0.5,1081,358,0.5,573,0.0,0.5,8478,3399,5079
2686,5623,0,0.0,2308,0,0.0,3315,0,0.0,574,0.0,0.7,249,100,149
1066,2541,0,0.0,1035,0,0.0,1506,0,0.0,575,0.0,0.9,87,27,60
5000,3060,1972,0.14052586046210738,1212,764,0.1295269996291535,1848,1208,0.1474820936379158,576,0.8,0.1,7421,2990,4431
5000,2547,1926,0.12607293765775898,979,741,0.11723105114068139,1568,1185,0.13160191479628602,577,0.8,0.3,8013,3187,4826
5000,5853,1363,0.18077939414631194,2265,561,0.17776019154911601,3588,802,0.1828913301276423,578,0.8,0.5,4804,1977,2827
770,1980,0,0.0,794,0,0.0,1186,0,0.0,579,0.8,0.7,68,31,37
837,2114,0,0.0,849,0,0.0,1265,0,0.0,580,0.8,0.9,56,17,39
5000,2250,3076,0.09999999999999988,886,1255,0.10000000000000006,1364,1821,0.09999999999999984,581,0.0,0.1,8187,3321,4866
5000,908,628,0.3000000000000002,373,255,0.2999999999999998,535,373,0.2999999999999999,582,0.0,0.3,9610,3843,5767
5000,2406,632,0.5,997,250,0.5,1409,382,0.5,583,0.0,0.5,7986,3117,4869
2918,6082,0,0.0,2403,0,0.0,3679,0,0.0,584,0.0,0.7,397,169,228
1069,2488,0,0.0,1032,0,0.0,1456,0,0.0,585,0.0,0.9,69,25,44
5000,2777,1885,0.13469961622466559,1149,721,0.13393267865072245,1628,1164,0.1351746694813777,586,0.8,0.1,7670,3094,4576
5000,2540,1774,0.1352196759226253,1030,716,0.13525727385439287,1510,1058,0.13519423157560673,587,0.8,0.3,7803,3176,4627
5000,4067,1751,0.16651919918929775,1619,667,0.17129699401092663,2448,1084,0.1635793568036643,588,0.8,0.5,6496,2520,3976
5000,5665,1372,0.171054000054888,2286,531,0.18142721307915988,3379,841,0.16450444462577002,589,0.8,0.7,4830,1941,2889
5000,8751,634,0.1750634125620139,3576,287,0.16377316634615816,5175,347,0.18440145482123751,590,0.8,0.9,1611,667,944
5000,1796,2937,0.0999999999999999,741,1140,0.10000000000000007,1055,1797,0.09999999999999991,591,0.0,0.1,8656,3419,5237
5000,878,708,0.30000000000000027,333,265,0.2999999999999998,545,443,0.30000000000000016,592,0.0,0.3,9615,3893,5722
5000,1649,469,0.5,649,189,0.5,1000,280,0.5,593,0.0,0.5,8847,3527,5320
2931,6128,0,0.0,2495,0,0.0,3633,0,0.0,594,0.0,0.7,293,91,202
708,1793,0,0.0,741,0,0.0,1052,0,0.0,595,0.0,0.9,41,17,24
5000,3405,1945,0.14551798672495647,1388,757,0.14991138127383136,2017,1188,0.14271849205029444,596,0.8,0.1,7100,2875,4225
5000,2588,1733,0.12384283985196498,1032,697,0.12287788969538467,1556,1036,0.12449203894379555,597,0.8,0.3,7811,3038,4773
1629,3715,0,0.0,1506,0,0.0,2209,0,0.0,598,0.8,0.5,42,14,28
5000,7095,1140,0.2156135762282819,2825,475,0.1955726755210493,4270,665,0.22992850530487666,599,0.8,0.7,3414,1415,1999
5000,7031,1028,0.18228288685959881,2866,383,0.19429774538156078,4165,645,0.1751484824969454,600,0.8,0.9,3582,1450,2132
5000,1975,3011,0.0999999999999999,808,1184,0.10000000000000007,1167,1827,0.09999999999999987,601,0.0,0.1,8574,3379,5195
5000,1070,598,0.30000000000000027,420,215,0.2999999999999999,650,383,0.2999999999999998,602,0.0,0.3,9378,3720,5658
5000,1833,523,0.5,684,214,0.5,1149,309,0.5,603,0.0,0.5,8746,3459,5287
5000,8969,49,0.7,3591,21,0.6999999999999998,5378,28,0.6999999999999998,604,0.0,0.7,1391,579,812
1900,4223,0,0.0,1720,0,0.0,2503,0,0.0,605,0.0,0.9,155,66,89
5000,3452,1848,0.13303983936221625,1397,721,0.1322029934564139,2055,1127,0.13357521282990348,606,0.8,0.1,6959,2734,4225
5000,2917,1817,0.12011851014668339,1231,736,0.11880974023409438,1686,1081,0.12100958753397799,607,0.8,0.3,7518,2958,4560
5000,2988,1927,0.14124546551220404,1204,777,0.13952761002906913,1784,1150,0.1424061383038525,608,0.8,0.5,7478,2981,4497
5000,6544,1188,0.1864882799782403,2612,514,0.16977652165704415,3932,674,0.19923285531517618,609,0.8,0.7,3841,1564,2277
504,1459,0,0.0,594,0,0.0,865,0,0.0,610,0.8,0.9,42,10,32
5000,2466,3127,0.09999999999999991,972,1298,0.09999999999999999,1494,1829,0.09999999999999992,611,0.0,0.1,7937,3186,4751
5000,940,623,0.3000000000000004,371,255,0.2999999999999998,569,368,0.29999999999999977,612,0.0,0.3,9380,3767,5613
5000,1578,429,0.5,638,137,0.5,940,292,0.5,613,0.0,0.5,8870,3510,5360
5000,9189,59,0.7000000000000003,3657,28,0.6999999999999998,5532,31,0.6999999999999997,614,0.0,0.7,1367,551,816
611,1689,0,0.0,683,0,0.0,1006,0,0.0,615,0.0,0.9,27,5,22
5000,3339,1921,0.15543067365717586,1326,747,0.16336927132110943,2013,1174,0.1503794535081482,616,0.8,0.1,7044,2781,4263
5000,2354,1775,0.12206189127375429,977,680,0.12091920087274444,1377,1095,0.12277150723054578,617,0.8,0.3,8054,3170,4884
5000,5767,1345,0.17888408866747416,2280,513,0.17474256259980983,3487,832,0.1814376978894837,618,0.8,0.5,4668,1846,2822
5000,10094,121,0.22274716321102211,4166,51,0.2854908925807001,5928,70,0.17703387467025675,619,0.8,0.7,383,134,249
5000,6787,1163,0.20050311674929838,2793,456,0.21579598416374288,3994,707,0.1906395417266864,620,0.8,0.9,3578,1390,2188
5000,1893,2782,0.09999999999999998,788,1085,0.10000000000000007,1105,1697,0.09999999999999985,621,0.0,0.1,8711,3454,5257
5000,910,624,0.3000000000000004,357,254,0.2999999999999998,553,370,0.29999999999999993,622,0.0,0.3,9515,3770,5745
5000,1645,632,0.5,634,251,0.5,1011,381,0.5,623,0.0,0.5,8775,3514,5261
1645,3810,0,0.0,1546,0,0.0,2264,0,0.0,624,0.0,0.7,87,26,61
1947,4247,0,0.0,1717,0,0.0,2530,0,0.0,625,0.0,0.9,146,51,95
5000,2687,1995,0.11950646412995823,1027,859,0.11505590393617247,1660,1136,0.12287180850184373,626,0.8,0.1,7862,3245,4617
5000,7442,1030,0.20430636720232417,2945,407,0.2017365227713058,4497,623,0.20598522223189797,627,0.8,0.3,3086,1221,1865
5000,8894,548,0.20179545404921323,3691,203,0.21340487966327246,5203,345,0.19496440071688279,628,0.8,0.5,1608,633,975
5000,4638,1677,0.183140494152991,1788,684,0.17258295191994397,2850,993,0.19041275889357934,629,0.8,0.7,5857,2396,3461
1245,2850,0,0.0,1095,0,0.0,1755,0,0.0,630,0.8,0.9,71,32,39
5000,1644,2844,0.09999999999999998,638,1163,0.10000000000000006,1006,1681,0.09999999999999991,631,0.0,0.1,8788,3567,5221
5000,896,670,0.30000000000000043,373,261,0.2999999999999999,523,409,0.2999999999999999,632,0.0,0.3,9529,3829,5700
5000,2011,612,0.5,838,251,0.5,1173,361,0.5,633,0.0,0.5,8560,3408,5152
5000,9119,16,0.6999999999999998,3705,5,0.7,5414,11,0.7000000000000001,634,0.0,0.7,1353,530,823
1309,2899,0,0.0,1146,0,0.0,1753,0,0.0,635,0.0,0.9,93,47,46
5000,2436,1935,0.11440773567383977,975,771,0.11031149449400707,1461,1164,0.11712096758934751,636,0.8,0.1,8056,3226,4830
5000,2513,1833,0.12921751068795398,1034,757,0.1300468040571729,1479,1076,0.1286340765982711,637,0.8,0.3,7790,3178,4612
5000,3673,1504,0.14685822580324467,1563,623,0.13938222127696254,2110,881,0.1521448896169494,638,0.8,0.5,6717,2681,4036
5000,3341,1626,0.1529460517127652,1386,672,0.14816129406170098,1955,954,0.15631644703930103,639,0.8,0.7,6900,2709,4191
5000,4027,1598,0.15168057421140482,1681,609,0.1564849428239793,2346,989,0.14872217129425844,640,0.8,0.9,6502,2554,3948
5000,1898,2783,0.09999999999999998,741,1107,0.10000000000000006,1157,1676,0.09999999999999992,641,0.0,0.1,8476,3384,5092
5000,999,681,0.3000000000000003,414,299,0.2999999999999998,585,382,0.2999999999999998,642,0.0,0.3,9499,3781,5718
5000,1417,459,0.5,542,205,0.5,875,254,0.5,643,0.0,0.5,9035,3662,5373
1967,4189,0,0.0,1729,0,0.0,2460,0,0.0,644,0.0,0.7,189,60,129
2668,5489,0,0.0,2142,0,0.0,3347,0,0.0,645,0.0,0.9,336,155,181
5000,3136,1860,0.13244884892656142,1261,735,0.133908760603422,1875,1125,0.1314950399643458,646,0.8,0.1,7585,3086,4499
5000,4049,1612,0.14865708488122564,1719,611,0.1476840005165702,2330,1001,0.14925104546744397,647,0.8,0.3,6314,2440,3874
5000,2895,1751,0.141252451052153,1116,711,0.13975788992670274,1779,1040,0.14227421351387912,648,0.8,0.5,7555,3051,4504
5000,6604,1100,0.19684973166964856,2738,426,0.20044855483181434,3866,674,0.1945751045671521,649,0.8,0.7,3828,1508,2320
5000,6886,1092,0.1974520177979318,2705,462,0.19355071132217067,4181,630,0.20031297588015662,650,0.8,0.9,3646,1436,2210
5000,3092,3099,0.09999999999999995,1246,1209,0.10000000000000007,1846,1890,0.09999999999999984,651,0.0,0.1,7254,2863,4391
5000,985,633,0.30000000000000027,424,240,0.29999999999999977,561,393,0.2999999999999998,652,0.0,0.3,9358,3707,5651
5000,6748,627,0.5,2726,223,0.5,4022,404,0.5,653,0.0,0.5,3693,1466,2227
2785,5743,0,0.0,2400,0,0.0,3343,0,0.0,654,0.0,0.7,233,86,147
1710,3650,0,0.0,1438,0,0.0,2212,0,0.0,655,0.0,0.9,192,96,96
5000,3684,1868,0.14368535431851834,1440,726,0.13441772162698326,2244,1142,0.14957703674763773,656,0.8,0.1,6739,2698,4041
5000,3560,1948,0.12718985509799172,1463,776,0.13694301533557343,2097,1172,0.12073213125467823,657,0.8,0.3,6973,2779,4194
5000,6031,1155,0.2019044484953831,2522,459,0.19668304947837176,3509,696,0.20534787112298122,658,0.8,0.5,4342,1725,2617
5000,5654,1377,0.1768861390926525,2337,585,0.18836318237484884,3317,792,0.1684087775773938,659,0.8,0.7,4793,1899,2894
5000,5209,1408,0.18963448494538146,2089,604,0.1830367325375344,3120,804,0.1945910054109777,660,0.8,0.9,5246,2065,3181
5000,2126,2815,0.09999999999999992,875,1112,0.10000000000000006,1251,1703,0.09999999999999994,661,0.0,0.1,8251,3278,4973
5000,1043,694,0.30000000000000027,442,268,0.2999999999999998,601,426,0.2999999999999998,662,0.0,0.3,9513,3751,5762
5000,2227,681,0.5,870,255,0.5,1357,426,0.5,663,0.0,0.5,8276,3249,5027
4027,8018,0,0.0,3281,0,0.0,4737,0,0.0,664,0.0,0.7,519,175,344
395,1264,0,0.0,511,0,0.0,753,0,0.0,665,0.0,0.9,29,4,25
5000,2567,2026,0.12529400031741356,1014,822,0.12308970225239235,1553,1204,0.12679892806612406,666,0.8,0.1,8036,3233,4803
5000,3374,1709,0.1541954854308725,1276,626,0.15122010393758967,2098,1083,0.15591532736512453,667,0.8,0.3,7087,2818,4269
5000,4134,1773,0.14988374306218538,1718,708,0.14529384576635893,2416,1065,0.15293505506729813,668,0.8,0.5,6366,2500,3866
5000,5434,1493,0.17916991212214411,2197,575,0.17665800353403735,3237,918,0.18074327534454201,669,0.8,0.7,4919,1908,3011
5000,10185,55,0.1496766603402541,4032,14,0.15473338757547878,6153,41,0.14794997299164078,670,0.8,0.9,371,122,249
5000,1901,2816,0.09999999999999991,743,1131,0.10000000000000007,1158,1685,0.0999999999999999,671,0.0,0.1,8745,3539,5206
5000,966,695,0.30000000000000027,389,262,0.2999999999999999,577,433,0.3,672,0.0,0.3,9383,3696,5687
5000,1639,664,0.5,673,267,0.5,966,397,0.5,673,0.0,0.5,8969,3591,5378
5000,8819,58,0.7000000000000003,3546,26,0.6999999999999998,5273,32,0.6999999999999997,674,0.0,0.7,1555,657,898
756,1990,0,0.0,786,0,0.0,1204,0,0.0,675,0.0,0.9,23,8,15
5000,5018,1550,0.15704189760818102,2048,633,0.162301381957743,2970,917,0.15341130481289994,676,0.8,0.1,5471,2161,3310
5000,2381,1837,0.12368582440273908,919,719,0.1203261100376386,1462,1118,0.12584649938351478,677,0.8,0.3,8124,3253,4871
5000,5070,1543,0.16885317552399076,1921,651,0.16992302227592568,3149,892,0.16807237929584098,678,0.8,0.5,5357,2257,3100
5000,6625,874,0.23378627932645007,2638,369,0.23472201005384385,3987,505,0.23310254736920574,679,0.8,0.7,3712,1488,2224
1821,3999,0,0.0,1612,0,0.0,2387,0,0.0,680,0.8,0.9,60,15,45
5000,2020,2870,0.09999999999999992,807,1100,0.10000000000000005,1213,1770,0.09999999999999992,681,0.0,0.1,8554,3313,5241
5000,872,764,0.3000000000000004,348,337,0.29999999999999977,524,427,0.2999999999999999,682,0.0,0.3,9415,3788,5627
5000,1619,404,0.5,646,146,0.5,973,258,0.5,683,0.0,0.5,8987,3573,5414
5000,8504,73,0.7000000000000003,3411,21,0.6999999999999998,5093,52,0.7,684,0.0,0.7,1833,693,1140
1114,2567,0,0.0,981,0,0.0,1586,0,0.0,685,0.0,0.9,101,46,55
5000,3692,1958,0.126678401766597,1531,812,0.11898820317004662,2161,1146,0.13212730338998172,686,0.8,0.1,6689,2671,4018
5000,3060,1666,0.13880622231003276,1255,686,0.1376371098237922,1805,980,0.1396246010504012,687,0.8,0.3,7466,2971,4495
5000,3450,1765,0.15738124443308824,1467,682,0.15568397350989097,1983,1083,0.15845007062849037,688,0.8,0.5,7109,2771,4338
1404,3281,0,0.0,1333,0,0.0,1948,0,0.0,689,0.8,0.7,43,2,41
5000,10308,2,0.04308436711542217,4129,0,0.0,6179,2,0.04308436711542217,690,0.8,0.9,115,36,79
5000,1682,2721,0.09999999999999996,673,1071,0.10000000000000007,1009,1650,0.09999999999999991,691,0.0,0.1,8768,3537,5231
5000,930,665,0.3000000000000003,387,270,0.29999999999999977,543,395,0.2999999999999998,692,0.0,0.3,9547,3731,5816
5000,1878,493,0.5,719,200,0.5,1159,293,0.5,693,0.0,0.5,8629,3469,5160
5000,8596,35,0.6999999999999998,3386,17,0.6999999999999998,5210,18,0.7,694,0.0,0.7,1970,808,1162
1350,2944,0,0.0,1124,0,0.0,1820,0,0.0,695,0.0,0.9,217,105,112
5000,3347,1912,0.143480451359187,1283,785,0.1427488562379221,2064,1127,0.14399003624844417,696,0.8,0.1,7221,2891,4330
5000,2230,1877,0.13120940503035294,819,761,0.13412410288547438,1411,1116,0.12922187360764023,697,0.8,0.3,8320,3369,4951
5000,4156,1547,0.1676447179500736,1736,583,0.16406853966303642,2420,964,0.16980748967345816,698,0.8,0.5,6270,2496,3774
5000,10289,41,0.09865121501516479,4123,18,0.10021751660955908,6166,23,0.097425413767378,699,0.8,0.7,270,64,206
5000,9952,79,0.13136754384393812,3905,20,0.13214782730623648,6047,59,0.1311030409753624,700,0.8,0.9,461,187,274
5000,1891,2999,0.09999999999999992,738,1164,0.10000000000000005,1153,1835,0.09999999999999991,701,0.0,0.1,8697,3476,5221
5000,1021,659,0.30000000000000027,407,258,0.29999999999999993,614,401,0.29999999999999977,702,0.0,0.3,9371,3779,5592
5000,1756,353,0.5,728,137,0.5,1028,216,0.5,703,0.0,0.5,8712,3458,5254
2017,4129,0,0.0,1666,0,0.0,2463,0,0.0,704,0.0,0.7,380,164,216
1315,3001,0,0.0,1210,0,0.0,1791,0,0.0,705,0.0,0.9,125,62,63
5000,2502,1751,0.12512377801735708,989,685,0.11983691537322883,1513,1066,0.128521058421886,706,0.8,0.1,8127,3287,4840
5000,3140,1476,0.14801769169572865,1338,565,0.14831711613572224,1802,911,0.14783198938113334,707,0.8,0.3,7419,2912,4507
5000,4708,1645,0.16554906349040885,1975,626,0.17245453225015572,2733,1019,0.1613068422503681,708,0.8,0.5,5801,2264,3537
5000,5149,1399,0.1786471643825407,2155,551,0.18148745626218105,2994,848,0.1768016445409348,709,0.8,0.7,5264,2097,3167
1156,2782,0,0.0,1115,0,0.0,1667,0,0.0,710,0.8,0.9,44,5,39
5000,2110,3014,0.09999999999999994,837,1220,0.10000000000000005,1273,1794,0.09999999999999984,711,0.0,0.1,8598,3480,5118
5000,1065,672,0.30000000000000043,492,275,0.29999999999999993,573,397,0.2999999999999998,712,0.0,0.3,9408,3818,5590
5000,1489,427,0.5,592,180,0.5,897,247,0.5,713,0.0,0.5,9046,3755,5291
5000,8626,61,0.7000000000000004,3410,28,0.6999999999999998,5216,33,0.6999999999999997,714,0.0,0.7,1735,717,1018
1160,2782,0,0.0,1136,0,0.0,1646,0,0.0,715,0.0,0.9,81,19,62
5000,2779,1890,0.1178249040256058,1113,762,0.11536630015733125,1666,1128,0.11948576940470616,716,0.8,0.1,7537,3003,4534
5000,2370,1824,0.13293759105019892,928,754,0.12685152845449493,1442,1070,0.1372262744120315,717,0.8,0.3,8117,3303,4814
5000,7493,916,0.19256492197604705,3001,372,0.19811173043647745,4492,544,0.18877188383766433,718,0.8,0.5,3021,1163,1858
5000,3128,1689,0.14551789950704286,1321,705,0.15609764639703053,1807,984,0.13793789792427727,719,0.8,0.7,7252,2859,4393
5000,5011,1502,0.1454361901057682,2158,571,0.14088340187247553,2853,931,0.14822850168601537,720,0.8,0.9,5419,2052,3367
5000,2117,2756,0.09999999999999991,863,1092,0.10000000000000005,1254,1664,0.09999999999999987,721,0.0,0.1,8171,3261,4910
5000,876,715,0.3000000000000004,310,310,0.29999999999999993,566,405,0.2999999999999999,722,0.0,0.3,9701,3876,5825
5000,2409,769,0.5,986,324,0.5,1423,445,0.5,723,0.0,0.5,8096,3276,4820
5000,7016,97,0.7000000000000004,2832,42,0.6999999999999998,4184,55,0.7000000000000002,724,0.0,0.7,3466,1404,2062
686,1793,0,0.0,732,0,0.0,1061,0,0.0,725,0.0,0.9,26,10,16
5000,4595,1755,0.14387810585665803,1878,713,0.14441755181586693,2717,1042,0.14350898400549106,726,0.8,0.1,5748,2254,3494
5000,3360,1768,0.14410379771407952,1386,692,0.14051600305023487,1974,1076,0.14641118982131046,727,0.8,0.3,7102,2841,4261
5000,4078,1603,0.13242098416739595,1704,647,0.13761403032751882,2374,956,0.12890644351300323,728,0.8,0.5,6235,2464,3771
5000,5761,1388,0.17140303026655843,2287,561,0.1684526096108671,3474,827,0.17340446435101173,729,0.8,0.7,4863,1924,2939
5000,10058,111,0.19760645636088203,4023,40,0.25533894892795084,6035,71,0.16508110843577295,730,0.8,0.9,415,136,279
5000,1731,2792,0.09999999999999995,679,1140,0.10000000000000007,1052,1652,0.09999999999999991,731,0.0,0.1,8774,3529,5245
5000,907,696,0.3000000000000003,371,269,0.2999999999999998,536,427,0.2999999999999999,732,0.0,0.3,9524,3731,5793
5000,1684,691,0.5,670,271,0.5,1014,420,0.5,733,0.0,0.5,8864,3571,5293
2264,4886,0,0.0,1962,0,0.0,2924,0,0.0,734,0.0,0.7,135,49,86
3202,6670,0,0.0,2674,0,0.0,3996,0,0.0,735,0.0,0.9,248,103,145
5000,3657,2026,0.151472762315138,1425,776,0.14735834913493723,2232,1250,0.15402699001740655,736,0.8,0.1,6736,2774,3962
5000,2653,1757,0.12941547689620034,1007,680,0.12736065002573815,1646,1077,0.13071286062128323,737,0.8,0.3,7891,3148,4743
5000,3301,1963,0.14222440558924263,1285,831,0.1480744449998934,2016,1132,0.1379298978593391,738,0.8,0.5,7004,2901,4103
5000,5678,1342,0.16044774745252358,2383,530,0.15285956680850288,3295,812,0.16540062398125643,739,0.8,0.7,4707,1875,2832
1119,2689,0,0.0,1085,0,0.0,1604,0,0.0,740,0.8,0.9,33,9,24
5000,1958,3051,0.09999999999999994,716,1202,0.10000000000000007,1242,1849,0.09999999999999987,741,0.0,0.1,8595,3484,5111
5000,920,686,0.3000000000000004,393,262,0.2999999999999999,527,424,0.2999999999999998,742,0.0,0.3,9725,3860,5865
5000,2079,708,0.5,813,275,0.5,1266,433,0.5,743,0.0,0.5,8275,3340,4935
2465,5206,0,0.0,2063,0,0.0,3143,0,0.0,744,0.0,0.7,193,51,142
1416,3201,0,0.0,1298,0,0.0,1903,0,0.0,745,0.0,0.9,105,26,79
5000,3219,1847,0.14970539853662204,1363,743,0.15853944510329215,1856,1104,0.14376002118242276,746,0.8,0.1,7065,2823,4242
5000,2643,1888,0.1234352881176624,1083,757,0.12405735409469636,1560,1131,0.12301892742392709,747,0.8,0.3,7981,3142,4839
5000,4485,1829,0.17203966900925596,1777,772,0.17140985062194866,2708,1057,0.17249966881531195,748,0.8,0.5,5986,2477,3509
5000,3913,1630,0.17433283045849476,1496,632,0.18649112579434618,2417,998,0.16663338892316595,749,0.8,0.7,6417,2548,3869
5000,9244,298,0.18498785340382778,3766,105,0.1789299231847501,5478,193,0.18828361854892184,750,0.8,0.9,1358,481,877
5000,1703,2770,0.1,706,1083,0.10000000000000009,997,1687,0.0999999999999999,751,0.0,0.1,8792,3533,5259
5000,873,690,0.3000000000000002,364,284,0.2999999999999999,509,406,0.2999999999999999,752,0.0,0.3,9654,3832,5822
5000,2035,567,0.5,794,229,0.5,1241,338,0.5,753,0.0,0.5,8508,3535,4973
5000,10158,6,0.7000000000000001,4090,0,0.0,6068,6,0.7000000000000001,754,0.0,0.7,512,204,308
1382,3055,0,0.0,1216,0,0.0,1839,0,0.0,755,0.0,0.9,160,67,93
5000,2982,1948,0.1344123487199132,1145,813,0.13633471606525552,1837,1135,0.13303535783730222,756,0.8,0.1,7573,3063,4510
5000,3344,1707,0.16268922786767656,1277,667,0.15260480353393205,2067,1040,0.16915683462787617,757,0.8,0.3,7170,2906,4264
5000,2734,1614,0.13403248988638314,1051,611,0.1386058870394501,1683,1003,0.13124650218895154,758,0.8,0.5,7844,3171,4673
5000,3296,1640,0.1562757004124696,1309,634,0.1552396226904178,1987,1006,0.15692865595499536,759,0.8,0.7,7142,2876,4266
5000,6511,1151,0.18845840482627382,2681,441,0.1860205050766582,3830,710,0.18997264960033092,760,0.8,0.9,3936,1551,2385
5000,2735,3103,0.09999999999999995,1136,1274,0.10000000000000009,1599,1829,0.09999999999999992,761,0.0,0.1,7852,3091,4761
5000,763,654,0.3000000000000004,310,272,0.29999999999999977,453,382,0.2999999999999998,762,0.0,0.3,9642,3931,5711
5000,1595,441,0.5,629,154,0.5,966,287,0.5,763,0.0,0.5,8739,3488,5251
5000,9438,86,0.7000000000000001,3771,39,0.6999999999999998,5667,47,0.6999999999999998,764,0.0,0.7,1209,501,708
1045,2477,0,0.0,1001,0,0.0,1476,0,0.0,765,0.0,0.9,62,13,49
5000,2996,1963,0.14085882668776842,1127,760,0.1513960436944862,1869,1203,0.13420189823797157,766,0.8,0.1,7478,3054,4424
5000,2212,1728,0.11543630938553846,850,725,0.11962699069086365,1362,1003,0.11240715290860849,767,0.8,0.3,8122,3278,4844
5000,3938,1517,0.1499046100543864,1599,609,0.14844355804499498,2339,908,0.15088454471707302,768,0.8,0.5,6361,2449,3912
5000,3875,1623,0.14579631853755157,1546,655,0.14302761029941682,2329,968,0.14766977297554565,769,0.8,0.7,6548,2584,3964
5000,3688,1665,0.1498443341142494,1533,630,0.1452387218948039,2155,1035,0.1526477502478249,770,0.8,0.9,6730,2664,4066
5000,2185,3062,0.09999999999999991,879,1191,0.10000000000000006,1306,1871,0.0999999999999999,771,0.0,0.1,8201,3262,4939
5000,907,779,0.3000000000000004,357,324,0.2999999999999999,550,455,0.30000000000000004,772,0.0,0.3,9696,3904,5792
5000,3147,885,0.5,1272,352,0.5,1875,533,0.5,773,0.0,0.5,7645,3060,4585
5000,9583,20,0.7,3851,8,0.7000000000000001,5732,12,0.7000000000000001,774,0.0,0.7,914,393,521
1024,2389,0,0.0,982,0,0.0,1407,0,0.0,775,0.0,0.9,107,36,71
5000,5180,1510,0.15806273867421844,2198,615,0.15679655548038066,2982,895,0.1589327975169116,776,0.8,0.1,5211,1955,3256
5000,3029,1972,0.13237478987277781,1197,764,0.1332212730117048,1832,1208,0.13183943133127096,777,0.8,0.3,7497,3038,4459
5000,6761,1178,0.20045217751583821,2678,513,0.19301130082811238,4083,665,0.20619228238922674,778,0.8,0.5,3739,1548,2191
5000,5182,1321,0.1774681414624347,2180,531,0.1764287393404655,3002,790,0.17816677757226465,779,0.8,0.7,5130,1979,3151
5000,10140,22,0.1265514178798569,4043,8,0.10200016307679044,6097,14,0.14058070633875203,780,0.8,0.9,199,62,137
5000,2400,3086,0.09999999999999996,1016,1272,0.10000000000000007,1384,1814,0.09999999999999987,781,0.0,0.1,7970,3222,4748
5000,986,668,0.3000000000000004,437,258,0.29999999999999993,549,410,0.2999999999999999,782,0.0,0.3,9566,3824,5742
5000,1819,618,0.5,712,235,0.5,1107,383,0.5,783,0.0,0.5,8607,3425,5182
2846,5771,0,0.0,2299,0,0.0,3472,0,0.0,784,0.0,0.7,362,128,234
1684,3625,0,0.0,1453,0,0.0,2172,0,0.0,785,0.0,0.9,180,75,105
5000,3567,1931,0.1375452394543924,1448,791,0.13046420564882177,2119,1140,0.14245848308615228,786,0.8,0.1,6804,2743,4061
5000,2845,1704,0.1271390692140264,1160,638,0.12828243019209237,1685,1066,0.12645476874122522,787,0.8,0.3,7634,3044,4590
5000,7711,933,0.21090839562209898,3137,375,0.19720632675045105,4574,558,0.2201167752401418,788,0.8,0.5,2593,996,1597
5000,3755,1875,0.1607018505819063,1449,728,0.16937018152737768,2306,1147,0.1552000677324702,789,0.8,0.7,6917,2787,4130
5000,6626,1161,0.18620956037675687,2650,448,0.18391111828933251,3976,713,0.18765374278231942,790,0.8,0.9,3798,1494,2304
5000,1919,3021,0.09999999999999996,758,1218,0.10000000000000009,1161,1803,0.0999999999999999,791,0.0,0.1,8536,3414,5122
5000,932,680,0.30000000000000027,386,277,0.29999999999999993,546,403,0.29999999999999993,792,0.0,0.3,9661,3861,5800
5000,1592,593,0.5,664,257,0.5,928,336,0.5,793,0.0,0.5,8835,3562,5273
1404,3077,0,0.0,1267,0,0.0,1810,0,0.0,794,0.0,0.7,100,29,71
505,1484,0,0.0,589,0,0.0,895,0,0.0,795,0.0,0.9,31,9,22
5000,2366,1907,0.11212728403545699,955,775,0.11001769937948126,1411,1132,0.1135715668167125,796,0.8,0.1,8048,3227,4821
5000,3687,1844,0.15894207349860184,1452,715,0.15503099161308553,2235,1129,0.1614189765527595,797,0.8,0.3,6884,2782,4102
5000,4358,1633,0.15294174476566905,1766,636,0.1506783014897213,2592,997,0.15438562633387654,798,0.8,0.5,6105,2424,3681
5000,2990,1843,0.14157183260620954,1212,771,0.14292912393930868,1778,1072,0.14059564639555705,799,0.8,0.7,7345,3017,4328
5000,9038,485,0.20014863436373248,3722,168,0.18672175046792133,5316,317,0.2072644592675062,800,0.8,0.9,1487,532,955
5000,2070,3090,0.09999999999999996,788,1267,0.10000000000000007,1282,1823,0.09999999999999984,801,0.0,0.1,8467,3407,5060
5000,941,677,0.30000000000000027,370,249,0.2999999999999999,571,428,0.2999999999999999,802,0.0,0.3,9602,3862,5740
5000,1651,452,0.5,684,167,0.5,967,285,0.5,803,0.0,0.5,8820,3460,5360
2737,5464,0,0.0,2233,0,0.0,3231,0,0.0,804,0.0,0.7,393,140,253
1351,3000,0,0.0,1211,0,0.0,1789,0,0.0,805,0.0,0.9,184,70,114
5000,3506,1900,0.1402657780404728,1490,793,0.13977085585929958,2016,1107,0.14062031579085252,806,0.8,0.1,6846,2705,4141
5000,3502,1932,0.1384091627752924,1399,763,0.14319215636232055,2103,1169,0.13528732863765114,807,0.8,0.3,7025,2795,4230
5000,4271,1635,0.15240148955454322,1694,650,0.15480536875318243,2577,985,0.15081517333209096,808,0.8,0.5,6224,2471,3753
5000,2449,1682,0.11313237956870262,950,676,0.10864031054554964,1499,1006,0.11615090706338592,809,0.8,0.7,7890,3158,4732
5000,6977,1156,0.17830003690291893,2825,472,0.18405996756570245,4152,684,0.1743253479075479,810,0.8,0.9,3654,1455,2199
5000,2253,3113,0.09999999999999991,876,1282,0.10000000000000007,1377,1831,0.09999999999999992,811,0.0,0.1,8196,3370,4826
5000,969,740,0.30000000000000027,376,295,0.2999999999999999,593,445,0.3000000000000002,812,0.0,0.3,9538,3836,5702
5000,2622,638,0.5,1069,270,0.5,1553,368,0.5,813,0.0,0.5,7868,3170,4698
5000,9316,41,0.6999999999999998,3665,12,0.7000000000000001,5651,29,0.6999999999999997,814,0.0,0.7,1145,503,642
959,2334,0,0.0,945,0,0.0,1389,0,0.0,815,0.0,0.9,62,26,36
5000,3123,1891,0.12878094261243417,1306,721,0.12429047419187833,1817,1170,0.13154814580151172,816,0.8,0.1,7523,2979,4544
5000,2222,1788,0.13171147707647873,869,687,0.1399872034704006,1353,1101,0.12654760420397707,817,0.8,0.3,8250,3228,5022
5000,6082,1277,0.19282881599920132,2376,503,0.203536442363235,3706,774,0.1858702422768384,818,0.8,0.5,4397,1725,2672
5000,6162,1440,0.19317740198852162,2444,545,0.19132070816273222,3718,895,0.19430801442992401,819,0.8,0.7,4467,1783,2684
533,1479,0,0.0,576,0,0.0,903,0,0.0,820,0.8,0.9,35,14,21
5000,2351,3170,0.09999999999999992,936,1256,0.10000000000000006,1415,1914,0.09999999999999985,821,0.0,0.1,8057,3212,4845
5000,2033,1726,0.3000000000000005,752,684,0.3000000000000004,1281,1042,0.3000000000000002,822,0.0,0.3,8320,3383,4937
5000,2222,761,0.5,871,309,0.5,1351,452,0.5,823,0.0,0.5,8379,3350,5029
2116,4500,0,0.0,1819,0,0.0,2681,0,0.0,824,0.0,0.7,174,52,122
1225,2858,0,0.0,1157,0,0.0,1701,0,0.0,825,0.0,0.9,65,25,40
5000,3578,1773,0.13824856487065634,1489,696,0.13436824866848868,2089,1077,0.14075617868375637,826,0.8,0.1,7016,2803,4213
5000,2363,1826,0.10709932571570759,947,742,0.10899421259718194,1416,1084,0.10580227214923714,827,0.8,0.3,8054,3239,4815
5000,5587,1459,0.18487109795670917,2162,640,0.1854723815516579,3425,819,0.18440123043440484,828,0.8,0.5,4977,2080,2897
5000,5436,1555,0.2039186866107388,2040,645,0.21791116360874901,3396,910,0.19400094192533593,829,0.8,0.7,4961,2064,2897
5000,9029,283,0.2195813286509852,3729,88,0.23157485757165908,5300,195,0.214168864317553,830,0.8,0.9,1330,412,918
5000,3581,3015,0.09999999999999996,1397,1223,0.10000000000000006,2184,1792,0.09999999999999985,831,0.0,0.1,6918,2725,4193
5000,932,653,0.3000000000000004,365,242,0.3,567,411,0.2999999999999999,832,0.0,0.3,9563,3876,5687
5000,1504,489,0.5,619,202,0.5,885,287,0.5,833,0.0,0.5,8921,3621,5300
4630,9148,0,0.0,3597,0,0.0,5551,0,0.0,834,0.0,0.7,607,264,343
1565,3592,0,0.0,1454,0,0.0,2138,0,0.0,835,0.0,0.9,46,7,39
5000,8520,581,0.15760915771714173,3429,234,0.15023513603841196,5091,347,0.16258184092412373,836,0.8,0.1,1844,645,1199
5000,7926,755,0.24175539841582838,3231,299,0.2543168914088497,4695,456,0.2335188054225973,837,0.8,0.3,2627,1045,1582
5000,2945,2006,0.14049344331390634,1145,797,0.13754253910101494,1800,1209,0.14243874576028712,838,0.8,0.5,7579,3031,4548
5000,3953,1691,0.18139127278445386,1582,700,0.18758764068031655,2371,991,0.17701442361482325,839,0.8,0.7,6561,2619,3942
1538,3461,0,0.0,1423,0,0.0,2038,0,0.0,840,0.8,0.9,56,19,37
5000,1825,2843,0.09999999999999998,754,1103,0.10000000000000006,1071,1740,0.09999999999999992,841,0.0,0.1,8741,3410,5331
5000,863,665,0.3000000000000003,320,250,0.2999999999999999,543,415,0.2999999999999998,842,0.0,0.3,9645,3902,5743
5000,1234,494,0.5,493,190,0.5,741,304,0.5,843,0.0,0.5,9238,3739,5499
5000,7454,212,0.6999999999999998,2892,84,0.7000000000000001,4562,128,0.7000000000000004,844,0.0,0.7,2943,1303,1640
1430,3285,0,0.0,1265,0,0.0,2020,0,0.0,845,0.0,0.9,84,32,52
5000,3690,2016,0.15678843801849587,1528,845,0.16302273385280713,2162,1171,0.15228973607144788,846,0.8,0.1,6954,2855,4099
5000,2977,1769,0.13093232316998998,1233,671,0.12708101044397874,1744,1098,0.13328590316921904,847,0.8,0.3,7434,2958,4476
5000,3833,1731,0.14141681026840766,1537,690,0.13930470954910218,2296,1041,0.1428167617538263,848,0.8,0.5,6554,2592,3962
5000,4009,1708,0.1521054271178164,1666,634,0.14698959994485566,2343,1074,0.15512538468546738,849,0.8,0.7,6445,2524,3921
1553,3415,0,0.0,1327,0,0.0,2088,0,0.0,850,0.8,0.9,112,59,53
5000,2501,2978,0.09999999999999995,1037,1215,0.10000000000000009,1464,1763,0.0999999999999999,851,0.0,0.1,7950,3119,4831
5000,911,655,0.3000000000000004,400,270,0.29999999999999977,511,385,0.2999999999999998,852,0.0,0.3,9498,3714,5784
5000,1303,436,0.5,485,168,0.5,818,268,0.5,853,0.0,0.5,9229,3708,5521
4361,8425,0,0.0,3346,0,0.0,5079,0,0.0,854,0.0,0.7,739,280,459
1072,2585,0,0.0,1077,0,0.0,1508,0,0.0,855,0.0,0.9,60,17,43
5000,3502,2006,0.13185623390293544,1401,799,0.1363689586883455,2101,1207,0.12886893721400194,856,0.8,0.1,6995,2750,4245
5000,2478,1717,0.1267748367211983,964,708,0.12608356264272907,1514,1009,0.12725989325990614,857,0.8,0.3,8213,3286,4927
5000,4141,1741,0.15514323918464978,1634,693,0.15422708918057512,2507,1048,0.15574905211673343,858,0.8,0.5,6212,2528,3684
5000,5619,1393,0.1654898156480973,2243,533,0.16289302647651335,3376,860,0.16709922103002087,859,0.8,0.7,4821,1891,2930
5000,9658,265,0.22080635308497037,3935,70,0.2686925460730024,5723,195,0.20361643765336915,860,0.8,0.9,900,286,614
5000,2723,3069,0.09999999999999988,1043,1220,0.10000000000000005,1680,1849,0.09999999999999987,861,0.0,0.1,7801,3115,4686
5000,901,635,0.3000000000000003,360,252,0.2999999999999999,541,383,0.2999999999999998,862,0.0,0.3,9553,3796,5757
5000,1311,449,0.5,558,188,0.5,753,261,0.5,863,0.0,0.5,9106,3657,5449
806,1987,0,0.0,787,0,0.0,1200,0,0.0,864,0.0,0.7,29,6,23
1102,2589,0,0.0,1043,0,0.0,1546,0,0.0,865,0.0,0.9,41,15,26
5000,3193,1982,0.1360230020870954,1288,766,0.14029622649187476,1905,1216,0.13333115184526875,866,0.8,0.1,7396,2873,4523
5000,2864,1957,0.11651398763998846,1124,823,0.11809475425003016,1740,1134,0.11536674696973774,867,0.8,0.3,7687,3169,4518
5000,2888,1763,0.14646170688914728,1152,734,0.15079822078497096,1736,1029,0.14336841126277736,868,0.8,0.5,7518,3078,4440
1442,3334,0,0.0,1301,0,0.0,2033,0,0.0,869,0.8,0.7,26,6,20
743,1839,0,0.0,740,0,0.0,1099,0,0.0,870,0.8,0.9,73,35,38
5000,2355,2949,0.09999999999999991,971,1209,0.10000000000000007,1384,1740,0.09999999999999992,871,0.0,0.1,8115,3287,4828
5000,912,658,0.3000000000000002,381,257,0.2999999999999998,531,401,0.29999999999999977,872,0.0,0.3,9573,3836,5737
5000,1868,428,0.5,747,171,0.5,1121,257,0.5,873,0.0,0.5,8632,3463,5169
4446,8729,0,0.0,3509,0,0.0,5220,0,0.0,874,0.0,0.7,677,263,414
942,2295,0,0.0,919,0,0.0,1376,0,0.0,875,0.0,0.9,71,25,46
5000,3069,1690,0.14716590299728013,1222,672,0.14147119610136308,1847,1018,0.15092508083034142,876,0.8,0.1,7404,2920,4484
5000,4591,1690,0.15005123699487025,1866,699,0.1622790066233593,2725,991,0.14142640251423064,877,0.8,0.3,5914,2346,3568
5000,3533,1524,0.1596124079210225,1472,582,0.15925472364115784,2061,942,0.15983339757163956,878,0.8,0.5,6771,2666,4105
690,1858,0,0.0,697,0,0.0,1161,0,0.0,879,0.8,0.7,26,11,15
5000,10093,91,0.21358007288356984,4032,21,0.23793933584562973,6061,70,0.206272293994952,880,0.8,0.9,316,90,226
5000,1839,2891,0.1,721,1167,0.10000000000000006,1118,1724,0.09999999999999987,881,0.0,0.1,8612,3475,5137
5000,871,679,0.30000000000000027,345,276,0.29999999999999993,526,403,0.29999999999999993,882,0.0,0.3,9589,3852,5737
5000,1665,628,0.5,680,266,0.5,985,362,0.5,883,0.0,0.5,8854,3516,5338
2020,4413,0,0.0,1773,0,0.0,2640,0,0.0,884,0.0,0.7,191,59,132
1123,2507,0,0.0,1015,0,0.0,1492,0,0.0,885,0.0,0.9,131,50,81
5000,2509,1937,0.1222365614741365,928,770,0.12652076928497624,1581,1167,0.1194097919674128,886,0.8,0.1,8104,3261,4843
5000,2804,1759,0.1120577633586597,1091,696,0.11027941034476112,1713,1063,0.1132221412492274,887,0.8,0.3,7675,3080,4595
5000,6011,1507,0.15389957275121255,2471,594,0.15700754551764654,3540,913,0.15187751818027967,888,0.8,0.5,4434,1767,2667
5000,10322,40,0.12259706624056717,4199,12,0.06691069807021675,6123,28,0.14646265259928876,889,0.8,0.7,244,66,178
2085,4566,0,0.0,1826,0,0.0,2740,0,0.0,890,0.8,0.9,122,50,72
5000,1967,2900,0.09999999999999998,771,1143,0.10000000000000009,1196,1757,0.09999999999999987,891,0.0,0.1,8360,3392,4968
5000,914,641,0.30000000000000043,362,226,0.29999999999999993,552,415,0.2999999999999998,892,0.0,0.3,9590,3857,5733
5000,5213,673,0.5,2158,258,0.5,3055,415,0.5,893,0.0,0.5,5279,2013,3266
2433,5150,0,0.0,2121,0,0.0,3029,0,0.0,894,0.0,0.7,213,88,125
903,2290,0,0.0,939,0,0.0,1351,0,0.0,895,0.0,0.9,56,26,30
5000,2748,1871,0.12019364946283118,1059,723,0.1260720200620825,1689,1148,0.11649150491295428,896,0.8,0.1,7502,3018,4484
5000,2305,1771,0.11564983734152329,897,707,0.11651965905571711,1408,1064,0.11507186370248662,897,0.8,0.3,8189,3280,4909
5000,5597,1416,0.1904905445936031,2174,572,0.1862798086883325,3423,844,0.19334426608390493,898,0.8,0.5,4832,1984,2848
5000,8001,754,0.19898926703734945,3316,276,0.21556793534698332,4685,478,0.18941664684182863,899,0.8,0.7,2650,993,1657
712,1821,0,0.0,716,0,0.0,1105,0,0.0,900,0.8,0.9,40,11,29
5000,2073,3113,0.09999999999999991,854,1194,0.10000000000000006,1219,1919,0.09999999999999984,901,0.0,0.1,8432,3343,5089
5000,871,728,0.3000000000000004,331,289,0.2999999999999998,540,439,0.30000000000000004,902,0.0,0.3,9700,3840,5860
5000,1495,399,0.5,619,156,0.5,876,243,0.5,903,0.0,0.5,9107,3615,5492
3629,7169,0,0.0,2862,0,0.0,4307,0,0.0,904,0.0,0.7,717,272,445
940,2258,0,0.0,927,0,0.0,1331,0,0.0,905,0.0,0.9,51,18,33
5000,3417,1913,0.13746883721261238,1339,806,0.1365791931023917,2078,1107,0.13811658170478744,906,0.8,0.1,6965,2787,4178
5000,3104,1840,0.13778482550152657,1297,741,0.13813920173032979,1807,1099,0.137545887571096,907,0.8,0.3,7260,2838,4422
5000,10000,84,0.13268761782791857,4080,23,0.16893638867391433,5920,61,0.11902004849254312,908,0.8,0.5,309,78,231
1187,2857,0,0.0,1109,0,0.0,1748,0,0.0,909,0.8,0.7,29,10,19
5000,7709,947,0.1896462234813664,3079,348,0.17957570655842045,4630,599,0.19549687438150856,910,0.8,0.9,2948,1120,1828
5000,1711,2898,0.09999999999999998,714,1179,0.10000000000000007,997,1719,0.09999999999999988,911,0.0,0.1,8831,3551,5280
5000,954,661,0.30000000000000027,393,262,0.2999999999999999,561,399,0.29999999999999977,912,0.0,0.3,9274,3689,5585
5000,1687,468,0.5,701,194,0.5,986,274,0.5,913,0.0,0.5,8703,3508,5195
2707,5470,0,0.0,2188,0,0.0,3282,0,0.0,914,0.0,0.7,377,159,218
943,2267,0,0.0,896,0,0.0,1371,0,0.0,915,0.0,0.9,49,13,36
5000,2444,1905,0.1223425746995615,987,767,0.12399337599161983,1457,1138,0.12122995203610919,916,0.8,0.1,7942,3258,4684
5000,4570,1627,0.15226263641667495,1824,647,0.14391134306870956,2746,980,0.1577761943719134,917,0.8,0.3,6084,2414,3670
5000,4580,1421,0.1583520683688627,1895,542,0.15170035135762658,2685,879,0.16245358215736097,918,0.8,0.5,6041,2317,3724
5000,7583,924,0.17927787281980295,2995,356,0.1798678681079373,4588,568,0.17890808704061997,919,0.8,0.7,2855,1153,1702
595,1620,0,0.0,665,0,0.0,955,0,0.0,920,0.8,0.9,44,18,26
5000,1469,2547,0.10000000000000009,501,991,0.09999999999999984,968,1556,0.09999999999999992,921,0.0,0.1,8926,3533,5393
5000,924,631,0.30000000000000027,382,255,0.2999999999999998,542,376,0.2999999999999999,922,0.0,0.3,9691,3921,5770
5000,1368,461,0.5,530,197,0.5,838,264,0.5,923,0.0,0.5,8988,3592,5396
1989,4329,0,0.0,1735,0,0.0,2594,0,0.0,924,0.0,0.7,208,91,117
1143,2731,0,0.0,1105,0,0.0,1626,0,0.0,925,0.0,0.9,39,15,24
5000,3973,1856,0.14505793456732324,1636,721,0.14889464619612278,2337,1135,0.14262069308330155,926,0.8,0.1,6496,2539,3957
5000,3497,1751,0.14404114521966804,1373,742,0.1358776221021597,2124,1009,0.15004444963313812,927,0.8,0.3,7081,2924,4157
5000,5631,1358,0.17002316480039265,2276,550,0.1721128698432041,3355,808,0.1686007170608552,928,0.8,0.5,4799,1869,2930
5000,7627,788,0.21031981118099285,3091,311,0.20768755696830984,4536,477,0.21203601885425152,929,0.8,0.7,3055,1236,1819
743,1936,0,0.0,771,0,0.0,1165,0,0.0,930,0.8,0.9,36,6,30
5000,2330,3126,0.0999999999999999,913,1281,0.10000000000000009,1417,1845,0.09999999999999988,931,0.0,0.1,8055,3251,4804
5000,885,673,0.3000000000000005,369,275,0.29999999999999993,516,398,0.2999999999999998,932,0.0,0.3,9503,3837,5666
5000,1740,501,0.5,705,198,0.5,1035,303,0.5,933,0.0,0.5,8920,3524,5396
1080,2536,0,0.0,1030,0,0.0,1506,0,0.0,934,0.0,0.7,90,28,62
1894,4165,0,0.0,1740,0,0.0,2425,0,0.0,935,0.0,0.9,103,34,69
5000,2919,1787,0.13220554447895455,1195,735,0.1254843953338305,1724,1052,0.13690140438548132,936,0.8,0.1,7474,3036,4438
5000,2424,1713,0.11964637623558338,1023,688,0.12527373652719762,1401,1025,0.1158691822056998,937,0.8,0.3,8019,3264,4755
5000,4086,1559,0.18674353483187617,1672,647,0.18971067555166146,2414,912,0.1846385567115899,938,0.8,0.5,6294,2495,3799
5000,4546,1471,0.1721984822546704,1841,587,0.18025120558770144,2705,884,0.166851255335565,939,0.8,0.7,5905,2270,3635
5000,10014,63,0.16628302728921848,3979,22,0.1749279210488109,6035,41,0.16164430380846154,940,0.8,0.9,472,170,302
5000,2174,2903,0.09999999999999998,917,1200,0.10000000000000007,1257,1703,0.09999999999999994,941,0.0,0.1,8413,3368,5045
5000,851,688,0.30000000000000043,307,288,0.2999999999999998,544,400,0.29999999999999977,942,0.0,0.3,9446,3783,5663
5000,2265,557,0.5,935,242,0.5,1330,315,0.5,943,0.0,0.5,8033,3099,4934
5000,8685,29,0.6999999999999997,3417,19,0.7,5268,10,0.7000000000000001,944,0.0,0.7,1693,724,969
1050,2551,0,0.0,977,0,0.0,1574,0,0.0,945,0.0,0.9,29,14,15
5000,2637,2094,0.12400638656027058,1090,847,0.13019332819392948,1547,1247,0.11980402925176288,946,0.8,0.1,7855,3172,4683
5000,3103,1739,0.15103750610570743,1292,655,0.15274552349085985,1811,1084,0.15000544763036153,947,0.8,0.3,7500,2963,4537
5000,3279,1708,0.15123500005621682,1356,640,0.15032758478782776,1923,1068,0.15177876950543864,948,0.8,0.5,7290,2870,4420
5000,7824,852,0.2115291791865106,3220,326,0.20836054951174832,4604,526,0.21349300670356844,949,0.8,0.7,2792,1067,1725
5000,7484,824,0.18682810740802425,3002,311,0.17961726796827449,4482,513,0.19119959096701467,950,0.8,0.9,3042,1246,1796
5000,2127,2845,0.09999999999999996,861,1126,0.10000000000000006,1266,1719,0.09999999999999988,951,0.0,0.1,8315,3320,4995
5000,768,703,0.30000000000000043,309,287,0.2999999999999998,459,416,0.2999999999999998,952,0.0,0.3,9589,3853,5736
5000,2198,629,0.5,928,252,0.5,1270,377,0.5,953,0.0,0.5,8480,3373,5107
1718,3747,0,0.0,1550,0,0.0,2197,0,0.0,954,0.0,0.7,195,78,117
939,2245,0,0.0,910,0,0.0,1335,0,0.0,955,0.0,0.9,67,25,42
5000,2723,1830,0.1307477507791522,1123,692,0.12803320289339762,1600,1138,0.13239842488894318,956,0.8,0.1,7740,3032,4708
5000,3652,1702,0.14975674098335862,1490,688,0.13431144331185346,2162,1014,0.16023639068552384,957,0.8,0.3,6692,2632,4060
5000,5121,1634,0.17120124367783243,2084,671,0.17609860324927668,3037,963,0.1677888571020908,958,0.8,0.5,5526,2208,3318
1187,2776,0,0.0,1074,0,0.0,1702,0,0.0,959,0.8,0.7,93,39,54
3401,7177,0,0.0,2983,0,0.0,4194,0,0.0,960,0.8,0.9,114,36,78
5000,1837,2870,0.09999999999999992,744,1165,0.10000000000000005,1093,1705,0.09999999999999994,961,0.0,0.1,8488,3379,5109
5000,864,645,0.3000000000000002,321,244,0.29999999999999993,543,401,0.29999999999999977,962,0.0,0.3,9564,3812,5752
5000,1599,410,0.5,634,171,0.5,965,239,0.5,963,0.0,0.5,8745,3528,5217
1394,3156,0,0.0,1245,0,0.0,1911,0,0.0,964,0.0,0.7,63,30,33
634,1753,0,0.0,724,0,0.0,1029,0,0.0,965,0.0,0.9,38,19,19
5000,3575,1897,0.13072008879764746,1431,784,0.13193732268226907,2144,1113,0.1298626661870964,966,0.8,0.1,6855,2673,4182
5000,3861,1851,0.14856939923607218,1537,765,0.14636976029276472,2324,1086,0.15011886865746277,967,0.8,0.3,6620,2616,4004
5000,4817,1576,0.1635508352982139,1873,641,0.16338845314828893,2944,935,0.16366215824805555,968,0.8,0.5,5647,2303,3344
5000,7050,1083,0.23815167092020367,2834,468,0.24136591151792658,4216,615,0.23570571222144868,969,0.8,0.7,3375,1409,1966
5000,4667,1669,0.1768383783394907,1946,649,0.17701789281362207,2721,1020,0.17672415785546014,970,0.8,0.9,6017,2255,3762
5000,2236,2937,0.0999999999999999,941,1189,0.10000000000000005,1295,1748,0.0999999999999999,971,0.0,0.1,8218,3272,4946
5000,890,754,0.30000000000000027,347,328,0.2999999999999998,543,426,0.2999999999999998,972,0.0,0.3,9488,3909,5579
5000,7136,401,0.5,2855,179,0.5,4281,222,0.5,973,0.0,0.5,3216,1291,1925
3362,6601,0,0.0,2636,0,0.0,3965,0,0.0,974,0.0,0.7,629,243,386
1817,3974,0,0.0,1543,0,0.0,2431,0,0.0,975,0.0,0.9,170,74,96
5000,2829,1925,0.13070203071536263,1114,747,0.12533734325245863,1715,1178,0.13410391656832468,976,0.8,0.1,7784,3017,4767
5000,2804,1826,0.13738989771808396,1114,709,0.1440392907518709,1690,1117,0.13316928924811533,977,0.8,0.3,7554,3036,4518
5000,2622,1694,0.12932288302406691,999,649,0.1273709456347242,1623,1045,0.13053513887639553,978,0.8,0.5,7757,3116,4641
5000,3435,1715,0.15060766316889565,1391,658,0.14412690316272816,2044,1057,0.15464204357008593,979,0.8,0.7,6914,2740,4174
5000,10381,18,0.10726622380344951,4130,4,0.07818504413553182,6251,14,0.11557513227999745,980,0.8,0.9,123,44,79
5000,1708,2709,0.09999999999999999,653,1053,0.10000000000000006,1055,1656,0.0999999999999999,981,0.0,0.1,8889,3568,5321
5000,885,879,0.3000000000000005,356,335,0.29999999999999977,529,544,0.3000000000000003,982,0.0,0.3,9510,3727,5783
5000,2682,627,0.5,1140,256,0.5,1542,371,0.5,983,0.0,0.5,7897,3149,4748
5000,7892,87,0.7000000000000002,3108,33,0.6999999999999997,4784,54,0.7000000000000001,984,0.0,0.7,2642,1082,1560
841,2028,0,0.0,813,0,0.0,1215,0,0.0,985,0.0,0.9,74,19,55
5000,3173,1883,0.12876303902850214,1305,805,0.1268750722280494,1868,1078,0.1301728843665026,986,0.8,0.1,7367,2999,4368
5000,2640,2077,0.12011560246633962,1029,788,0.12290342603411436,1611,1289,0.11841133173600098,987,0.8,0.3,7779,3044,4735
5000,4151,1773,0.14810386638409256,1619,788,0.1421472503159296,2532,985,0.15286915923862293,988,0.8,0.5,6660,2728,3932
5000,5941,1279,0.18754154278969534,2452,519,0.1817573025054808,3489,760,0.19149157003641568,989,0.8,0.7,4362,1767,2595
5000,10039,45,0.07236132556082245,3982,12,0.10126747729353831,6057,33,0.06184999765801674,990,0.8,0.9,239,68,171
5000,1892,2954,0.09999999999999999,752,1186,0.10000000000000007,1140,1768,0.09999999999999992,991,0.0,0.1,8724,3457,5267
5000,923,662,0.30000000000000027,372,241,0.29999999999999977,551,421,0.2999999999999999,992,0.0,0.3,9570,3753,5817
5000,3074,769,0.5,1225,302,0.5,1849,467,0.5,993,0.0,0.5,7195,2854,4341
5000,9062,35,0.6999999999999998,3554,12,0.7000000000000001,5508,23,0.7,994,0.0,0.7,1548,641,907
1774,3704,0,0.0,1499,0,0.0,2205,0,0.0,995,0.0,0.9,300,130,170
5000,4928,1538,0.15271855672181855,2006,641,0.1510271692894963,2922,897,0.1539272293462542,996,0.8,0.1,5486,2164,3322
5000,2481,1740,0.11913800261504957,1000,651,0.12217272445274363,1481,1089,0.11732385760463744,997,0.8,0.3,7998,3124,4874
5000,3915,1737,0.166575418063433,1498,682,0.1658573766108557,2417,1055,0.16703959272756358,998,0.8,0.5,6621,2682,3939
5000,7707,909,0.18943992923892386,3072,377,0.19290542632342023,4635,532,0.1869841164553614,999,0.8,0.7,2939,1164,1775
1040,2539,0,0.0,1033,0,0.0,1506,0,0.0,1000,0.8,0.9,28,5,23
