step,susceptible_status,infected_status,filtermeanvirulence_pathogen,susceptible_status_is_minority,infected_status_is_minority,filtermeanvirulence_pathogen_is_minority,susceptible_status_#84_f=is_minority,infected_status_#84_f=is_minority,filtermeanvirulence_pathogen_#84_f=is_minority,ensemble,mutation_rate,virulence_init,total_infected,total_minority_infected,total_majority_infected
1418,3246,0,0.0,1273,0,0.0,1973,0,0.0,1,0.0,1.1,91,40,51
1243,2874,0,0.0,1141,0,0.0,1733,0,0.0,2,0.0,1.3,85,33,52
1268,2790,0,0.0,1097,0,0.0,1693,0,0.0,3,0.0,1.5,165,71,94
2195,4935,0,0.0,1943,0,0.0,2992,0,0.0,4,0.0,1.7,106,42,64
842,2050,0,0.0,840,0,0.0,1210,0,0.0,5,0.0,1.9,50,20,30
5000,5377,1379,0.18681310782052965,2199,531,0.19275939980231607,3178,848,0.1830896631951422,6,0.8,1.1,5126,2026,3100
657,1703,0,0.0,710,0,0.0,993,0,0.0,7,0.8,1.3,47,15,32
5000,10072,48,0.23010894765538228,4053,14,0.2544183689227736,6019,34,0.22009918595704459,8,0.8,1.5,204,76,128
5000,4418,1594,0.16043779429658356,1752,641,0.15578350154669615,2666,953,0.16356833118291916,9,0.8,1.7,6145,2459,3686
5000,6513,1179,0.23923939581291723,2617,472,0.23607072819880992,3896,707,0.24135482878867193,10,0.8,1.9,3847,1585,2262
444,1387,0,0.0,545,0,0.0,842,0,0.0,11,0.0,1.1,16,5,11
817,2083,0,0.0,815,0,0.0,1268,0,0.0,12,0.0,1.3,50,24,26
501,1428,0,0.0,582,0,0.0,846,0,0.0,13,0.0,1.5,55,18,37
1790,3882,0,0.0,1629,0,0.0,2253,0,0.0,14,0.0,1.7,130,42,88
500,1426,0,0.0,575,0,0.0,851,0,0.0,15,0.0,1.9,29,8,21
453,1387,0,0.0,547,0,0.0,840,0,0.0,16,0.8,1.1,32,10,22
5000,5150,1445,0.17795275961675716,2118,586,0.1757601876158011,3032,859,0.17944850722160033,17,0.8,1.3,5484,2227,3257
5000,5069,1504,0.15011607383477565,2081,582,0.1434810146801854,2988,922,0.15430436497140432,18,0.8,1.5,5312,2083,3229
691,1818,0,0.0,712,0,0.0,1106,0,0.0,19,0.8,1.7,35,8,27
5000,8144,770,0.21676157009905242,3258,312,0.23153714484083138,4886,458,0.20669611306971822,20,0.8,1.9,2312,900,1412
721,1813,0,0.0,727,0,0.0,1086,0,0.0,21,0.0,1.1,50,19,31
463,1338,0,0.0,526,0,0.0,812,0,0.0,22,0.0,1.3,25,12,13
1037,2457,0,0.0,1001,0,0.0,1456,0,0.0,23,0.0,1.5,69,29,40
1300,3036,0,0.0,1173,0,0.0,1863,0,0.0,24,0.0,1.7,104,45,59
752,1916,0,0.0,789,0,0.0,1127,0,0.0,25,0.0,1.9,65,23,42
5000,6123,1304,0.17351799088786818,2450,511,0.17328721819557605,3673,793,0.17366669813346886,26,0.8,1.1,4329,1723,2606
1304,3134,0,0.0,1290,0,0.0,1844,0,0.0,27,0.8,1.3,49,19,30
5000,9979,107,0.17359036413674883,3961,43,0.15955930246405337,6018,64,0.18301748369809107,28,0.8,1.5,354,131,223
535,1561,0,0.0,616,0,0.0,945,0,0.0,29,0.8,1.7,41,18,23
1433,3359,0,0.0,1401,0,0.0,1958,0,0.0,30,0.8,1.9,48,20,28
945,2314,0,0.0,943,0,0.0,1371,0,0.0,31,0.0,1.1,78,35,43
962,2353,0,0.0,887,0,0.0,1466,0,0.0,32,0.0,1.3,66,28,38
668,1721,0,0.0,676,0,0.0,1045,0,0.0,33,0.0,1.5,72,27,45
1690,3647,0,0.0,1478,0,0.0,2169,0,0.0,34,0.0,1.7,125,53,72
791,2021,0,0.0,792,0,0.0,1229,0,0.0,35,0.0,1.9,72,27,45
300,1066,0,0.0,441,0,0.0,625,0,0.0,36,0.8,1.1,10,2,8
5000,9444,396,0.19579401549823086,3687,145,0.20615968635168863,5757,251,0.1898058789494208,37,0.8,1.3,957,379,578
1001,2326,0,0.0,915,0,0.0,1411,0,0.0,38,0.8,1.5,56,21,35
315,1081,0,0.0,457,0,0.0,624,0,0.0,39,0.8,1.7,14,6,8
5000,8175,721,0.20654114002609647,3308,288,0.21098861700638202,4867,433,0.20358300291218812,40,0.8,1.9,2270,932,1338
584,1676,0,0.0,685,0,0.0,991,0,0.0,41,0.0,1.1,21,10,11
672,1806,0,0.0,724,0,0.0,1082,0,0.0,42,0.0,1.3,31,13,18
833,2098,0,0.0,844,0,0.0,1254,0,0.0,43,0.0,1.5,31,12,19
665,1741,0,0.0,735,0,0.0,1006,0,0.0,44,0.0,1.7,29,8,21
785,1952,0,0.0,777,0,0.0,1175,0,0.0,45,0.0,1.9,51,17,34
2038,4447,0,0.0,1808,0,0.0,2639,0,0.0,46,0.8,1.1,104,41,63
5000,10118,136,0.1642314787708809,4020,59,0.16000641422299855,6098,77,0.16746886589198556,47,0.8,1.3,552,231,321
5000,9273,425,0.22007786116121988,3784,165,0.2076170800964677,5489,260,0.2279856645292358,48,0.8,1.5,1376,552,824
1102,2752,0,0.0,1082,0,0.0,1670,0,0.0,49,0.8,1.7,37,16,21
5000,5157,1696,0.16590605471068548,2122,669,0.16637930497651968,3035,1027,0.16559777386565794,50,0.8,1.9,5349,2173,3176
2033,4436,0,0.0,1712,0,0.0,2724,0,0.0,51,0.0,1.1,113,35,78
693,1836,0,0.0,761,0,0.0,1075,0,0.0,52,0.0,1.3,48,20,28
390,1189,0,0.0,497,0,0.0,692,0,0.0,53,0.0,1.5,19,8,11
1181,2804,0,0.0,1126,0,0.0,1678,0,0.0,54,0.0,1.7,108,39,69
523,1535,0,0.0,589,0,0.0,946,0,0.0,55,0.0,1.9,24,11,13
713,1831,0,0.0,744,0,0.0,1087,0,0.0,56,0.8,1.1,46,23,23
5000,9168,420,0.22147883703470939,3718,168,0.21696280535589613,5450,252,0.22448952482058482,57,0.8,1.3,1293,520,773
5000,9025,457,0.208747726569701,3587,183,0.22224640100176454,5438,274,0.19973218853660754,58,0.8,1.5,1468,582,886
2050,4432,0,0.0,1730,0,0.0,2702,0,0.0,59,0.8,1.7,56,20,36
767,1970,0,0.0,774,0,0.0,1196,0,0.0,60,0.8,1.9,32,10,22
1077,2537,0,0.0,997,0,0.0,1540,0,0.0,61,0.0,1.1,103,41,62
570,1561,0,0.0,600,0,0.0,961,0,0.0,62,0.0,1.3,47,29,18
965,2306,0,0.0,882,0,0.0,1424,0,0.0,63,0.0,1.5,63,26,37
1256,2914,0,0.0,1140,0,0.0,1774,0,0.0,64,0.0,1.7,89,32,57
1350,3081,0,0.0,1285,0,0.0,1796,0,0.0,65,0.0,1.9,151,66,85
875,2197,0,0.0,883,0,0.0,1314,0,0.0,66,0.8,1.1,37,14,23
5000,8432,600,0.15301137602494266,3397,238,0.13582071295739845,5035,362,0.16431352467156024,67,0.8,1.3,1930,778,1152
750,1912,0,0.0,743,0,0.0,1169,0,0.0,68,0.8,1.5,37,13,24
5000,9229,436,0.18837937743612054,3735,174,0.19376495027230886,5494,262,0.1848026992930031,69,0.8,1.7,1215,509,706
5000,5544,1472,0.1588676785066142,2218,575,0.15556787418509424,3326,897,0.16098293768707567,70,0.8,1.9,4911,1940,2971
652,1666,0,0.0,668,0,0.0,998,0,0.0,71,0.0,1.1,59,23,36
919,2266,0,0.0,919,0,0.0,1347,0,0.0,72,0.0,1.3,55,24,31
709,1910,0,0.0,774,0,0.0,1136,0,0.0,73,0.0,1.5,43,18,25
774,1925,0,0.0,783,0,0.0,1142,0,0.0,74,0.0,1.7,64,23,41
457,1324,0,0.0,530,0,0.0,794,0,0.0,75,0.0,1.9,30,13,17
5000,9850,241,0.2693805247901591,3930,102,0.23618611028724393,5920,139,0.29373901600812574,76,0.8,1.1,773,315,458
5000,10097,90,0.16984015735474853,4013,39,0.15257277680160558,6084,51,0.1830446248365637,77,0.8,1.3,440,183,257
5000,8746,445,0.18215096784707024,3554,172,0.18104673476226626,5192,273,0.18284667513859504,78,0.8,1.5,1734,671,1063
5000,10359,52,0.10181366560754558,4155,21,0.1547970441528973,6204,31,0.06592169949617835,79,0.8,1.7,172,64,108
5000,7546,920,0.19202230993757732,3015,366,0.1990075159818689,4531,554,0.18740753482528352,80,0.8,1.9,3046,1234,1812
2033,4458,0,0.0,1769,0,0.0,2689,0,0.0,81,0.0,1.1,110,47,63
1061,2549,0,0.0,1054,0,0.0,1495,0,0.0,82,0.0,1.3,26,7,19
1033,2487,0,0.0,994,0,0.0,1493,0,0.0,83,0.0,1.5,52,21,31
883,2187,0,0.0,863,0,0.0,1324,0,0.0,84,0.0,1.7,96,44,52
550,1525,0,0.0,599,0,0.0,926,0,0.0,85,0.0,1.9,24,8,16
5000,8968,479,0.1985374699002536,3600,186,0.18043298187479478,5368,293,0.21003042134303626,86,0.8,1.1,1569,637,932
5000,4052,1684,0.15380235770061,1651,673,0.15089723217878315,2401,1011,0.15573623453165789,87,0.8,1.3,6300,2519,3781
5000,9309,211,0.22157999397539957,3821,75,0.27091321988714157,5488,136,0.19437417086230663,88,0.8,1.5,1026,395,631
5000,10398,3,0.39025088065060726,4280,0,0.0,6118,3,0.39025088065060726,89,0.8,1.7,66,20,46
831,2131,0,0.0,841,0,0.0,1290,0,0.0,90,0.8,1.9,23,9,14
2288,4970,0,0.0,1950,0,0.0,3020,0,0.0,91,0.0,1.1,80,38,42
526,1467,0,0.0,596,0,0.0,871,0,0.0,92,0.0,1.3,46,14,32
1335,3043,0,0.0,1171,0,0.0,1872,0,0.0,93,0.0,1.5,90,44,46
989,2423,0,0.0,967,0,0.0,1456,0,0.0,94,0.0,1.7,85,37,48
1167,2819,0,0.0,1186,0,0.0,1633,0,0.0,95,0.0,1.9,50,22,28
1321,3027,0,0.0,1173,0,0.0,1854,0,0.0,96,0.8,1.1,48,13,35
5000,4722,1632,0.1714895957203486,1955,641,0.16180560186006282,2767,991,0.17775341011433765,97,0.8,1.3,5826,2241,3585
1512,3373,0,0.0,1344,0,0.0,2029,0,0.0,98,0.8,1.5,128,56,72
5000,9865,182,0.22996164309100736,4013,76,0.2623250796043567,5852,106,0.20675766974181364,99,0.8,1.7,563,217,346
2919,6182,0,0.0,2461,0,0.0,3721,0,0.0,100,0.8,1.9,121,50,71
1051,2473,0,0.0,997,0,0.0,1476,0,0.0,101,0.0,1.1,57,15,42
2067,4370,0,0.0,1733,0,0.0,2637,0,0.0,102,0.0,1.3,169,61,108
1250,2924,0,0.0,1179,0,0.0,1745,0,0.0,103,0.0,1.5,110,47,63
1043,2572,0,0.0,1024,0,0.0,1548,0,0.0,104,0.0,1.7,87,24,63
994,2410,0,0.0,972,0,0.0,1438,0,0.0,105,0.0,1.9,71,25,46
532,1555,0,0.0,634,0,0.0,921,0,0.0,106,0.8,1.1,30,7,23
5000,7370,942,0.18709707586249902,2991,377,0.19099861906158636,4379,565,0.18449374526770967,107,0.8,1.3,2985,1214,1771
5000,5732,1347,0.15778368617410918,2318,561,0.16760943249581428,3414,786,0.15077065349411362,108,0.8,1.5,4760,1904,2856
325,1120,0,0.0,457,0,0.0,663,0,0.0,109,0.8,1.7,12,3,9
5000,8245,579,0.22952088407975363,3264,240,0.22128097246444117,4981,339,0.23535444982510753,110,0.8,1.9,2298,915,1383
1283,3019,0,0.0,1171,0,0.0,1848,0,0.0,111,0.0,1.1,95,36,59
993,2318,0,0.0,882,0,0.0,1436,0,0.0,112,0.0,1.3,146,61,85
1118,2651,0,0.0,1032,0,0.0,1619,0,0.0,113,0.0,1.5,65,28,37
1327,3087,0,0.0,1243,0,0.0,1844,0,0.0,114,0.0,1.7,108,42,66
746,1922,0,0.0,767,0,0.0,1155,0,0.0,115,0.0,1.9,62,28,34
5000,5344,1487,0.1633906571071776,2137,576,0.1634745410843997,3207,911,0.16333761959797913,116,0.8,1.1,5234,2056,3178
869,2180,0,0.0,843,0,0.0,1337,0,0.0,117,0.8,1.3,36,19,17
5000,7805,875,0.18885253463416182,3182,369,0.18252332128322019,4623,506,0.19346810721617247,118,0.8,1.5,2721,1112,1609
5000,9773,293,0.15779476163027759,4020,127,0.17797862371509438,5753,166,0.14235289124008646,119,0.8,1.7,748,300,448
831,2003,0,0.0,799,0,0.0,1204,0,0.0,120,0.8,1.9,48,21,27
1199,2740,0,0.0,1117,0,0.0,1623,0,0.0,121,0.0,1.1,111,40,71
782,2019,0,0.0,813,0,0.0,1206,0,0.0,122,0.0,1.3,38,18,20
1176,2766,0,0.0,1148,0,0.0,1618,0,0.0,123,0.0,1.5,89,37,52
602,1709,0,0.0,679,0,0.0,1030,0,0.0,124,0.0,1.7,41,17,24
1321,3011,0,0.0,1204,0,0.0,1807,0,0.0,125,0.0,1.9,81,33,48
5000,8364,670,0.18871988518591076,3391,253,0.1889572504745393,4973,417,0.18857587219304986,126,0.8,1.1,1997,774,1223
5000,7054,1029,0.18880459745444067,2804,411,0.19216519995654385,4250,618,0.1865696336544983,127,0.8,1.3,3483,1372,2111
5000,9406,311,0.1865620089846766,3731,120,0.19075394442753804,5675,191,0.18392833226664845,128,0.8,1.5,901,373,528
5000,6108,1471,0.17116393932683374,2478,600,0.17626233644255337,3630,871,0.1676518402804138,129,0.8,1.7,4307,1722,2585
5000,9124,422,0.23506471867565953,3648,147,0.2772224605560615,5476,275,0.2125294893795902,130,0.8,1.9,1487,593,894
1250,2951,0,0.0,1157,0,0.0,1794,0,0.0,131,0.0,1.1,80,29,51
1975,4301,0,0.0,1724,0,0.0,2577,0,0.0,132,0.0,1.3,132,47,85
1171,2757,0,0.0,1095,0,0.0,1662,0,0.0,133,0.0,1.5,102,45,57
639,1703,0,0.0,698,0,0.0,1005,0,0.0,134,0.0,1.7,32,11,21
892,2182,0,0.0,854,0,0.0,1328,0,0.0,135,0.0,1.9,74,30,44
5000,6510,1238,0.20003286718934798,2485,505,0.19900067212470604,4025,733,0.20074399748627053,136,0.8,1.1,4013,1627,2386
418,1275,0,0.0,498,0,0.0,777,0,0.0,137,0.8,1.3,22,8,14
495,1437,0,0.0,564,0,0.0,873,0,0.0,138,0.8,1.5,22,12,10
5000,8247,665,0.2125395358847586,3308,242,0.21009040311101718,4939,423,0.21394069458746634,139,0.8,1.7,2078,829,1249
5000,7804,711,0.22400175859894078,3223,290,0.22448376319767077,4581,421,0.2236697364287942,140,0.8,1.9,2701,1080,1621
759,1964,0,0.0,802,0,0.0,1162,0,0.0,141,0.0,1.1,36,16,20
1433,3198,0,0.0,1276,0,0.0,1922,0,0.0,142,0.0,1.3,77,42,35
1366,3051,0,0.0,1210,0,0.0,1841,0,0.0,143,0.0,1.5,93,36,57
1210,2738,0,0.0,1072,0,0.0,1666,0,0.0,144,0.0,1.7,146,55,91
1742,3812,0,0.0,1482,0,0.0,2330,0,0.0,145,0.0,1.9,110,46,64
446,1356,0,0.0,542,0,0.0,814,0,0.0,146,0.8,1.1,30,14,16
1911,4215,0,0.0,1687,0,0.0,2528,0,0.0,147,0.8,1.3,156,57,99
5000,7535,942,0.1875868396790093,3035,382,0.17910732648073321,4500,560,0.19337107903926168,148,0.8,1.5,3023,1255,1768
5000,4272,1636,0.16435022152484652,1707,631,0.16074663444618198,2565,1005,0.16661277221801807,149,0.8,1.7,6295,2411,3884
882,2242,0,0.0,946,0,0.0,1296,0,0.0,150,0.8,1.9,29,8,21
1473,3252,0,0.0,1295,0,0.0,1957,0,0.0,151,0.0,1.1,147,60,87
370,1152,0,0.0,458,0,0.0,694,0,0.0,152,0.0,1.3,28,9,19
967,2343,0,0.0,954,0,0.0,1389,0,0.0,153,0.0,1.5,41,17,24
1691,3719,0,0.0,1451,0,0.0,2268,0,0.0,154,0.0,1.7,156,61,95
1215,2779,0,0.0,1133,0,0.0,1646,0,0.0,155,0.0,1.9,145,55,90
5000,5610,1423,0.17194285107171237,2194,551,0.17597672431720876,3416,872,0.1693939242847072,156,0.8,1.1,4883,1950,2933
5000,9063,408,0.24741682018968628,3607,172,0.23472857485559762,5456,236,0.25666418543317465,157,0.8,1.3,1321,520,801
1355,3074,0,0.0,1202,0,0.0,1872,0,0.0,158,0.8,1.5,112,45,67
1099,2571,0,0.0,1010,0,0.0,1561,0,0.0,159,0.8,1.7,81,32,49
623,1724,0,0.0,691,0,0.0,1033,0,0.0,160,0.8,1.9,45,16,29
1049,2443,0,0.0,1013,0,0.0,1430,0,0.0,161,0.0,1.1,55,15,40
846,2083,0,0.0,859,0,0.0,1224,0,0.0,162,0.0,1.3,38,12,26
1096,2603,0,0.0,1022,0,0.0,1581,0,0.0,163,0.0,1.5,66,34,32
1718,3809,0,0.0,1516,0,0.0,2293,0,0.0,164,0.0,1.7,87,28,59
1194,2867,0,0.0,1080,0,0.0,1787,0,0.0,165,0.0,1.9,92,32,60
5000,10008,115,0.18808734436876356,3918,46,0.16889451753375084,6090,69,0.20088256225877207,166,0.8,1.1,412,162,250
1509,3345,0,0.0,1336,0,0.0,2009,0,0.0,167,0.8,1.3,169,67,102
5000,6441,1311,0.19732656969280887,2607,520,0.18691121251926623,3834,791,0.2041735807297775,168,0.8,1.5,4116,1652,2464
734,1917,0,0.0,753,0,0.0,1164,0,0.0,169,0.8,1.7,24,6,18
5000,10134,29,0.15191564920394002,4087,14,0.1169715876592856,6047,15,0.18453010664561745,170,0.8,1.9,157,54,103
410,1246,0,0.0,476,0,0.0,770,0,0.0,171,0.0,1.1,40,15,25
684,1846,0,0.0,748,0,0.0,1098,0,0.0,172,0.0,1.3,45,15,30
1780,3856,0,0.0,1550,0,0.0,2306,0,0.0,173,0.0,1.5,185,71,114
599,1593,0,0.0,654,0,0.0,939,0,0.0,174,0.0,1.7,51,17,34
960,2350,0,0.0,945,0,0.0,1405,0,0.0,175,0.0,1.9,72,32,40
582,1578,0,0.0,637,0,0.0,941,0,0.0,176,0.8,1.1,18,11,7
5000,7041,989,0.21065576449800502,2839,415,0.2166736649721663,4202,574,0.20630484342348057,177,0.8,1.3,3363,1399,1964
5000,4914,1483,0.1798881676937695,2013,590,0.1713358108782064,2901,893,0.18553866099856484,178,0.8,1.5,5606,2244,3362
417,1272,0,0.0,534,0,0.0,738,0,0.0,179,0.8,1.7,10,4,6
5000,9920,141,0.12668266447776275,3947,51,0.13871101892864665,5973,90,0.11986659695559516,180,0.8,1.9,408,156,252
647,1656,0,0.0,671,0,0.0,985,0,0.0,181,0.0,1.1,47,21,26
1930,4263,0,0.0,1740,0,0.0,2523,0,0.0,182,0.0,1.3,157,61,96
460,1319,0,0.0,550,0,0.0,769,0,0.0,183,0.0,1.5,36,10,26
1516,3344,0,0.0,1314,0,0.0,2030,0,0.0,184,0.0,1.7,98,38,60
892,2250,0,0.0,909,0,0.0,1341,0,0.0,185,0.0,1.9,47,19,28
1505,3402,0,0.0,1365,0,0.0,2037,0,0.0,186,0.8,1.1,46,22,24
473,1375,0,0.0,546,0,0.0,829,0,0.0,187,0.8,1.3,37,14,23
1639,3560,0,0.0,1450,0,0.0,2110,0,0.0,188,0.8,1.5,120,50,70
599,1681,0,0.0,664,0,0.0,1017,0,0.0,189,0.8,1.7,45,12,33
5000,9835,237,0.19568393798531603,3904,101,0.1892637230757253,5931,136,0.20045189170493857,190,0.8,1.9,624,269,355
505,1500,0,0.0,587,0,0.0,913,0,0.0,191,0.0,1.1,43,13,30
541,1561,0,0.0,638,0,0.0,923,0,0.0,192,0.0,1.3,35,14,21
439,1320,0,0.0,518,0,0.0,802,0,0.0,193,0.0,1.5,35,13,22
556,1504,0,0.0,603,0,0.0,901,0,0.0,194,0.0,1.7,70,28,42
2621,5467,0,0.0,2203,0,0.0,3264,0,0.0,195,0.0,1.9,207,82,125
5000,5162,1545,0.17056506907108152,2045,605,0.1700009617604613,3117,940,0.17092813813802324,196,0.8,1.1,5089,2009,3080
5000,9732,243,0.20035468117643715,3834,95,0.22244130444382312,5898,148,0.1861774567818313,197,0.8,1.3,782,307,475
5000,10134,125,0.23045672325107994,4055,53,0.18591816327527078,6079,72,0.2632420521221617,198,0.8,1.5,338,122,216
5000,9399,348,0.20898304702623352,3729,135,0.20435493058212195,5670,213,0.2119163602654592,199,0.8,1.7,1011,395,616
539,1508,0,0.0,599,0,0.0,909,0,0.0,200,0.8,1.9,24,11,13
1277,3039,0,0.0,1247,0,0.0,1792,0,0.0,201,0.0,1.1,98,37,61
684,1806,0,0.0,730,0,0.0,1076,0,0.0,202,0.0,1.3,46,23,23
441,1327,0,0.0,537,0,0.0,790,0,0.0,203,0.0,1.5,13,4,9
459,1337,0,0.0,516,0,0.0,821,0,0.0,204,0.0,1.7,20,8,12
1903,4138,0,0.0,1683,0,0.0,2455,0,0.0,205,0.0,1.9,117,46,71
5000,10352,7,0.10418315730261522,4183,3,0.0895707643111361,6169,4,0.11514245204622456,206,0.8,1.1,135,61,74
2048,4498,0,0.0,1828,0,0.0,2670,0,0.0,207,0.8,1.3,120,48,72
5000,10123,87,0.18536464489395982,4042,33,0.21226994337558913,6081,54,0.1689225180440752,208,0.8,1.5,296,114,182
5000,7650,947,0.17890649716796028,3113,370,0.17687027105425795,4537,577,0.1802122227521368,209,0.8,1.7,2924,1149,1775
2087,4530,0,0.0,1746,0,0.0,2784,0,0.0,210,0.8,1.9,127,47,80
1266,2835,0,0.0,1138,0,0.0,1697,0,0.0,211,0.0,1.1,124,48,76
1378,3053,0,0.0,1180,0,0.0,1873,0,0.0,212,0.0,1.3,176,70,106
1319,3054,0,0.0,1195,0,0.0,1859,0,0.0,213,0.0,1.5,68,29,39
726,1881,0,0.0,759,0,0.0,1122,0,0.0,214,0.0,1.7,72,30,42
596,1624,0,0.0,628,0,0.0,996,0,0.0,215,0.0,1.9,13,5,8
5000,6077,1315,0.193377493733987,2496,523,0.20072552608551608,3581,792,0.18852519459276262,216,0.8,1.1,4296,1690,2606
5000,8684,544,0.19523590952231265,3553,210,0.20003967330379469,5131,334,0.19221557900102162,217,0.8,1.3,1773,704,1069
5000,10125,122,0.2573038666249039,3996,46,0.2684855815015876,6129,76,0.25053598656796383,218,0.8,1.5,341,135,206
476,1404,0,0.0,542,0,0.0,862,0,0.0,219,0.8,1.7,33,16,17
679,1768,0,0.0,684,0,0.0,1084,0,0.0,220,0.8,1.9,38,8,30
1458,3310,0,0.0,1366,0,0.0,1944,0,0.0,221,0.0,1.1,77,27,50
1457,3330,0,0.0,1303,0,0.0,2027,0,0.0,222,0.0,1.3,146,69,77
867,2194,0,0.0,906,0,0.0,1288,0,0.0,223,0.0,1.5,57,21,36
1165,2667,0,0.0,1017,0,0.0,1650,0,0.0,224,0.0,1.7,99,37,62
1802,3895,0,0.0,1509,0,0.0,2386,0,0.0,225,0.0,1.9,205,80,125
767,1936,0,0.0,786,0,0.0,1150,0,0.0,226,0.8,1.1,37,13,24
5000,10194,85,0.1753794482609274,4051,35,0.17726337223522481,6143,50,0.17406070147891925,227,0.8,1.3,268,111,157
743,1887,0,0.0,761,0,0.0,1126,0,0.0,228,0.8,1.5,40,15,25
790,2006,0,0.0,796,0,0.0,1210,0,0.0,229,0.8,1.7,41,16,25
5000,6107,1242,0.21021936628021093,2431,501,0.2114039823146403,3676,741,0.20941843155247913,230,0.8,1.9,4184,1726,2458
1181,2714,0,0.0,1100,0,0.0,1614,0,0.0,231,0.0,1.1,117,51,66
446,1339,0,0.0,507,0,0.0,832,0,0.0,232,0.0,1.3,36,13,23
991,2378,0,0.0,953,0,0.0,1425,0,0.0,233,0.0,1.5,52,20,32
1556,3424,0,0.0,1344,0,0.0,2080,0,0.0,234,0.0,1.7,97,41,56
1466,3295,0,0.0,1336,0,0.0,1959,0,0.0,235,0.0,1.9,193,82,111
5000,7849,832,0.208536162150179,3060,339,0.1965975021187618,4789,493,0.2167455044435874,236,0.8,1.1,2806,1160,1646
1137,2756,0,0.0,1071,0,0.0,1685,0,0.0,237,0.8,1.3,28,8,20
5000,9125,291,0.25022320886253646,3735,98,0.2766307842055598,5390,193,0.23681418096815163,238,0.8,1.5,1368,535,833
5000,9429,336,0.20459457505468728,3863,127,0.21011051165342365,5566,209,0.2012427858296178,239,0.8,1.7,1191,461,730
575,1614,0,0.0,630,0,0.0,984,0,0.0,240,0.8,1.9,64,24,40
827,2144,0,0.0,877,0,0.0,1267,0,0.0,241,0.0,1.1,38,10,28
835,2085,0,0.0,846,0,0.0,1239,0,0.0,242,0.0,1.3,82,33,49
1007,2410,0,0.0,969,0,0.0,1441,0,0.0,243,0.0,1.5,58,23,35
1320,2990,0,0.0,1208,0,0.0,1782,0,0.0,244,0.0,1.7,101,40,61
1098,2648,0,0.0,1063,0,0.0,1585,0,0.0,245,0.0,1.9,50,21,29
5000,6141,1336,0.17878373456980343,2433,531,0.18152002387748364,3708,805,0.17697880336188018,246,0.8,1.1,4336,1734,2602
5000,8874,516,0.17754822484593386,3553,188,0.17153751963434619,5321,328,0.1809933851501366,247,0.8,1.3,1531,580,951
5000,6848,1086,0.19424939134123742,2737,430,0.19428271317947685,4111,656,0.19422754928263533,248,0.8,1.5,3881,1548,2333
5000,9254,481,0.28638563685392054,3721,201,0.2982941494412778,5533,280,0.277837026032282,249,0.8,1.7,1298,521,777
5000,10050,44,0.1779007192483739,4024,19,0.15361409705803558,6026,25,0.19635855211303088,250,0.8,1.9,152,60,92
1462,3271,0,0.0,1344,0,0.0,1927,0,0.0,251,0.0,1.1,68,26,42
719,1870,0,0.0,746,0,0.0,1124,0,0.0,252,0.0,1.3,103,45,58
560,1518,0,0.0,608,0,0.0,910,0,0.0,253,0.0,1.5,32,11,21
623,1580,0,0.0,669,0,0.0,911,0,0.0,254,0.0,1.7,52,24,28
1520,3402,0,0.0,1350,0,0.0,2052,0,0.0,255,0.0,1.9,194,81,113
406,1225,0,0.0,507,0,0.0,718,0,0.0,256,0.8,1.1,24,11,13
5000,3464,1819,0.15188402814764398,1364,701,0.15163541571261696,2100,1118,0.15203991125762056,257,0.8,1.3,7125,2844,4281
588,1579,0,0.0,643,0,0.0,936,0,0.0,258,0.8,1.5,32,15,17
1384,3061,0,0.0,1219,0,0.0,1842,0,0.0,259,0.8,1.7,70,27,43
691,1790,0,0.0,713,0,0.0,1077,0,0.0,260,0.8,1.9,46,19,27
1687,3572,0,0.0,1423,0,0.0,2149,0,0.0,261,0.0,1.1,198,83,115
1448,3365,0,0.0,1319,0,0.0,2046,0,0.0,262,0.0,1.3,67,25,42
1070,2495,0,0.0,1028,0,0.0,1467,0,0.0,263,0.0,1.5,90,42,48
1288,2933,0,0.0,1150,0,0.0,1783,0,0.0,264,0.0,1.7,125,51,74
2184,4880,0,0.0,1971,0,0.0,2909,0,0.0,265,0.0,1.9,98,41,57
5000,7153,1055,0.19442528840941278,2883,392,0.19973530289477617,4270,663,0.19128573233360224,266,0.8,1.1,3213,1217,1996
5000,9044,460,0.19036190997249497,3575,182,0.19202898068101698,5469,278,0.18927051835756337,267,0.8,1.3,1483,576,907
5000,9060,429,0.21549242207595193,3661,179,0.22202750763410858,5399,250,0.21081330081631186,268,0.8,1.5,1254,517,737
5000,9143,344,0.2115076665217737,3674,133,0.18977014869177689,5469,211,0.22520951425347785,269,0.8,1.7,1384,564,820
5000,7769,871,0.18491586328171847,3097,345,0.1862226752703535,4672,526,0.18405873374544635,270,0.8,1.9,2733,1052,1681
1534,3412,0,0.0,1358,0,0.0,2054,0,0.0,271,0.0,1.1,109,42,67
642,1707,0,0.0,631,0,0.0,1076,0,0.0,272,0.0,1.3,45,20,25
886,2158,0,0.0,876,0,0.0,1282,0,0.0,273,0.0,1.5,48,21,27
778,1983,0,0.0,784,0,0.0,1199,0,0.0,274,0.0,1.7,51,22,29
1314,2995,0,0.0,1180,0,0.0,1815,0,0.0,275,0.0,1.9,84,38,46
850,2180,0,0.0,889,0,0.0,1291,0,0.0,276,0.8,1.1,69,34,35
5000,8292,575,0.2112499826233447,3340,233,0.21249200489929146,4952,342,0.21040380955230495,277,0.8,1.3,2160,833,1327
388,1189,0,0.0,471,0,0.0,718,0,0.0,278,0.8,1.5,24,14,10
875,2160,0,0.0,866,0,0.0,1294,0,0.0,279,0.8,1.7,38,15,23
5000,9443,524,0.2594950901192802,3789,214,0.24971879692693394,5654,310,0.2662438860649643,280,0.8,1.9,1207,494,713
1252,2913,0,0.0,1161,0,0.0,1752,0,0.0,281,0.0,1.1,109,39,70
831,2160,0,0.0,864,0,0.0,1296,0,0.0,282,0.0,1.3,76,36,40
446,1296,0,0.0,527,0,0.0,769,0,0.0,283,0.0,1.5,33,15,18
1200,2771,0,0.0,1090,0,0.0,1681,0,0.0,284,0.0,1.7,86,42,44
724,1898,0,0.0,779,0,0.0,1119,0,0.0,285,0.0,1.9,84,28,56
5000,6180,1324,0.19878078908365496,2407,528,0.20155136503111043,3773,796,0.19694302011348347,286,0.8,1.1,4153,1696,2457
359,1142,0,0.0,447,0,0.0,695,0,0.0,287,0.8,1.3,18,13,5
768,1934,0,0.0,783,0,0.0,1151,0,0.0,288,0.8,1.5,58,25,33
793,2054,0,0.0,808,0,0.0,1246,0,0.0,289,0.8,1.7,34,10,24
5000,10119,153,0.27480964871066066,4037,46,0.3269073310581819,6082,107,0.2524125142435021,290,0.8,1.9,390,131,259
1886,4140,0,0.0,1703,0,0.0,2437,0,0.0,291,0.0,1.1,186,70,116
2845,5678,0,0.0,2263,0,0.0,3415,0,0.0,292,0.0,1.3,322,128,194
655,1698,0,0.0,698,0,0.0,1000,0,0.0,293,0.0,1.5,58,24,34
463,1335,0,0.0,565,0,0.0,770,0,0.0,294,0.0,1.7,21,8,13
850,2129,0,0.0,820,0,0.0,1309,0,0.0,295,0.0,1.9,64,22,42
908,2257,0,0.0,924,0,0.0,1333,0,0.0,296,0.8,1.1,91,37,54
997,2434,0,0.0,960,0,0.0,1474,0,0.0,297,0.8,1.3,47,19,28
5000,8532,658,0.2151133138034833,3452,257,0.21402239646999208,5080,401,0.215812480274075,298,0.8,1.5,2028,817,1211
5000,6520,1280,0.1963672901736695,2706,494,0.17851176103368832,3814,786,0.20758946752118962,299,0.8,1.7,3922,1546,2376
5000,5979,1620,0.1937259250840469,2438,635,0.18093557769822272,3541,985,0.20197147898252243,300,0.8,1.9,4533,1766,2767
2861,6062,0,0.0,2414,0,0.0,3648,0,0.0,301,0.0,1.1,145,62,83
844,2160,0,0.0,881,0,0.0,1279,0,0.0,302,0.0,1.3,55,20,35
604,1608,0,0.0,655,0,0.0,953,0,0.0,303,0.0,1.5,59,24,35
1289,2848,0,0.0,1145,0,0.0,1703,0,0.0,304,0.0,1.7,167,71,96
1151,2830,0,0.0,1144,0,0.0,1686,0,0.0,305,0.0,1.9,60,22,38
5000,5438,1501,0.16885225596236722,2176,585,0.16462245424373398,3262,916,0.17155360312983495,306,0.8,1.1,4960,1948,3012
5000,7654,815,0.20123960160547583,3033,332,0.1923422849129225,4621,483,0.20735535552251028,307,0.8,1.3,2633,1086,1547
5000,9664,246,0.19444120409557328,3882,102,0.187381232110693,5782,144,0.1994420175848635,308,0.8,1.5,816,332,484
5000,9339,272,0.2565357607533846,3695,101,0.23738771930998806,5644,171,0.26784542265854866,309,0.8,1.7,1209,508,701
441,1327,0,0.0,506,0,0.0,821,0,0.0,310,0.8,1.9,20,7,13
566,1584,0,0.0,641,0,0.0,943,0,0.0,311,0.0,1.1,50,18,32
914,2238,0,0.0,896,0,0.0,1342,0,0.0,312,0.0,1.3,36,12,24
871,2134,0,0.0,885,0,0.0,1249,0,0.0,313,0.0,1.5,50,17,33
184,820,0,0.0,317,0,0.0,503,0,0.0,314,0.0,1.7,16,9,7
582,1545,0,0.0,595,0,0.0,950,0,0.0,315,0.0,1.9,41,11,30
5000,10397,2,0.05,4145,0,0.0,6252,2,0.05,316,0.8,1.1,64,24,40
5000,9592,241,0.2800058298140602,3775,111,0.30562358674312184,5817,130,0.25813220659001535,317,0.8,1.3,965,412,553
5000,5098,1410,0.15967764730623082,2088,576,0.15816150176569804,3010,834,0.16072476940616712,318,0.8,1.5,5551,2195,3356
4533,9409,0,0.0,3771,0,0.0,5638,0,0.0,319,0.8,1.7,169,70,99
5000,5695,1287,0.18924371804247406,2332,512,0.1787961572559908,3363,775,0.19614584852335076,320,0.8,1.9,4668,1847,2821
777,1932,0,0.0,792,0,0.0,1140,0,0.0,321,0.0,1.1,60,23,37
991,2458,0,0.0,979,0,0.0,1479,0,0.0,322,0.0,1.3,36,10,26
655,1672,0,0.0,683,0,0.0,989,0,0.0,323,0.0,1.5,42,15,27
1062,2502,0,0.0,1006,0,0.0,1496,0,0.0,324,0.0,1.7,81,42,39
796,1994,0,0.0,789,0,0.0,1205,0,0.0,325,0.0,1.9,51,23,28
5000,6844,1098,0.20923669492014382,2744,439,0.20952139802156583,4100,659,0.20904703686016768,326,0.8,1.1,3539,1438,2101
917,2233,0,0.0,901,0,0.0,1332,0,0.0,327,0.8,1.3,48,15,33
5000,7321,1037,0.21944886218260576,2856,376,0.2135968131906606,4465,661,0.22277771304640512,328,0.8,1.5,3096,1178,1918
5000,4365,1675,0.1597149540011313,1768,673,0.1604814605537842,2597,1002,0.15920012474969872,329,0.8,1.7,6068,2414,3654
5000,3709,1548,0.1453828308876148,1498,622,0.14139988302374532,2211,926,0.1480582019149657,330,0.8,1.9,6617,2649,3968
1370,3060,0,0.0,1196,0,0.0,1864,0,0.0,331,0.0,1.1,124,50,74
413,1320,0,0.0,527,0,0.0,793,0,0.0,332,0.0,1.3,17,4,13
1325,2995,0,0.0,1162,0,0.0,1833,0,0.0,333,0.0,1.5,96,38,58
1956,4217,0,0.0,1688,0,0.0,2529,0,0.0,334,0.0,1.7,170,83,87
959,2285,0,0.0,923,0,0.0,1362,0,0.0,335,0.0,1.9,86,35,51
789,1938,0,0.0,770,0,0.0,1168,0,0.0,336,0.8,1.1,75,32,43
5000,7378,1154,0.17942142294256191,2921,482,0.17824382098556818,4457,672,0.1802660719652866,337,0.8,1.3,3290,1364,1926
5000,8533,643,0.1844580002956194,3389,232,0.1748006973716999,5144,411,0.18990932457384163,338,0.8,1.5,1814,722,1092
5000,8123,696,0.24485511819878258,3262,290,0.24722604968878498,4861,406,0.24316159570592372,339,0.8,1.7,2278,918,1360
961,2380,0,0.0,937,0,0.0,1443,0,0.0,340,0.8,1.9,54,16,38
615,1663,0,0.0,674,0,0.0,989,0,0.0,341,0.0,1.1,55,21,34
1331,3033,0,0.0,1191,0,0.0,1842,0,0.0,342,0.0,1.3,72,27,45
1834,3971,0,0.0,1600,0,0.0,2371,0,0.0,343,0.0,1.5,116,48,68
1295,3023,0,0.0,1184,0,0.0,1839,0,0.0,344,0.0,1.7,52,22,30
1576,3517,0,0.0,1430,0,0.0,2087,0,0.0,345,0.0,1.9,115,39,76
1010,2413,0,0.0,970,0,0.0,1443,0,0.0,346,0.8,1.1,43,17,26
809,2090,0,0.0,814,0,0.0,1276,0,0.0,347,0.8,1.3,35,16,19
744,1859,0,0.0,701,0,0.0,1158,0,0.0,348,0.8,1.5,71,29,42
5000,5506,1590,0.1808127698090327,2155,642,0.1644256656962617,3351,948,0.19191036563223834,349,0.8,1.7,5038,2075,2963
952,2247,0,0.0,917,0,0.0,1330,0,0.0,350,0.8,1.9,118,40,78
929,2216,0,0.0,884,0,0.0,1332,0,0.0,351,0.0,1.1,100,35,65
820,2048,0,0.0,797,0,0.0,1251,0,0.0,352,0.0,1.3,42,13,29
544,1529,0,0.0,628,0,0.0,901,0,0.0,353,0.0,1.5,25,9,16
1174,2659,0,0.0,1044,0,0.0,1615,0,0.0,354,0.0,1.7,170,75,95
1282,2947,0,0.0,1194,0,0.0,1753,0,0.0,355,0.0,1.9,92,42,50
1254,2904,0,0.0,1170,0,0.0,1734,0,0.0,356,0.8,1.1,81,34,47
5000,10044,78,0.17156018776490717,4038,31,0.18639651602651958,6006,47,0.16177452444341803,357,0.8,1.3,349,139,210
806,1998,0,0.0,781,0,0.0,1217,0,0.0,358,0.8,1.5,39,10,29
5000,9076,335,0.24893953708968428,3638,135,0.22814990408089508,5438,200,0.26297253937061715,359,0.8,1.7,1198,483,715
1023,2454,0,0.0,985,0,0.0,1469,0,0.0,360,0.8,1.9,37,17,20
436,1309,0,0.0,532,0,0.0,777,0,0.0,361,0.0,1.1,36,13,23
964,2304,0,0.0,924,0,0.0,1380,0,0.0,362,0.0,1.3,75,25,50
1050,2547,0,0.0,996,0,0.0,1551,0,0.0,363,0.0,1.5,77,36,41
1119,2732,0,0.0,1101,0,0.0,1631,0,0.0,364,0.0,1.7,70,31,39
1374,3046,0,0.0,1254,0,0.0,1792,0,0.0,365,0.0,1.9,103,46,57
495,1404,0,0.0,570,0,0.0,834,0,0.0,366,0.8,1.1,40,12,28
1742,3909,0,0.0,1548,0,0.0,2361,0,0.0,367,0.8,1.3,78,27,51
1043,2447,0,0.0,955,0,0.0,1492,0,0.0,368,0.8,1.5,51,23,28
399,1239,0,0.0,491,0,0.0,748,0,0.0,369,0.8,1.7,30,9,21
631,1712,0,0.0,668,0,0.0,1044,0,0.0,370,0.8,1.9,23,10,13
1202,2728,0,0.0,1087,0,0.0,1641,0,0.0,371,0.0,1.1,77,37,40
355,1113,0,0.0,426,0,0.0,687,0,0.0,372,0.0,1.3,36,13,23
605,1668,0,0.0,678,0,0.0,990,0,0.0,373,0.0,1.5,40,15,25
1178,2859,0,0.0,1100,0,0.0,1759,0,0.0,374,0.0,1.7,52,21,31
3513,7151,0,0.0,2825,0,0.0,4326,0,0.0,375,0.0,1.9,284,112,172
5000,8263,639,0.24795201734579053,3334,250,0.2560587793115256,4929,389,0.24274201608246437,376,0.8,1.1,2429,919,1510
1121,2682,0,0.0,1073,0,0.0,1609,0,0.0,377,0.8,1.3,83,34,49
693,1751,0,0.0,718,0,0.0,1033,0,0.0,378,0.8,1.5,30,8,22
5000,9287,453,0.1854177578307505,3789,192,0.17377300357369604,5498,261,0.19398401383594008,379,0.8,1.7,1341,525,816
5000,8285,830,0.22553544198657452,3385,328,0.23251392874800236,4900,502,0.2209757932659601,380,0.8,1.9,2153,855,1298
397,1243,0,0.0,505,0,0.0,738,0,0.0,381,0.0,1.1,11,7,4
597,1604,0,0.0,636,0,0.0,968,0,0.0,382,0.0,1.3,27,10,17
1215,2846,0,0.0,1108,0,0.0,1738,0,0.0,383,0.0,1.5,56,25,31
515,1490,0,0.0,583,0,0.0,907,0,0.0,384,0.0,1.7,35,12,23
485,1455,0,0.0,590,0,0.0,865,0,0.0,385,0.0,1.9,25,5,20
5000,5185,1518,0.16532563258159727,2049,612,0.1675370243128481,3136,906,0.16383184478962662,386,0.8,1.1,5282,2097,3185
565,1563,0,0.0,617,0,0.0,946,0,0.0,387,0.8,1.3,27,12,15
5000,6533,1174,0.17717624955061423,2593,449,0.18882099404318053,3940,725,0.16996453882349385,388,0.8,1.5,3995,1577,2418
1442,3202,0,0.0,1271,0,0.0,1931,0,0.0,389,0.8,1.7,83,37,46
1606,3705,0,0.0,1496,0,0.0,2209,0,0.0,390,0.8,1.9,39,13,26
359,1215,0,0.0,489,0,0.0,726,0,0.0,391,0.0,1.1,25,5,20
242,957,0,0.0,370,0,0.0,587,0,0.0,392,0.0,1.3,14,5,9
1424,3209,0,0.0,1273,0,0.0,1936,0,0.0,393,0.0,1.5,79,28,51
1953,4203,0,0.0,1649,0,0.0,2554,0,0.0,394,0.0,1.7,186,77,109
946,2215,0,0.0,868,0,0.0,1347,0,0.0,395,0.0,1.9,115,47,68
704,1834,0,0.0,703,0,0.0,1131,0,0.0,396,0.8,1.1,45,16,29
5000,5513,1285,0.17407095032514366,2260,528,0.17802782084547164,3253,757,0.17131107234002713,397,0.8,1.3,4825,1938,2887
414,1241,0,0.0,510,0,0.0,731,0,0.0,398,0.8,1.5,12,7,5
5000,8392,677,0.18653297134819405,3317,253,0.17524232098137257,5075,424,0.1932700811189626,399,0.8,1.7,2351,915,1436
438,1323,0,0.0,567,0,0.0,756,0,0.0,400,0.8,1.9,25,8,17
1446,3183,0,0.0,1275,0,0.0,1908,0,0.0,401,0.0,1.1,91,39,52
1045,2452,0,0.0,985,0,0.0,1467,0,0.0,402,0.0,1.3,63,24,39
2729,5858,0,0.0,2347,0,0.0,3511,0,0.0,403,0.0,1.5,93,35,58
1735,3773,0,0.0,1497,0,0.0,2276,0,0.0,404,0.0,1.7,133,56,77
902,2249,0,0.0,916,0,0.0,1333,0,0.0,405,0.0,1.9,28,12,16
5000,6397,1376,0.19057314239188727,2554,530,0.1884536439514863,3843,846,0.1919009605637696,406,0.8,1.1,4093,1645,2448
5000,8596,581,0.21226002875591884,3408,245,0.19861153589261868,5188,336,0.22221205480207523,407,0.8,1.3,1959,800,1159
992,2402,0,0.0,974,0,0.0,1428,0,0.0,408,0.8,1.5,73,31,42
517,1458,0,0.0,586,0,0.0,872,0,0.0,409,0.8,1.7,39,13,26
1711,3714,0,0.0,1505,0,0.0,2209,0,0.0,410,0.8,1.9,143,62,81
378,1208,0,0.0,480,0,0.0,728,0,0.0,411,0.0,1.1,34,9,25
998,2359,0,0.0,914,0,0.0,1445,0,0.0,412,0.0,1.3,82,26,56
1192,2573,0,0.0,1084,0,0.0,1489,0,0.0,413,0.0,1.5,210,89,121
499,1420,0,0.0,553,0,0.0,867,0,0.0,414,0.0,1.7,32,16,16
1551,3538,0,0.0,1400,0,0.0,2138,0,0.0,415,0.0,1.9,139,55,84
5000,5823,1106,0.19280655149470458,2349,429,0.19173153989722777,3474,677,0.19348776268424317,416,0.8,1.1,4663,1929,2734
1083,2576,0,0.0,1058,0,0.0,1518,0,0.0,417,0.8,1.3,67,29,38
930,2177,0,0.0,879,0,0.0,1298,0,0.0,418,0.8,1.5,65,31,34
5000,9587,183,0.23701878689030348,3874,74,0.23013657952049416,5713,109,0.24169111115971542,419,0.8,1.7,654,248,406
366,1163,0,0.0,470,0,0.0,693,0,0.0,420,0.8,1.9,21,9,12
739,1890,0,0.0,784,0,0.0,1106,0,0.0,421,0.0,1.1,49,16,33
1732,3654,0,0.0,1422,0,0.0,2232,0,0.0,422,0.0,1.3,154,69,85
3087,6595,0,0.0,2635,0,0.0,3960,0,0.0,423,0.0,1.5,202,82,120
1645,3561,0,0.0,1436,0,0.0,2125,0,0.0,424,0.0,1.7,174,73,101
541,1535,0,0.0,620,0,0.0,915,0,0.0,425,0.0,1.9,39,16,23
5000,6075,1216,0.16379251306278522,2432,476,0.15587584898265155,3643,740,0.16888485374135773,426,0.8,1.1,4319,1774,2545
5000,10237,1,0.05,4047,1,0.05,6190,0,0.0,427,0.8,1.3,128,54,74
526,1490,0,0.0,624,0,0.0,866,0,0.0,428,0.8,1.5,60,27,33
985,2425,0,0.0,1001,0,0.0,1424,0,0.0,429,0.8,1.7,50,22,28
5000,6371,1298,0.19514886677581095,2530,534,0.19041348443907244,3841,764,0.19845867589599206,430,0.8,1.9,4264,1699,2565
1325,2998,0,0.0,1140,0,0.0,1858,0,0.0,431,0.0,1.1,106,40,66
1699,3916,0,0.0,1588,0,0.0,2328,0,0.0,432,0.0,1.3,74,24,50
698,1872,0,0.0,726,0,0.0,1146,0,0.0,433,0.0,1.5,47,14,33
719,1794,0,0.0,688,0,0.0,1106,0,0.0,434,0.0,1.7,58,18,40
1411,3180,0,0.0,1266,0,0.0,1914,0,0.0,435,0.0,1.9,98,38,60
713,1777,0,0.0,716,0,0.0,1061,0,0.0,436,0.8,1.1,39,12,27
5000,5135,1540,0.17494670430728834,2031,600,0.17693273303261747,3104,940,0.1736790263975038,437,0.8,1.3,5238,2120,3118
773,2000,0,0.0,775,0,0.0,1225,0,0.0,438,0.8,1.5,38,17,21
5000,4986,1527,0.16361271733271932,1962,627,0.16385469741632597,3024,900,0.1634441378744734,439,0.8,1.7,5480,2220,3260
5000,10042,89,0.24843970484802644,4057,37,0.27195506409530473,5985,52,0.23170762230669384,440,0.8,1.9,393,155,238
1111,2675,0,0.0,1108,0,0.0,1567,0,0.0,441,0.0,1.1,79,40,39
1099,2697,0,0.0,1086,0,0.0,1611,0,0.0,442,0.0,1.3,56,23,33
583,1606,0,0.0,636,0,0.0,970,0,0.0,443,0.0,1.5,20,11,9
673,1798,0,0.0,740,0,0.0,1058,0,0.0,444,0.0,1.7,31,13,18
999,2324,0,0.0,910,0,0.0,1414,0,0.0,445,0.0,1.9,68,24,44
5000,8530,669,0.19961155750511136,3458,268,0.21231584010244722,5072,401,0.1911209147717297,446,0.8,1.1,1954,801,1153
1241,2786,0,0.0,1080,0,0.0,1706,0,0.0,447,0.8,1.3,64,29,35
5000,5365,1546,0.1806841931212632,2124,589,0.18938427032431507,3241,957,0.17532960015094193,448,0.8,1.5,5074,2044,3030
528,1450,0,0.0,592,0,0.0,858,0,0.0,449,0.8,1.7,34,12,22
1170,2789,0,0.0,1126,0,0.0,1663,0,0.0,450,0.8,1.9,46,22,24
1994,4270,0,0.0,1698,0,0.0,2572,0,0.0,451,0.0,1.1,206,91,115
933,2190,0,0.0,888,0,0.0,1302,0,0.0,452,0.0,1.3,98,45,53
1136,2639,0,0.0,1076,0,0.0,1563,0,0.0,453,0.0,1.5,137,48,89
1040,2377,0,0.0,955,0,0.0,1422,0,0.0,454,0.0,1.7,85,30,55
771,1926,0,0.0,788,0,0.0,1138,0,0.0,455,0.0,1.9,41,11,30
1199,2745,0,0.0,1071,0,0.0,1674,0,0.0,456,0.8,1.1,80,30,50
667,1811,0,0.0,731,0,0.0,1080,0,0.0,457,0.8,1.3,54,21,33
5000,9457,293,0.21465399520463121,3753,119,0.2128329971003289,5704,174,0.21589939045987244,458,0.8,1.5,1111,478,633
5000,9760,243,0.21936024221054373,3919,87,0.19572134774967398,5841,156,0.23254347181372118,459,0.8,1.7,772,297,475
1291,2978,0,0.0,1200,0,0.0,1778,0,0.0,460,0.8,1.9,99,39,60
644,1664,0,0.0,684,0,0.0,980,0,0.0,461,0.0,1.1,32,16,16
1005,2442,0,0.0,961,0,0.0,1481,0,0.0,462,0.0,1.3,128,50,78
404,1286,0,0.0,527,0,0.0,759,0,0.0,463,0.0,1.5,13,4,9
3406,7015,0,0.0,2840,0,0.0,4175,0,0.0,464,0.0,1.7,330,138,192
1115,2471,0,0.0,969,0,0.0,1502,0,0.0,465,0.0,1.9,99,47,52
5000,6609,1095,0.19471081559798858,2755,442,0.1950026861246283,3854,653,0.19451325545591397,466,0.8,1.1,3853,1546,2307
545,1544,0,0.0,626,0,0.0,918,0,0.0,467,0.8,1.3,52,17,35
428,1349,0,0.0,545,0,0.0,804,0,0.0,468,0.8,1.5,26,6,20
5000,10274,82,0.18326150946307568,4069,34,0.1851217753461895,6205,48,0.18194382112920338,469,0.8,1.7,247,100,147
5000,8376,785,0.20084517308832328,3398,311,0.1974658067011313,4978,474,0.20306243668835813,470,0.8,1.9,2147,831,1316
1068,2501,0,0.0,988,0,0.0,1513,0,0.0,471,0.0,1.1,100,40,60
1293,2942,0,0.0,1189,0,0.0,1753,0,0.0,472,0.0,1.3,110,54,56
1189,2804,0,0.0,1122,0,0.0,1682,0,0.0,473,0.0,1.5,80,36,44
958,2329,0,0.0,949,0,0.0,1380,0,0.0,474,0.0,1.7,157,65,92
630,1624,0,0.0,650,0,0.0,974,0,0.0,475,0.0,1.9,57,20,37
5000,8615,618,0.20199376929676596,3418,233,0.20368963011347413,5197,385,0.20096744314016068,476,0.8,1.1,1876,702,1174
5000,9967,65,0.19788854193024605,4001,29,0.13232827427116062,5966,36,0.2507009797667315,477,0.8,1.3,328,132,196
652,1757,0,0.0,736,0,0.0,1021,0,0.0,478,0.8,1.5,72,31,41
630,1638,0,0.0,644,0,0.0,994,0,0.0,479,0.8,1.7,53,16,37
5000,7159,981,0.20876245135167606,2940,404,0.20276322408341574,4219,577,0.21296295016688752,480,0.8,1.9,3434,1397,2037
479,1377,0,0.0,535,0,0.0,842,0,0.0,481,0.0,1.1,39,19,20
662,1781,0,0.0,713,0,0.0,1068,0,0.0,482,0.0,1.3,43,16,27
1075,2440,0,0.0,1021,0,0.0,1419,0,0.0,483,0.0,1.5,94,32,62
899,2260,0,0.0,903,0,0.0,1357,0,0.0,484,0.0,1.7,59,20,39
799,2009,0,0.0,856,0,0.0,1153,0,0.0,485,0.0,1.9,37,17,20
1089,2552,0,0.0,1042,0,0.0,1510,0,0.0,486,0.8,1.1,60,13,47
868,2189,0,0.0,876,0,0.0,1313,0,0.0,487,0.8,1.3,30,11,19
5000,9569,269,0.21938605132466707,3809,117,0.22652989112030883,5760,152,0.21388717463986387,488,0.8,1.5,734,314,420
5000,9566,194,0.24510349250322774,3842,76,0.2483477808483589,5724,118,0.2430139508572111,489,0.8,1.7,969,365,604
5000,6956,1080,0.17116645003426226,2739,440,0.16644205771677179,4217,640,0.174414469752537,490,0.8,1.9,3475,1384,2091
962,2243,0,0.0,903,0,0.0,1340,0,0.0,491,0.0,1.1,86,39,47
748,1922,0,0.0,761,0,0.0,1161,0,0.0,492,0.0,1.3,71,25,46
2011,4424,0,0.0,1780,0,0.0,2644,0,0.0,493,0.0,1.5,173,64,109
1536,3416,0,0.0,1396,0,0.0,2020,0,0.0,494,0.0,1.7,91,32,59
1776,3827,0,0.0,1521,0,0.0,2306,0,0.0,495,0.0,1.9,187,76,111
1119,2645,0,0.0,1064,0,0.0,1581,0,0.0,496,0.8,1.1,44,15,29
469,1370,0,0.0,514,0,0.0,856,0,0.0,497,0.8,1.3,32,13,19
1404,3245,0,0.0,1306,0,0.0,1939,0,0.0,498,0.8,1.5,88,34,54
719,1833,0,0.0,729,0,0.0,1104,0,0.0,499,0.8,1.7,46,18,28
480,1433,0,0.0,570,0,0.0,863,0,0.0,500,0.8,1.9,27,13,14
926,2234,0,0.0,883,0,0.0,1351,0,0.0,501,0.0,1.1,102,42,60
1102,2525,0,0.0,1009,0,0.0,1516,0,0.0,502,0.0,1.3,97,45,52
871,2161,0,0.0,851,0,0.0,1310,0,0.0,503,0.0,1.5,75,33,42
1779,3985,0,0.0,1571,0,0.0,2414,0,0.0,504,0.0,1.7,117,50,67
471,1370,0,0.0,567,0,0.0,803,0,0.0,505,0.0,1.9,26,10,16
846,2095,0,0.0,831,0,0.0,1264,0,0.0,506,0.8,1.1,39,18,21
5000,4764,1517,0.17456896344709785,1952,601,0.17867971899894947,2812,916,0.17187184108174539,507,0.8,1.3,5717,2280,3437
860,2157,0,0.0,885,0,0.0,1272,0,0.0,508,0.8,1.5,83,36,47
5000,8330,691,0.17648713054001564,3376,259,0.172863692697683,4954,432,0.1786595157278956,509,0.8,1.7,2117,832,1285
5000,5125,1578,0.17992185195791038,2021,628,0.1835778973965647,3104,950,0.17750501349951575,510,0.8,1.9,5387,2208,3179
653,1753,0,0.0,691,0,0.0,1062,0,0.0,511,0.0,1.1,29,13,16
778,2050,0,0.0,848,0,0.0,1202,0,0.0,512,0.0,1.3,46,17,29
673,1776,0,0.0,727,0,0.0,1049,0,0.0,513,0.0,1.5,62,24,38
593,1675,0,0.0,650,0,0.0,1025,0,0.0,514,0.0,1.7,29,5,24
1551,3428,0,0.0,1345,0,0.0,2083,0,0.0,515,0.0,1.9,67,17,50
5000,5255,1490,0.1723899612791505,2150,591,0.17365606767297723,3105,899,0.17155762659755813,516,0.8,1.1,5147,2039,3108
1573,3435,0,0.0,1392,0,0.0,2043,0,0.0,517,0.8,1.3,82,38,44
984,2358,0,0.0,918,0,0.0,1440,0,0.0,518,0.8,1.5,86,31,55
851,2132,0,0.0,874,0,0.0,1258,0,0.0,519,0.8,1.7,44,17,27
5000,10365,2,0.05,4147,0,0.0,6218,2,0.05,520,0.8,1.9,100,36,64
1148,2714,0,0.0,1098,0,0.0,1616,0,0.0,521,0.0,1.1,96,35,61
728,1907,0,0.0,755,0,0.0,1152,0,0.0,522,0.0,1.3,67,26,41
1081,2597,0,0.0,1024,0,0.0,1573,0,0.0,523,0.0,1.5,69,23,46
371,1209,0,0.0,492,0,0.0,717,0,0.0,524,0.0,1.7,36,13,23
924,2305,0,0.0,862,0,0.0,1443,0,0.0,525,0.0,1.9,34,13,21
5000,5983,1181,0.21604156412571004,2448,487,0.21742231974336398,3535,694,0.2150726477196618,526,0.8,1.1,4447,1841,2606
5000,5814,1374,0.1782624423272952,2401,584,0.18820437687401223,3413,790,0.17091296159908934,527,0.8,1.3,4662,1922,2740
642,1637,0,0.0,673,0,0.0,964,0,0.0,528,0.8,1.5,73,35,38
5000,5815,1381,0.16915758583247448,2331,550,0.16785777308647407,3484,831,0.17001787104342544,529,0.8,1.7,4396,1750,2646
5000,8603,586,0.21365034958393828,3465,237,0.23104040342642884,5138,349,0.2018410580060865,530,0.8,1.9,1930,773,1157
471,1408,0,0.0,577,0,0.0,831,0,0.0,531,0.0,1.1,25,11,14
833,2118,0,0.0,838,0,0.0,1280,0,0.0,532,0.0,1.3,38,16,22
1297,2857,0,0.0,1118,0,0.0,1739,0,0.0,533,0.0,1.5,160,59,101
539,1494,0,0.0,606,0,0.0,888,0,0.0,534,0.0,1.7,47,21,26
610,1631,0,0.0,644,0,0.0,987,0,0.0,535,0.0,1.9,40,15,25
3744,7832,0,0.0,3171,0,0.0,4661,0,0.0,536,0.8,1.1,85,38,47
5000,8762,556,0.21334521484530733,3522,216,0.20822234948921542,5240,340,0.2165997410715305,537,0.8,1.3,1821,736,1085
5000,7272,1165,0.20720375520341433,2865,473,0.19659294801752167,4407,692,0.21445651791862713,538,0.8,1.5,3177,1273,1904
377,1186,0,0.0,485,0,0.0,701,0,0.0,539,0.8,1.7,14,4,10
671,1822,0,0.0,737,0,0.0,1085,0,0.0,540,0.8,1.9,29,6,23
892,2151,0,0.0,885,0,0.0,1266,0,0.0,541,0.0,1.1,80,26,54
920,2313,0,0.0,960,0,0.0,1353,0,0.0,542,0.0,1.3,70,25,45
1267,2885,0,0.0,1156,0,0.0,1729,0,0.0,543,0.0,1.5,127,56,71
1450,3287,0,0.0,1297,0,0.0,1990,0,0.0,544,0.0,1.7,60,21,39
730,1819,0,0.0,703,0,0.0,1116,0,0.0,545,0.0,1.9,43,20,23
938,2327,0,0.0,935,0,0.0,1392,0,0.0,546,0.8,1.1,50,16,34
5000,6893,931,0.19649816648733906,2741,387,0.19512172682388168,4152,544,0.19747736161557056,547,0.8,1.3,3497,1402,2095
1618,3513,0,0.0,1391,0,0.0,2122,0,0.0,548,0.8,1.5,115,48,67
594,1621,0,0.0,622,0,0.0,999,0,0.0,549,0.8,1.7,30,15,15
2464,5371,0,0.0,2094,0,0.0,3277,0,0.0,550,0.8,1.9,57,18,39
704,1821,0,0.0,725,0,0.0,1096,0,0.0,551,0.0,1.1,19,8,11
1363,3167,0,0.0,1271,0,0.0,1896,0,0.0,552,0.0,1.3,67,26,41
1054,2534,0,0.0,947,0,0.0,1587,0,0.0,553,0.0,1.5,64,31,33
893,2214,0,0.0,898,0,0.0,1316,0,0.0,554,0.0,1.7,51,19,32
1413,3232,0,0.0,1283,0,0.0,1949,0,0.0,555,0.0,1.9,98,45,53
5000,9315,333,0.15165255879054657,3774,124,0.13600823647439142,5541,209,0.1609343576766865,556,0.8,1.1,972,369,603
1097,2571,0,0.0,1024,0,0.0,1547,0,0.0,557,0.8,1.3,109,41,68
5000,8206,650,0.20089193646018014,3308,251,0.20076398703511694,4898,399,0.20097242594812695,558,0.8,1.5,2228,893,1335
5000,8684,598,0.22810045418600847,3480,227,0.21204005513028598,5204,371,0.23792716735487365,559,0.8,1.7,1693,649,1044
843,2080,0,0.0,838,0,0.0,1242,0,0.0,560,0.8,1.9,49,16,33
1686,3618,0,0.0,1463,0,0.0,2155,0,0.0,561,0.0,1.1,187,73,114
552,1514,0,0.0,597,0,0.0,917,0,0.0,562,0.0,1.3,38,18,20
2100,4563,0,0.0,1853,0,0.0,2710,0,0.0,563,0.0,1.5,137,53,84
469,1354,0,0.0,563,0,0.0,791,0,0.0,564,0.0,1.7,25,11,14
1139,2743,0,0.0,1111,0,0.0,1632,0,0.0,565,0.0,1.9,66,29,37
337,1111,0,0.0,422,0,0.0,689,0,0.0,566,0.8,1.1,9,6,3
1625,3633,0,0.0,1408,0,0.0,2225,0,0.0,567,0.8,1.3,89,41,48
512,1495,0,0.0,593,0,0.0,902,0,0.0,568,0.8,1.5,23,12,11
5000,9546,325,0.22641746850097758,3870,152,0.20707210137621698,5676,173,0.2434145540672412,569,0.8,1.7,996,425,571
5000,8762,463,0.2106820387758889,3435,194,0.20856229064528214,5327,269,0.21221077906338967,570,0.8,1.9,1760,696,1064
1530,3513,0,0.0,1399,0,0.0,2114,0,0.0,571,0.0,1.1,52,15,37
462,1362,0,0.0,563,0,0.0,799,0,0.0,572,0.0,1.3,17,7,10
1244,2832,0,0.0,1171,0,0.0,1661,0,0.0,573,0.0,1.5,83,36,47
1061,2604,0,0.0,1028,0,0.0,1576,0,0.0,574,0.0,1.7,67,25,42
1009,2409,0,0.0,947,0,0.0,1462,0,0.0,575,0.0,1.9,72,29,43
5000,7960,803,0.17684834197380112,3113,325,0.17103094287091417,4847,478,0.18080368655212375,576,0.8,1.1,2348,958,1390
5000,10615,1,0.013868591610225411,4277,1,0.013868591610225411,6338,0,0.0,577,0.8,1.3,57,22,35
5000,8546,592,0.19390759804163882,3323,225,0.1870271621822303,5223,367,0.19812584890912358,578,0.8,1.5,1922,744,1178
5000,6999,969,0.1804542379546114,2808,405,0.16869128340549921,4191,564,0.18890104042338873,579,0.8,1.7,3329,1337,1992
5000,9499,385,0.16236620777578542,3766,155,0.17451550863510545,5733,230,0.15417863545754817,580,0.8,1.9,1123,435,688
501,1474,0,0.0,598,0,0.0,876,0,0.0,581,0.0,1.1,42,19,23
651,1764,0,0.0,718,0,0.0,1046,0,0.0,582,0.0,1.3,35,14,21
1071,2535,0,0.0,1022,0,0.0,1513,0,0.0,583,0.0,1.5,83,36,47
1038,2481,0,0.0,1011,0,0.0,1470,0,0.0,584,0.0,1.7,65,21,44
805,1991,0,0.0,795,0,0.0,1196,0,0.0,585,0.0,1.9,86,38,48
1343,2982,0,0.0,1139,0,0.0,1843,0,0.0,586,0.8,1.1,101,40,61
1830,4108,0,0.0,1636,0,0.0,2472,0,0.0,587,0.8,1.3,66,31,35
5000,10503,7,0.25813409762476486,4283,2,0.3550639646905665,6220,5,0.21936215079844418,588,0.8,1.5,138,46,92
900,2222,0,0.0,883,0,0.0,1339,0,0.0,589,0.8,1.7,46,18,28
593,1563,0,0.0,642,0,0.0,921,0,0.0,590,0.8,1.9,74,34,40
2840,5938,0,0.0,2411,0,0.0,3527,0,0.0,591,0.0,1.1,157,72,85
720,1879,0,0.0,735,0,0.0,1144,0,0.0,592,0.0,1.3,84,36,48
1034,2545,0,0.0,1029,0,0.0,1516,0,0.0,593,0.0,1.5,58,25,33
649,1654,0,0.0,640,0,0.0,1014,0,0.0,594,0.0,1.7,68,32,36
1224,2937,0,0.0,1193,0,0.0,1744,0,0.0,595,0.0,1.9,49,22,27
5000,7602,896,0.18047919452563568,3011,349,0.18376436251263836,4591,547,0.17838317326884578,596,0.8,1.1,2882,1136,1746
5000,9614,197,0.23554066066391824,3808,86,0.24764394199224463,5806,111,0.2261633435987285,597,0.8,1.3,921,364,557
5000,4923,1698,0.1730564774135955,1942,691,0.17676327614373272,2981,1007,0.17051288464048242,598,0.8,1.5,5676,2206,3470
1149,2627,0,0.0,1059,0,0.0,1568,0,0.0,599,0.8,1.7,82,24,58
5000,10003,158,0.17703521336280256,4019,71,0.16111154492639032,5984,87,0.1900303910522883,600,0.8,1.9,446,207,239
1087,2536,0,0.0,1025,0,0.0,1511,0,0.0,601,0.0,1.1,139,43,96
1122,2665,0,0.0,1037,0,0.0,1628,0,0.0,602,0.0,1.3,84,43,41
659,1738,0,0.0,690,0,0.0,1048,0,0.0,603,0.0,1.5,40,13,27
1608,3530,0,0.0,1441,0,0.0,2089,0,0.0,604,0.0,1.7,133,59,74
1457,3309,0,0.0,1296,0,0.0,2013,0,0.0,605,0.0,1.9,76,25,51
717,1833,0,0.0,738,0,0.0,1095,0,0.0,606,0.8,1.1,63,26,37
5000,7453,910,0.19892795594640467,3003,362,0.1823101659486982,4450,548,0.2099054011638675,607,0.8,1.3,2763,1101,1662
1493,3313,0,0.0,1322,0,0.0,1991,0,0.0,608,0.8,1.5,70,28,42
5000,4866,1433,0.16386704270161032,1925,562,0.16505381823690848,2941,871,0.16310129315989097,609,0.8,1.7,5699,2224,3475
682,1800,0,0.0,709,0,0.0,1091,0,0.0,610,0.8,1.9,30,11,19
702,1867,0,0.0,742,0,0.0,1125,0,0.0,611,0.0,1.1,40,17,23
919,2282,0,0.0,922,0,0.0,1360,0,0.0,612,0.0,1.3,33,18,15
555,1508,0,0.0,597,0,0.0,911,0,0.0,613,0.0,1.5,43,20,23
1086,2586,0,0.0,1059,0,0.0,1527,0,0.0,614,0.0,1.7,95,35,60
594,1641,0,0.0,678,0,0.0,963,0,0.0,615,0.0,1.9,57,24,33
5000,7321,856,0.17058206868890813,2951,354,0.1808263451264196,4370,502,0.16335801717719683,616,0.8,1.1,3269,1290,1979
5000,5387,1392,0.1954898289044866,2171,548,0.18649997603172777,3216,844,0.20132684238111204,617,0.8,1.3,5222,2078,3144
5000,6517,1062,0.1991286195336669,2663,419,0.19831980522529055,3854,643,0.19965566960397743,618,0.8,1.5,3870,1540,2330
922,2241,0,0.0,884,0,0.0,1357,0,0.0,619,0.8,1.7,32,14,18
1304,2869,0,0.0,1123,0,0.0,1746,0,0.0,620,0.8,1.9,107,46,61
725,1915,0,0.0,769,0,0.0,1146,0,0.0,621,0.0,1.1,29,8,21
1577,3450,0,0.0,1395,0,0.0,2055,0,0.0,622,0.0,1.3,181,82,99
408,1296,0,0.0,512,0,0.0,784,0,0.0,623,0.0,1.5,17,6,11
1380,3188,0,0.0,1295,0,0.0,1893,0,0.0,624,0.0,1.7,58,22,36
1036,2599,0,0.0,1043,0,0.0,1556,0,0.0,625,0.0,1.9,81,41,40
450,1345,0,0.0,526,0,0.0,819,0,0.0,626,0.8,1.1,33,8,25
5000,8177,744,0.18991324535028092,3279,326,0.19811729244173357,4898,418,0.18351487369522454,627,0.8,1.3,2277,975,1302
5000,7477,906,0.23106517488480252,2970,354,0.23466669726239714,4507,552,0.22875550292525798,628,0.8,1.5,2962,1158,1804
807,2070,0,0.0,809,0,0.0,1261,0,0.0,629,0.8,1.7,56,19,37
5000,9361,335,0.21676138584827925,3699,146,0.21181687606348265,5662,189,0.2205809542534661,630,0.8,1.9,1085,438,647
779,1920,0,0.0,735,0,0.0,1185,0,0.0,631,0.0,1.1,60,25,35
1158,2672,0,0.0,1032,0,0.0,1640,0,0.0,632,0.0,1.3,99,45,54
829,2072,0,0.0,846,0,0.0,1226,0,0.0,633,0.0,1.5,42,13,29
860,2165,0,0.0,857,0,0.0,1308,0,0.0,634,0.0,1.7,54,25,29
633,1669,0,0.0,654,0,0.0,1015,0,0.0,635,0.0,1.9,42,17,25
619,1645,0,0.0,659,0,0.0,986,0,0.0,636,0.8,1.1,27,10,17
5000,10439,23,0.29752199389769796,4188,9,0.2744720573527952,6251,14,0.3123398102479925,637,0.8,1.3,222,79,143
341,1181,0,0.0,465,0,0.0,716,0,0.0,638,0.8,1.5,12,5,7
1133,2596,0,0.0,1103,0,0.0,1493,0,0.0,639,0.8,1.7,88,38,50
5000,4637,1669,0.16638620859220127,1878,661,0.16940335024171296,2759,1008,0.16440770598274973,640,0.8,1.9,5863,2365,3498
461,1365,0,0.0,551,0,0.0,814,0,0.0,641,0.0,1.1,37,8,29
717,1815,0,0.0,750,0,0.0,1065,0,0.0,642,0.0,1.3,82,35,47
765,1968,0,0.0,784,0,0.0,1184,0,0.0,643,0.0,1.5,53,24,29
1788,3866,0,0.0,1537,0,0.0,2329,0,0.0,644,0.0,1.7,124,53,71
757,1963,0,0.0,777,0,0.0,1186,0,0.0,645,0.0,1.9,21,7,14
334,1098,0,0.0,426,0,0.0,672,0,0.0,646,0.8,1.1,26,12,14
5000,4751,1616,0.16902990882188293,1890,642,0.17233979680353692,2861,974,0.16684823727750733,647,0.8,1.3,5739,2302,3437
1083,2701,0,0.0,1098,0,0.0,1603,0,0.0,648,0.8,1.5,79,31,48
1289,3020,0,0.0,1221,0,0.0,1799,0,0.0,649,0.8,1.7,55,24,31
5000,5390,1471,0.20191642762298742,2170,605,0.20429162832893566,3220,866,0.2002570784000097,650,0.8,1.9,4908,1985,2923
1151,2740,0,0.0,1099,0,0.0,1641,0,0.0,651,0.0,1.1,83,36,47
2825,6070,0,0.0,2386,0,0.0,3684,0,0.0,652,0.0,1.3,105,41,64
866,2068,0,0.0,818,0,0.0,1250,0,0.0,653,0.0,1.5,74,28,46
2009,4270,0,0.0,1685,0,0.0,2585,0,0.0,654,0.0,1.7,213,96,117
1081,2492,0,0.0,1002,0,0.0,1490,0,0.0,655,0.0,1.9,58,27,31
897,2280,0,0.0,899,0,0.0,1381,0,0.0,656,0.8,1.1,35,12,23
5000,5295,1615,0.2026107703532403,2039,637,0.20294227870107762,3256,978,0.20239484927187787,657,0.8,1.3,5292,2120,3172
5000,7308,1105,0.21031656591306097,2899,437,0.20654360579234168,4409,668,0.21278480479442985,658,0.8,1.5,3216,1258,1958
5000,8976,551,0.1903997553849395,3549,213,0.1807865633064574,5427,338,0.19645777287818414,659,0.8,1.7,1463,559,904
5000,3093,1904,0.15484415056618817,1220,759,0.15361219205231005,1873,1145,0.15566079380813877,660,0.8,1.9,7491,3049,4442
623,1660,0,0.0,673,0,0.0,987,0,0.0,661,0.0,1.1,35,13,22
681,1729,0,0.0,683,0,0.0,1046,0,0.0,662,0.0,1.3,84,36,48
1041,2544,0,0.0,1020,0,0.0,1524,0,0.0,663,0.0,1.5,39,17,22
705,1803,0,0.0,746,0,0.0,1057,0,0.0,664,0.0,1.7,33,11,22
758,1911,0,0.0,789,0,0.0,1122,0,0.0,665,0.0,1.9,53,24,29
5000,4371,1442,0.17615542459977515,1698,569,0.1719113502051854,2673,873,0.178921608254439,666,0.8,1.1,5931,2396,3535
1514,3431,0,0.0,1347,0,0.0,2084,0,0.0,667,0.8,1.3,52,20,32
2021,4464,0,0.0,1809,0,0.0,2655,0,0.0,668,0.8,1.5,77,26,51
5000,8362,684,0.20287652592063307,3300,252,0.2044756207322431,5062,432,0.20194372061386054,669,0.8,1.7,2042,773,1269
5000,6628,1028,0.1978100065286668,2614,399,0.20573397794539142,4014,629,0.19278351273649968,670,0.8,1.9,3750,1455,2295
1004,2494,0,0.0,964,0,0.0,1530,0,0.0,671,0.0,1.1,35,9,26
1328,3068,0,0.0,1246,0,0.0,1822,0,0.0,672,0.0,1.3,77,26,51
748,1888,0,0.0,730,0,0.0,1158,0,0.0,673,0.0,1.5,70,29,41
1358,3088,0,0.0,1225,0,0.0,1863,0,0.0,674,0.0,1.7,105,38,67
706,1904,0,0.0,752,0,0.0,1152,0,0.0,675,0.0,1.9,41,17,24
5000,6777,1121,0.2367445327096327,2681,453,0.23782109477602367,4096,668,0.23601446891311287,676,0.8,1.1,3656,1486,2170
565,1584,0,0.0,663,0,0.0,921,0,0.0,677,0.8,1.3,33,10,23
1079,2617,0,0.0,1055,0,0.0,1562,0,0.0,678,0.8,1.5,44,16,28
5000,5955,1387,0.17090217067044172,2455,554,0.16088298991774266,3500,833,0.17756558740152853,679,0.8,1.7,4546,1795,2751
5000,7626,895,0.20148224037740567,2974,366,0.19969416004209423,4652,529,0.20271936212168543,680,0.8,1.9,2932,1206,1726
387,1250,0,0.0,481,0,0.0,769,0,0.0,681,0.0,1.1,22,7,15
1249,2886,0,0.0,1126,0,0.0,1760,0,0.0,682,0.0,1.3,92,32,60
1031,2530,0,0.0,1025,0,0.0,1505,0,0.0,683,0.0,1.5,68,23,45
757,1980,0,0.0,795,0,0.0,1185,0,0.0,684,0.0,1.7,27,8,19
730,1900,0,0.0,790,0,0.0,1110,0,0.0,685,0.0,1.9,47,12,35
1084,2615,0,0.0,1039,0,0.0,1576,0,0.0,686,0.8,1.1,46,18,28
5000,6424,1271,0.22573238864051798,2506,486,0.23278404457138493,3918,785,0.22136665006421058,687,0.8,1.3,4268,1680,2588
5000,10278,44,0.0825929418844707,4113,17,0.08392296379348567,6165,27,0.08175552068249836,688,0.8,1.5,140,54,86
1723,3842,0,0.0,1587,0,0.0,2255,0,0.0,689,0.8,1.7,77,33,44
1538,3564,0,0.0,1425,0,0.0,2139,0,0.0,690,0.8,1.9,118,53,65
1081,2568,0,0.0,1018,0,0.0,1550,0,0.0,691,0.0,1.1,69,32,37
534,1532,0,0.0,616,0,0.0,916,0,0.0,692,0.0,1.3,41,22,19
1339,2967,0,0.0,1215,0,0.0,1752,0,0.0,693,0.0,1.5,223,92,131
456,1377,0,0.0,560,0,0.0,817,0,0.0,694,0.0,1.7,26,13,13
1053,2433,0,0.0,980,0,0.0,1453,0,0.0,695,0.0,1.9,112,39,73
5000,9509,287,0.16807758352673424,3845,117,0.1553953634316779,5664,170,0.17680593500392014,696,0.8,1.1,887,342,545
5000,5276,1391,0.19175264629405464,2070,554,0.19195689749240621,3206,837,0.19161745493935126,697,0.8,1.3,5084,2024,3060
958,2374,0,0.0,950,0,0.0,1424,0,0.0,698,0.8,1.5,38,17,21
506,1406,0,0.0,583,0,0.0,823,0,0.0,699,0.8,1.7,35,10,25
554,1580,0,0.0,664,0,0.0,916,0,0.0,700,0.8,1.9,25,11,14
864,2110,0,0.0,856,0,0.0,1254,0,0.0,701,0.0,1.1,46,17,29
895,2256,0,0.0,920,0,0.0,1336,0,0.0,702,0.0,1.3,74,31,43
802,2024,0,0.0,806,0,0.0,1218,0,0.0,703,0.0,1.5,108,49,59
320,1132,0,0.0,448,0,0.0,684,0,0.0,704,0.0,1.7,12,5,7
830,2027,0,0.0,817,0,0.0,1210,0,0.0,705,0.0,1.9,80,26,54
5000,8496,696,0.20088008223427736,3401,288,0.1831486703326823,5095,408,0.2133963729883444,706,0.8,1.1,2199,861,1338
5000,10194,127,0.14299980895909084,4009,57,0.11765556689334944,6185,70,0.16363726321262315,707,0.8,1.3,347,152,195
645,1779,0,0.0,727,0,0.0,1052,0,0.0,708,0.8,1.5,30,12,18
5000,6876,1084,0.19950949558446474,2723,426,0.19510386363150442,4153,658,0.20236177402209563,709,0.8,1.7,3519,1392,2127
5000,3090,1878,0.142980607640725,1218,758,0.1367609846089777,1872,1120,0.14718995965685394,710,0.8,1.9,7340,2916,4424
464,1362,0,0.0,548,0,0.0,814,0,0.0,711,0.0,1.1,52,26,26
494,1415,0,0.0,583,0,0.0,832,0,0.0,712,0.0,1.3,43,20,23
597,1615,0,0.0,626,0,0.0,989,0,0.0,713,0.0,1.5,46,20,26
1180,2737,0,0.0,1052,0,0.0,1685,0,0.0,714,0.0,1.7,79,30,49
1807,3943,0,0.0,1577,0,0.0,2366,0,0.0,715,0.0,1.9,125,50,75
5000,9078,385,0.22418753502472843,3661,170,0.22219095734152708,5417,215,0.22576622435563182,716,0.8,1.1,1347,564,783
5000,7766,867,0.2012920154298858,3101,335,0.20862029797066106,4665,532,0.19667740142394646,717,0.8,1.3,2736,1079,1657
758,1980,0,0.0,798,0,0.0,1182,0,0.0,718,0.8,1.5,46,16,30
380,1234,0,0.0,453,0,0.0,781,0,0.0,719,0.8,1.7,16,7,9
5000,8895,608,0.1946815192715184,3548,238,0.19509441877272307,5347,370,0.19441592445723005,720,0.8,1.9,1560,628,932
940,2238,0,0.0,868,0,0.0,1370,0,0.0,721,0.0,1.1,64,24,40
988,2335,0,0.0,960,0,0.0,1375,0,0.0,722,0.0,1.3,88,27,61
688,1805,0,0.0,744,0,0.0,1061,0,0.0,723,0.0,1.5,45,19,26
729,1888,0,0.0,741,0,0.0,1147,0,0.0,724,0.0,1.7,41,16,25
913,2257,0,0.0,903,0,0.0,1354,0,0.0,725,0.0,1.9,53,17,36
5000,5117,1557,0.18058799223622057,2051,627,0.17855435563259853,3066,930,0.18195905691414635,726,0.8,1.1,5360,2121,3239
361,1161,0,0.0,448,0,0.0,713,0,0.0,727,0.8,1.3,24,14,10
5000,4230,1643,0.14874939402491127,1679,656,0.14944886772428734,2551,987,0.14828449559857831,728,0.8,1.5,6365,2507,3858
1174,2730,0,0.0,1124,0,0.0,1606,0,0.0,729,0.8,1.7,38,9,29
5000,8834,497,0.24178771473895405,3468,178,0.22486925048920553,5366,319,0.2512281117184375,730,0.8,1.9,1636,624,1012
1089,2591,0,0.0,1015,0,0.0,1576,0,0.0,731,0.0,1.1,73,30,43
2126,4668,0,0.0,1874,0,0.0,2794,0,0.0,732,0.0,1.3,145,54,91
1514,3399,0,0.0,1359,0,0.0,2040,0,0.0,733,0.0,1.5,139,60,79
1081,2505,0,0.0,998,0,0.0,1507,0,0.0,734,0.0,1.7,78,28,50
1047,2535,0,0.0,1015,0,0.0,1520,0,0.0,735,0.0,1.9,79,34,45
5000,8973,533,0.19135666741880686,3586,213,0.185383934800139,5387,320,0.19533226756810765,736,0.8,1.1,1514,578,936
916,2223,0,0.0,875,0,0.0,1348,0,0.0,737,0.8,1.3,98,40,58
817,2058,0,0.0,813,0,0.0,1245,0,0.0,738,0.8,1.5,58,19,39
5000,4179,1769,0.1502804151373604,1568,735,0.15434664290300593,2611,1034,0.14739001145481734,739,0.8,1.7,6217,2539,3678
663,1756,0,0.0,718,0,0.0,1038,0,0.0,740,0.8,1.9,70,33,37
1265,2971,0,0.0,1164,0,0.0,1807,0,0.0,741,0.0,1.1,89,35,54
1266,2886,0,0.0,1145,0,0.0,1741,0,0.0,742,0.0,1.3,148,57,91
448,1316,0,0.0,528,0,0.0,788,0,0.0,743,0.0,1.5,37,12,25
789,1998,0,0.0,844,0,0.0,1154,0,0.0,744,0.0,1.7,39,12,27
908,2325,0,0.0,921,0,0.0,1404,0,0.0,745,0.0,1.9,44,18,26
877,2223,0,0.0,912,0,0.0,1311,0,0.0,746,0.8,1.1,64,28,36
299,985,0,0.0,391,0,0.0,594,0,0.0,747,0.8,1.3,14,7,7
1664,3660,0,0.0,1440,0,0.0,2220,0,0.0,748,0.8,1.5,67,27,40
5000,4619,1556,0.189246704009126,1832,628,0.2032782632393673,2787,928,0.17975120918521278,749,0.8,1.7,5660,2261,3399
5000,9644,332,0.20826757626315265,3916,132,0.2299216632913098,5728,200,0.19397587882456904,750,0.8,1.9,986,396,590
1212,2791,0,0.0,1107,0,0.0,1684,0,0.0,751,0.0,1.1,135,50,85
2079,4472,0,0.0,1781,0,0.0,2691,0,0.0,752,0.0,1.3,190,85,105
512,1449,0,0.0,581,0,0.0,868,0,0.0,753,0.0,1.5,43,11,32
623,1701,0,0.0,657,0,0.0,1044,0,0.0,754,0.0,1.7,39,18,21
1400,3193,0,0.0,1281,0,0.0,1912,0,0.0,755,0.0,1.9,108,45,63
2434,5216,0,0.0,2074,0,0.0,3142,0,0.0,756,0.8,1.1,93,34,59
1024,2419,0,0.0,947,0,0.0,1472,0,0.0,757,0.8,1.3,72,27,45
5000,5624,1372,0.176254598863436,2283,545,0.17592443845638595,3341,827,0.1764721773662683,758,0.8,1.5,4664,1858,2806
469,1378,0,0.0,548,0,0.0,830,0,0.0,759,0.8,1.7,31,12,19
564,1470,0,0.0,596,0,0.0,874,0,0.0,760,0.8,1.9,40,17,23
1425,3347,0,0.0,1340,0,0.0,2007,0,0.0,761,0.0,1.1,68,30,38
1141,2638,0,0.0,1057,0,0.0,1581,0,0.0,762,0.0,1.3,71,25,46
682,1707,0,0.0,665,0,0.0,1042,0,0.0,763,0.0,1.5,92,38,54
753,1893,0,0.0,739,0,0.0,1154,0,0.0,764,0.0,1.7,51,24,27
2062,4428,0,0.0,1817,0,0.0,2611,0,0.0,765,0.0,1.9,165,55,110
5000,9203,406,0.23765307185393708,3744,164,0.23453841802657455,5459,242,0.23976382899314144,766,0.8,1.1,1338,541,797
3385,7033,0,0.0,2837,0,0.0,4196,0,0.0,767,0.8,1.3,120,49,71
464,1361,0,0.0,540,0,0.0,821,0,0.0,768,0.8,1.5,19,3,16
5000,10089,68,0.19105769597119754,4029,25,0.14566051530365778,6060,43,0.21745140566162754,769,0.8,1.7,327,139,188
585,1619,0,0.0,678,0,0.0,941,0,0.0,770,0.8,1.9,19,9,10
744,1898,0,0.0,726,0,0.0,1172,0,0.0,771,0.0,1.1,70,34,36
666,1699,0,0.0,655,0,0.0,1044,0,0.0,772,0.0,1.3,80,29,51
795,2065,0,0.0,851,0,0.0,1214,0,0.0,773,0.0,1.5,38,15,23
784,2012,0,0.0,795,0,0.0,1217,0,0.0,774,0.0,1.7,43,23,20
1059,2475,0,0.0,957,0,0.0,1518,0,0.0,775,0.0,1.9,75,35,40
5000,8235,640,0.20535317835373834,3288,249,0.22193308217059907,4947,391,0.19479462068008524,776,0.8,1.1,2240,907,1333
2197,4712,0,0.0,1870,0,0.0,2842,0,0.0,777,0.8,1.3,170,75,95
5000,9643,283,0.22044470854955414,3789,104,0.23391958627889484,5854,179,0.2126157293101608,778,0.8,1.5,839,326,513
641,1706,0,0.0,686,0,0.0,1020,0,0.0,779,0.8,1.7,20,10,10
1200,2699,0,0.0,1052,0,0.0,1647,0,0.0,780,0.8,1.9,83,33,50
539,1525,0,0.0,648,0,0.0,877,0,0.0,781,0.0,1.1,41,14,27
375,1174,0,0.0,465,0,0.0,709,0,0.0,782,0.0,1.3,21,11,10
1196,2830,0,0.0,1125,0,0.0,1705,0,0.0,783,0.0,1.5,96,40,56
773,1903,0,0.0,767,0,0.0,1136,0,0.0,784,0.0,1.7,109,52,57
1022,2479,0,0.0,993,0,0.0,1486,0,0.0,785,0.0,1.9,59,19,40
5000,9623,261,0.21630051749516238,3900,117,0.2167974199419032,5723,144,0.21589678425718556,786,0.8,1.1,845,376,469
5000,5934,1293,0.17867712201096464,2339,516,0.1825755277872559,3595,777,0.17608821933327307,787,0.8,1.3,4520,1798,2722
682,1781,0,0.0,700,0,0.0,1081,0,0.0,788,0.8,1.5,45,14,31
782,1972,0,0.0,796,0,0.0,1176,0,0.0,789,0.8,1.7,38,14,24
2679,5821,0,0.0,2378,0,0.0,3443,0,0.0,790,0.8,1.9,87,33,54
749,1993,0,0.0,808,0,0.0,1185,0,0.0,791,0.0,1.1,38,18,20
510,1391,0,0.0,558,0,0.0,833,0,0.0,792,0.0,1.3,40,8,32
1899,4179,0,0.0,1639,0,0.0,2540,0,0.0,793,0.0,1.5,124,44,80
681,1851,0,0.0,749,0,0.0,1102,0,0.0,794,0.0,1.7,44,16,28
1079,2540,0,0.0,1041,0,0.0,1499,0,0.0,795,0.0,1.9,99,37,62
842,2125,0,0.0,844,0,0.0,1281,0,0.0,796,0.8,1.1,33,15,18
573,1483,0,0.0,587,0,0.0,896,0,0.0,797,0.8,1.3,50,24,26
1156,2672,0,0.0,1073,0,0.0,1599,0,0.0,798,0.8,1.5,98,43,55
5000,4499,1817,0.1643230755682822,1795,714,0.16658244140890865,2704,1103,0.16286053050009783,799,0.8,1.7,5874,2291,3583
394,1229,0,0.0,478,0,0.0,751,0,0.0,800,0.8,1.9,40,17,23
2024,4421,0,0.0,1768,0,0.0,2653,0,0.0,801,0.0,1.1,153,58,95
1213,2823,0,0.0,1142,0,0.0,1681,0,0.0,802,0.0,1.3,68,26,42
1241,2790,0,0.0,1141,0,0.0,1649,0,0.0,803,0.0,1.5,151,58,93
1312,3032,0,0.0,1187,0,0.0,1845,0,0.0,804,0.0,1.7,106,51,55
636,1704,0,0.0,673,0,0.0,1031,0,0.0,805,0.0,1.9,48,21,27
1205,2832,0,0.0,1149,0,0.0,1683,0,0.0,806,0.8,1.1,75,30,45
5000,8200,631,0.19116871487285086,3306,223,0.19362601618773048,4894,408,0.18982563106594358,807,0.8,1.3,2345,907,1438
594,1659,0,0.0,663,0,0.0,996,0,0.0,808,0.8,1.5,29,10,19
383,1213,0,0.0,492,0,0.0,721,0,0.0,809,0.8,1.7,18,9,9
5000,7475,963,0.21098183875506696,3040,371,0.20835901606712198,4435,592,0.21262553337876203,810,0.8,1.9,2959,1187,1772
732,1838,0,0.0,732,0,0.0,1106,0,0.0,811,0.0,1.1,52,21,31
1544,3330,0,0.0,1312,0,0.0,2018,0,0.0,812,0.0,1.3,97,47,50
601,1675,0,0.0,666,0,0.0,1009,0,0.0,813,0.0,1.5,34,11,23
811,2094,0,0.0,827,0,0.0,1267,0,0.0,814,0.0,1.7,51,22,29
841,2130,0,0.0,870,0,0.0,1260,0,0.0,815,0.0,1.9,67,25,42
5000,6652,1102,0.22399834762815826,2673,444,0.2256585709392498,3979,658,0.2228780753635311,816,0.8,1.1,3810,1483,2327
5000,7524,930,0.2001674686015987,3035,370,0.20329129651577657,4489,560,0.19810351087258818,817,0.8,1.3,2908,1184,1724
689,1850,0,0.0,745,0,0.0,1105,0,0.0,818,0.8,1.5,34,12,22
5000,8947,434,0.26354572068177934,3697,169,0.25677411702297265,5250,265,0.26786421509060315,819,0.8,1.7,1525,622,903
590,1666,0,0.0,643,0,0.0,1023,0,0.0,820,0.8,1.9,17,9,8
2991,6193,0,0.0,2454,0,0.0,3739,0,0.0,821,0.0,1.1,244,92,152
608,1632,0,0.0,629,0,0.0,1003,0,0.0,822,0.0,1.3,33,15,18
1618,3504,0,0.0,1396,0,0.0,2108,0,0.0,823,0.0,1.5,221,99,122
975,2361,0,0.0,932,0,0.0,1429,0,0.0,824,0.0,1.7,62,26,36
1088,2572,0,0.0,1016,0,0.0,1556,0,0.0,825,0.0,1.9,94,39,55
5000,9117,516,0.1962659362766635,3608,220,0.21627341437723951,5509,296,0.18139551336407325,826,0.8,1.1,1349,565,784
1284,2994,0,0.0,1169,0,0.0,1825,0,0.0,827,0.8,1.3,74,31,43
988,2441,0,0.0,983,0,0.0,1458,0,0.0,828,0.8,1.5,47,22,25
1410,3308,0,0.0,1410,0,0.0,1898,0,0.0,829,0.8,1.7,85,42,43
5000,3500,1854,0.1388146764222732,1381,754,0.1429880685864676,2119,1100,0.13595400579336173,830,0.8,1.9,7169,2905,4264
774,1958,0,0.0,755,0,0.0,1203,0,0.0,831,0.0,1.1,89,41,48
379,1195,0,0.0,470,0,0.0,725,0,0.0,832,0.0,1.3,48,17,31
1333,3080,0,0.0,1201,0,0.0,1879,0,0.0,833,0.0,1.5,69,16,53
726,1860,0,0.0,748,0,0.0,1112,0,0.0,834,0.0,1.7,102,37,65
2096,4625,0,0.0,1883,0,0.0,2742,0,0.0,835,0.0,1.9,57,20,37
5000,7939,796,0.2025532116361494,3235,302,0.20622786079176517,4704,494,0.20030676620093482,836,0.8,1.1,2408,916,1492
683,1759,0,0.0,725,0,0.0,1034,0,0.0,837,0.8,1.3,64,22,42
1383,3179,0,0.0,1283,0,0.0,1896,0,0.0,838,0.8,1.5,72,29,43
5000,8687,716,0.20560314139152733,3446,286,0.2052439524064697,5241,430,0.20584204383275148,839,0.8,1.7,1794,730,1064
5000,6923,1108,0.1835062474546524,2696,416,0.1751205020718542,4227,692,0.1885473891876641,840,0.8,1.9,3467,1390,2077
1400,3066,0,0.0,1221,0,0.0,1845,0,0.0,841,0.0,1.1,223,96,127
738,1947,0,0.0,798,0,0.0,1149,0,0.0,842,0.0,1.3,24,7,17
1455,3129,0,0.0,1203,0,0.0,1926,0,0.0,843,0.0,1.5,231,92,139
815,2035,0,0.0,830,0,0.0,1205,0,0.0,844,0.0,1.7,70,27,43
1484,3290,0,0.0,1317,0,0.0,1973,0,0.0,845,0.0,1.9,101,46,55
663,1732,0,0.0,694,0,0.0,1038,0,0.0,846,0.8,1.1,58,19,39
5000,8209,641,0.21097592429341727,3225,253,0.20483195714247177,4984,388,0.2149821709150388,847,0.8,1.3,2190,894,1296
5000,9690,263,0.2798920909532159,3861,106,0.2540730109511905,5829,157,0.29732408127305476,848,0.8,1.5,797,318,479
1275,2995,0,0.0,1203,0,0.0,1792,0,0.0,849,0.8,1.7,49,19,30
5000,10356,28,0.2779137101208938,4170,13,0.27481327840592384,6186,15,0.2806007509405343,850,0.8,1.9,257,103,154
355,1141,0,0.0,467,0,0.0,674,0,0.0,851,0.0,1.1,12,6,6
348,1181,0,0.0,456,0,0.0,725,0,0.0,852,0.0,1.3,8,5,3
1646,3645,0,0.0,1412,0,0.0,2233,0,0.0,853,0.0,1.5,124,53,71
932,2297,0,0.0,920,0,0.0,1377,0,0.0,854,0.0,1.7,78,34,44
1030,2465,0,0.0,1002,0,0.0,1463,0,0.0,855,0.0,1.9,61,23,38
1069,2568,0,0.0,983,0,0.0,1585,0,0.0,856,0.8,1.1,75,35,40
5000,7956,791,0.22061546559451345,3136,313,0.23363045525826429,4820,478,0.2120930978858228,857,0.8,1.3,2520,1019,1501
402,1245,0,0.0,501,0,0.0,744,0,0.0,858,0.8,1.5,26,8,18
5000,6721,1138,0.2256259172763221,2658,459,0.234719000807651,4063,679,0.21947904637664617,859,0.8,1.7,3650,1507,2143
471,1350,0,0.0,537,0,0.0,813,0,0.0,860,0.8,1.9,34,13,21
889,2191,0,0.0,881,0,0.0,1310,0,0.0,861,0.0,1.1,88,27,61
727,1845,0,0.0,763,0,0.0,1082,0,0.0,862,0.0,1.3,80,31,49
1731,3742,0,0.0,1450,0,0.0,2292,0,0.0,863,0.0,1.5,179,73,106
955,2292,0,0.0,924,0,0.0,1368,0,0.0,864,0.0,1.7,110,36,74
1405,3184,0,0.0,1256,0,0.0,1928,0,0.0,865,0.0,1.9,44,16,28
5000,9453,378,0.23264483062844987,3795,148,0.23807555907613773,5658,230,0.22915027493167692,866,0.8,1.1,1090,404,686
5000,5157,1363,0.1775100516155983,2025,542,0.17079197934285875,3132,821,0.1819451249064934,867,0.8,1.3,5295,2097,3198
5000,6496,1071,0.18492746558664416,2608,447,0.1792814764509833,3888,624,0.188971948188632,868,0.8,1.5,4049,1641,2408
1406,3203,0,0.0,1255,0,0.0,1948,0,0.0,869,0.8,1.7,93,35,58
5000,7291,979,0.194051276179448,3013,388,0.20857195945383739,4278,591,0.18451823876749673,870,0.8,1.9,3103,1252,1851
659,1763,0,0.0,693,0,0.0,1070,0,0.0,871,0.0,1.1,30,10,20
1957,4360,0,0.0,1754,0,0.0,2606,0,0.0,872,0.0,1.3,65,21,44
661,1705,0,0.0,659,0,0.0,1046,0,0.0,873,0.0,1.5,72,31,41
1105,2630,0,0.0,1024,0,0.0,1606,0,0.0,874,0.0,1.7,54,25,29
816,1972,0,0.0,773,0,0.0,1199,0,0.0,875,0.0,1.9,74,28,46
694,1828,0,0.0,738,0,0.0,1090,0,0.0,876,0.8,1.1,49,15,34
1134,2649,0,0.0,1064,0,0.0,1585,0,0.0,877,0.8,1.3,97,48,49
5000,10220,61,0.235700260692597,4092,21,0.24191860533685797,6128,40,0.23243562975436,878,0.8,1.5,162,66,96
862,2119,0,0.0,859,0,0.0,1260,0,0.0,879,0.8,1.7,60,25,35
5000,6768,1210,0.19240238219599154,2768,522,0.2004674109617067,4000,688,0.18628327606851572,880,0.8,1.9,3689,1502,2187
1643,3594,0,0.0,1453,0,0.0,2141,0,0.0,881,0.0,1.1,79,34,45
397,1227,0,0.0,475,0,0.0,752,0,0.0,882,0.0,1.3,18,7,11
1946,4303,0,0.0,1662,0,0.0,2641,0,0.0,883,0.0,1.5,164,66,98
1669,3755,0,0.0,1501,0,0.0,2254,0,0.0,884,0.0,1.7,85,30,55
1485,3363,0,0.0,1337,0,0.0,2026,0,0.0,885,0.0,1.9,93,36,57
5000,4556,1676,0.16252959612067175,1835,677,0.16463149650281925,2721,999,0.16110518515098815,886,0.8,1.1,5930,2384,3546
720,1824,0,0.0,713,0,0.0,1111,0,0.0,887,0.8,1.3,58,21,37
5000,9226,404,0.24940894551310572,3713,177,0.2571871774244767,5513,227,0.2433439805425653,888,0.8,1.5,1259,530,729
5000,9342,324,0.20848169245815626,3717,139,0.1969256004565157,5625,185,0.21716437779992934,889,0.8,1.7,1214,482,732
5000,6866,974,0.21410679803595445,2742,400,0.21039498944003412,4124,574,0.21669342423520174,890,0.8,1.9,3532,1403,2129
478,1496,0,0.0,607,0,0.0,889,0,0.0,891,0.0,1.1,33,7,26
800,1943,0,0.0,743,0,0.0,1200,0,0.0,892,0.0,1.3,97,30,67
456,1378,0,0.0,549,0,0.0,829,0,0.0,893,0.0,1.5,25,13,12
384,1201,0,0.0,474,0,0.0,727,0,0.0,894,0.0,1.7,27,11,16
1272,2885,0,0.0,1153,0,0.0,1732,0,0.0,895,0.0,1.9,68,23,45
5000,10320,61,0.18568617116696126,4108,23,0.15740057590108417,6212,38,0.20280639988051846,896,0.8,1.1,277,118,159
5000,4052,1736,0.1529698236392736,1605,705,0.15429082639377373,2447,1031,0.1520665191369239,897,0.8,1.3,6494,2665,3829
1238,2910,0,0.0,1164,0,0.0,1746,0,0.0,898,0.8,1.5,59,19,40
939,2321,0,0.0,933,0,0.0,1388,0,0.0,899,0.8,1.7,30,10,20
1710,3946,0,0.0,1610,0,0.0,2336,0,0.0,900,0.8,1.9,65,31,34
1043,2447,0,0.0,978,0,0.0,1469,0,0.0,901,0.0,1.1,67,28,39
1156,2746,0,0.0,1058,0,0.0,1688,0,0.0,902,0.0,1.3,68,33,35
790,2013,0,0.0,820,0,0.0,1193,0,0.0,903,0.0,1.5,37,16,21
845,2108,0,0.0,823,0,0.0,1285,0,0.0,904,0.0,1.7,89,32,57
485,1385,0,0.0,553,0,0.0,832,0,0.0,905,0.0,1.9,23,9,14
368,1134,0,0.0,452,0,0.0,682,0,0.0,906,0.8,1.1,26,10,16
5000,4602,1510,0.15981206066699397,1926,587,0.15671433842654597,2676,923,0.16178211803984666,907,0.8,1.3,5830,2299,3531
529,1466,0,0.0,581,0,0.0,885,0,0.0,908,0.8,1.5,44,14,30
892,2157,0,0.0,908,0,0.0,1249,0,0.0,909,0.8,1.7,78,35,43
535,1547,0,0.0,623,0,0.0,924,0,0.0,910,0.8,1.9,25,5,20
940,2305,0,0.0,925,0,0.0,1380,0,0.0,911,0.0,1.1,61,21,40
884,2134,0,0.0,839,0,0.0,1295,0,0.0,912,0.0,1.3,81,38,43
901,2262,0,0.0,847,0,0.0,1415,0,0.0,913,0.0,1.5,25,8,17
588,1667,0,0.0,656,0,0.0,1011,0,0.0,914,0.0,1.7,42,16,26
656,1778,0,0.0,689,0,0.0,1089,0,0.0,915,0.0,1.9,49,19,30
5000,5713,1276,0.19182099691854368,2280,497,0.19298852461479432,3433,779,0.1910761172458396,916,0.8,1.1,4768,1882,2886
5000,3143,1873,0.1420417520993757,1275,735,0.1404152853612005,1868,1138,0.14309223808580682,917,0.8,1.3,7348,2894,4454
5000,5574,1417,0.1564107689905123,2240,592,0.1577924988605741,3334,825,0.1554192731322376,918,0.8,1.5,4984,2009,2975
5000,9601,255,0.18602461849977994,3811,103,0.16684070538209117,5790,152,0.1990242438361086,919,0.8,1.7,910,354,556
5000,9002,410,0.18740180841006293,3623,163,0.20170147745897607,5379,247,0.1779651847057194,920,0.8,1.9,1395,579,816
1182,2614,0,0.0,1056,0,0.0,1558,0,0.0,921,0.0,1.1,131,55,76
1909,4241,0,0.0,1685,0,0.0,2556,0,0.0,922,0.0,1.3,102,39,63
634,1738,0,0.0,692,0,0.0,1046,0,0.0,923,0.0,1.5,53,20,33
1089,2542,0,0.0,1003,0,0.0,1539,0,0.0,924,0.0,1.7,113,33,80
601,1622,0,0.0,640,0,0.0,982,0,0.0,925,0.0,1.9,25,10,15
5000,7256,927,0.17047609789924179,2854,363,0.17596565081588553,4402,564,0.16694292820289117,926,0.8,1.1,3073,1208,1865
5000,9387,385,0.2423242331885736,3751,167,0.2528392865279112,5636,218,0.2342691235203654,927,0.8,1.3,1022,429,593
5000,7328,923,0.19725079335219645,2884,358,0.1940242687894735,4444,565,0.19929521068574474,928,0.8,1.5,3033,1209,1824
548,1560,0,0.0,618,0,0.0,942,0,0.0,929,0.8,1.7,27,12,15
5000,10219,138,0.1519145432364484,4163,44,0.14940911672196178,6056,94,0.15308729607301663,930,0.8,1.9,370,123,247
1268,2866,0,0.0,1183,0,0.0,1683,0,0.0,931,0.0,1.1,97,30,67
679,1739,0,0.0,750,0,0.0,989,0,0.0,932,0.0,1.3,46,12,34
1484,3320,0,0.0,1296,0,0.0,2024,0,0.0,933,0.0,1.5,115,48,67
681,1791,0,0.0,725,0,0.0,1066,0,0.0,934,0.0,1.7,93,40,53
1676,3698,0,0.0,1461,0,0.0,2237,0,0.0,935,0.0,1.9,141,52,89
947,2294,0,0.0,932,0,0.0,1362,0,0.0,936,0.8,1.1,57,21,36
414,1266,0,0.0,491,0,0.0,775,0,0.0,937,0.8,1.3,43,14,29
812,2093,0,0.0,830,0,0.0,1263,0,0.0,938,0.8,1.5,30,15,15
5000,8714,565,0.2185132817048725,3498,222,0.22099019177338222,5216,343,0.2169101504068865,939,0.8,1.7,1732,690,1042
447,1341,0,0.0,550,0,0.0,791,0,0.0,940,0.8,1.9,28,12,16
2034,4368,0,0.0,1708,0,0.0,2660,0,0.0,941,0.0,1.1,122,42,80
950,2287,0,0.0,909,0,0.0,1378,0,0.0,942,0.0,1.3,64,25,39
558,1539,0,0.0,608,0,0.0,931,0,0.0,943,0.0,1.5,38,16,22
1154,2732,0,0.0,1107,0,0.0,1625,0,0.0,944,0.0,1.7,64,25,39
587,1702,0,0.0,679,0,0.0,1023,0,0.0,945,0.0,1.9,23,12,11
5000,5086,1498,0.18107989779676986,2036,596,0.1835133468170051,3050,902,0.1794719869142197,946,0.8,1.1,5444,2211,3233
1551,3490,0,0.0,1394,0,0.0,2096,0,0.0,947,0.8,1.3,62,24,38
1314,3088,0,0.0,1272,0,0.0,1816,0,0.0,948,0.8,1.5,60,22,38
5000,5157,1485,0.17269614807018416,2036,590,0.17238950442833512,3121,895,0.17289829304078858,949,0.8,1.7,5349,2132,3217
5000,7299,928,0.1969557704640662,2906,366,0.20390038075868167,4393,562,0.19243312390209227,950,0.8,1.9,3140,1238,1902
751,1900,0,0.0,757,0,0.0,1143,0,0.0,951,0.0,1.1,58,21,37
1518,3408,0,0.0,1319,0,0.0,2089,0,0.0,952,0.0,1.3,138,61,77
623,1680,0,0.0,670,0,0.0,1010,0,0.0,953,0.0,1.5,28,8,20
1484,3337,0,0.0,1374,0,0.0,1963,0,0.0,954,0.0,1.7,133,58,75
689,1834,0,0.0,727,0,0.0,1107,0,0.0,955,0.0,1.9,50,20,30
1013,2404,0,0.0,961,0,0.0,1443,0,0.0,956,0.8,1.1,68,29,39
5000,9595,344,0.20537941026727552,3883,127,0.22292296622250182,5712,217,0.19511198351006936,957,0.8,1.3,994,385,609
569,1611,0,0.0,689,0,0.0,922,0,0.0,958,0.8,1.5,29,8,21
5000,5936,1248,0.19902809822726283,2351,498,0.19269380478059506,3585,750,0.20323406907585034,959,0.8,1.7,4413,1744,2669
5000,7024,963,0.2143506782233446,2808,385,0.21622138552449544,4216,578,0.2131046188618512,960,0.8,1.9,3360,1334,2026
389,1211,0,0.0,467,0,0.0,744,0,0.0,961,0.0,1.1,21,9,12
614,1691,0,0.0,665,0,0.0,1026,0,0.0,962,0.0,1.3,45,18,27
2439,5167,0,0.0,2050,0,0.0,3117,0,0.0,963,0.0,1.5,160,74,86
1061,2465,0,0.0,1021,0,0.0,1444,0,0.0,964,0.0,1.7,148,49,99
833,2064,0,0.0,811,0,0.0,1253,0,0.0,965,0.0,1.9,52,24,28
707,1870,0,0.0,737,0,0.0,1133,0,0.0,966,0.8,1.1,35,12,23
935,2262,0,0.0,926,0,0.0,1336,0,0.0,967,0.8,1.3,49,21,28
442,1317,0,0.0,503,0,0.0,814,0,0.0,968,0.8,1.5,32,15,17
589,1588,0,0.0,631,0,0.0,957,0,0.0,969,0.8,1.7,26,9,17
1010,2436,0,0.0,964,0,0.0,1472,0,0.0,970,0.8,1.9,45,18,27
363,1202,0,0.0,475,0,0.0,727,0,0.0,971,0.0,1.1,24,10,14
1065,2583,0,0.0,1012,0,0.0,1571,0,0.0,972,0.0,1.3,97,44,53
530,1508,0,0.0,610,0,0.0,898,0,0.0,973,0.0,1.5,31,15,16
1097,2579,0,0.0,998,0,0.0,1581,0,0.0,974,0.0,1.7,70,21,49
616,1638,0,0.0,654,0,0.0,984,0,0.0,975,0.0,1.9,54,20,34
545,1577,0,0.0,638,0,0.0,939,0,0.0,976,0.8,1.1,34,13,21
5000,9855,168,0.20790638007014478,3918,63,0.19202066412061047,5937,105,0.21743780963986536,977,0.8,1.3,612,249,363
5000,9758,281,0.250084253640582,3896,109,0.2649338941101063,5862,172,0.24067372566861603,978,0.8,1.5,787,310,477
966,2278,0,0.0,916,0,0.0,1362,0,0.0,979,0.8,1.7,39,21,18
5000,7281,904,0.20154017143050018,2944,354,0.1970966377860424,4337,550,0.20440019126711467,980,0.8,1.9,3067,1239,1828
1082,2498,0,0.0,1025,0,0.0,1473,0,0.0,981,0.0,1.1,82,32,50
763,1934,0,0.0,783,0,0.0,1151,0,0.0,982,0.0,1.3,101,39,62
722,1808,0,0.0,730,0,0.0,1078,0,0.0,983,0.0,1.5,100,40,60
872,2201,0,0.0,862,0,0.0,1339,0,0.0,984,0.0,1.7,56,16,40
459,1368,0,0.0,567,0,0.0,801,0,0.0,985,0.0,1.9,18,8,10
5000,10231,33,0.15608371044372735,4104,12,0.12900751004545283,6127,21,0.1715558249570271,986,0.8,1.1,229,96,133
5000,7990,849,0.17361953665045965,3159,325,0.17316849022300343,4831,524,0.17389928872855728,987,0.8,1.3,2443,961,1482
1181,2749,0,0.0,1132,0,0.0,1617,0,0.0,988,0.8,1.5,91,29,62
5000,7058,1082,0.20001964907834868,2807,404,0.19518007188319486,4251,678,0.2029034089409478,989,0.8,1.7,3435,1361,2074
5000,8711,434,0.1644484231007131,3461,178,0.16873199394169291,5250,256,0.16147000275034432,990,0.8,1.9,1698,669,1029
981,2403,0,0.0,963,0,0.0,1440,0,0.0,991,0.0,1.1,47,16,31
1130,2626,0,0.0,1049,0,0.0,1577,0,0.0,992,0.0,1.3,31,10,21
1080,2515,0,0.0,975,0,0.0,1540,0,0.0,993,0.0,1.5,127,57,70
579,1627,0,0.0,660,0,0.0,967,0,0.0,994,0.0,1.7,32,13,19
543,1545,0,0.0,630,0,0.0,915,0,0.0,995,0.0,1.9,28,12,16
5000,6253,1238,0.16442347248116926,2536,503,0.17107699322965864,3717,735,0.15987011066281534,996,0.8,1.1,4270,1682,2588
684,1797,0,0.0,691,0,0.0,1106,0,0.0,997,0.8,1.3,33,13,20
5000,8385,733,0.19358551882450456,3363,295,0.19775775584369543,5022,438,0.1907754505124924,998,0.8,1.5,2181,857,1324
868,2225,0,0.0,858,0,0.0,1367,0,0.0,999,0.8,1.7,49,17,32
5000,8709,493,0.17313440272268288,3475,211,0.17237085687798462,5234,282,0.17370570830151752,1000,0.8,1.9,1692,656,1036
