step,susceptible_status,infected_status,filtermeanvirulence_pathogen,susceptible_status_is_minority,infected_status_is_minority,filtermeanvirulence_pathogen_is_minority,susceptible_status_#84_f=is_minority,infected_status_#84_f=is_minority,filtermeanvirulence_pathogen_#84_f=is_minority,ensemble,mutation_rate,virulence_init,total_infected,total_minority_infected,total_majority_infected
580,1610,0,0.0,648,0,0.0,962,0,0.0,1,0.0,1.1,21,5,16
957,2319,0,0.0,884,0,0.0,1435,0,0.0,2,0.0,1.3,72,35,37
1358,2921,0,0.0,1138,0,0.0,1783,0,0.0,3,0.0,1.5,207,97,110
719,1858,0,0.0,755,0,0.0,1103,0,0.0,4,0.0,1.7,33,14,19
1568,3469,0,0.0,1386,0,0.0,2083,0,0.0,5,0.0,1.9,131,52,79
1327,3100,0,0.0,1158,0,0.0,1942,0,0.0,6,0.8,1.1,51,22,29
5000,7002,1156,0.19452612139231934,2803,480,0.1966605330849742,4199,676,0.19301056279398454,7,0.8,1.3,3636,1441,2195
1193,2817,0,0.0,1145,0,0.0,1672,0,0.0,8,0.8,1.5,79,13,66
5000,7728,763,0.183963871462032,3110,285,0.20413861973059255,4618,478,0.17193499435630022,9,0.8,1.7,2776,1130,1646
5000,6184,1401,0.1758972212959716,2618,538,0.15562188154829434,3566,863,0.18853700435999293,10,0.8,1.9,4214,1594,2620
453,1386,0,0.0,530,0,0.0,856,0,0.0,11,0.0,1.1,17,4,13
631,1770,0,0.0,700,0,0.0,1070,0,0.0,12,0.0,1.3,29,11,18
463,1409,0,0.0,532,0,0.0,877,0,0.0,13,0.0,1.5,21,4,17
1398,3285,0,0.0,1307,0,0.0,1978,0,0.0,14,0.0,1.7,83,40,43
565,1501,0,0.0,602,0,0.0,899,0,0.0,15,0.0,1.9,72,26,46
5000,7943,855,0.16956680218440273,3262,343,0.17564711614883047,4681,512,0.16549346685276448,16,0.8,1.1,2600,967,1633
5000,4578,1544,0.15520489680586233,1882,591,0.1492436159845484,2696,953,0.15890176665412736,17,0.8,1.3,5771,2239,3532
5000,7721,784,0.20082509201600224,3075,323,0.2291569649475992,4646,461,0.18097434373637994,18,0.8,1.5,2617,1086,1531
608,1663,0,0.0,654,0,0.0,1009,0,0.0,19,0.8,1.7,20,6,14
3215,6872,0,0.0,2771,0,0.0,4101,0,0.0,20,0.8,1.9,48,15,33
416,1270,0,0.0,523,0,0.0,747,0,0.0,21,0.0,1.1,20,3,17
1005,2366,0,0.0,915,0,0.0,1451,0,0.0,22,0.0,1.3,92,34,58
1386,3028,0,0.0,1191,0,0.0,1837,0,0.0,23,0.0,1.5,111,35,76
558,1522,0,0.0,618,0,0.0,904,0,0.0,24,0.0,1.7,24,6,18
1249,2978,0,0.0,1191,0,0.0,1787,0,0.0,25,0.0,1.9,50,20,30
1265,2942,0,0.0,1220,0,0.0,1722,0,0.0,26,0.8,1.1,57,21,36
1145,2725,0,0.0,1101,0,0.0,1624,0,0.0,27,0.8,1.3,66,25,41
5000,7836,694,0.21041024547452997,3219,252,0.20283643913657332,4617,442,0.21472834320567258,28,0.8,1.5,2546,906,1640
5000,5478,1646,0.1762967389444844,2144,652,0.17456809236439644,3334,994,0.1774306197998338,29,0.8,1.7,5046,2107,2939
574,1578,0,0.0,642,0,0.0,936,0,0.0,30,0.8,1.9,44,21,23
782,1995,0,0.0,794,0,0.0,1201,0,0.0,31,0.0,1.1,33,16,17
724,1918,0,0.0,784,0,0.0,1134,0,0.0,32,0.0,1.3,33,11,22
797,2064,0,0.0,822,0,0.0,1242,0,0.0,33,0.0,1.5,29,5,24
970,2354,0,0.0,914,0,0.0,1440,0,0.0,34,0.0,1.7,66,19,47
873,2201,0,0.0,910,0,0.0,1291,0,0.0,35,0.0,1.9,27,11,16
569,1557,0,0.0,640,0,0.0,917,0,0.0,36,0.8,1.1,48,17,31
534,1550,0,0.0,629,0,0.0,921,0,0.0,37,0.8,1.3,48,23,25
5000,9520,292,0.21459326738339576,3854,123,0.2059484987217225,5666,169,0.2208850220898206,38,0.8,1.5,942,375,567
2742,5859,0,0.0,2279,0,0.0,3580,0,0.0,39,0.8,1.7,131,67,64
5000,8134,655,0.1963940488788155,3277,254,0.17105503930610644,4857,401,0.21244419459319971,40,0.8,1.9,2228,917,1311
1215,2885,0,0.0,1151,0,0.0,1734,0,0.0,41,0.0,1.1,70,22,48
1742,3742,0,0.0,1506,0,0.0,2236,0,0.0,42,0.0,1.3,192,90,102
447,1321,0,0.0,559,0,0.0,762,0,0.0,43,0.0,1.5,37,13,24
1578,3593,0,0.0,1469,0,0.0,2124,0,0.0,44,0.0,1.7,97,30,67
825,2041,0,0.0,784,0,0.0,1257,0,0.0,45,0.0,1.9,64,34,30
581,1540,0,0.0,625,0,0.0,915,0,0.0,46,0.8,1.1,34,7,27
5000,5227,1616,0.17167017707347926,2119,649,0.1679826071584307,3108,967,0.1741450818044684,47,0.8,1.3,5292,2140,3152
5000,7754,906,0.21476642126456313,3081,379,0.21333477349017257,4673,527,0.2157960123584794,48,0.8,1.5,2625,1115,1510
5000,4443,1753,0.17651419861794665,1748,706,0.16916308961806542,2695,1047,0.1814711068833869,49,0.8,1.7,6085,2492,3593
5000,5366,1535,0.17271153333210382,2135,602,0.16927079494153605,3231,933,0.17493160247585712,50,0.8,1.9,5215,2075,3140
1810,3893,0,0.0,1626,0,0.0,2267,0,0.0,51,0.0,1.1,170,71,99
601,1645,0,0.0,671,0,0.0,974,0,0.0,52,0.0,1.3,28,7,21
1241,2851,0,0.0,1169,0,0.0,1682,0,0.0,53,0.0,1.5,125,56,69
1253,2913,0,0.0,1187,0,0.0,1726,0,0.0,54,0.0,1.7,67,22,45
346,1185,0,0.0,459,0,0.0,726,0,0.0,55,0.0,1.9,12,5,7
1304,2928,0,0.0,1166,0,0.0,1762,0,0.0,56,0.8,1.1,44,20,24
471,1356,0,0.0,539,0,0.0,817,0,0.0,57,0.8,1.3,42,9,33
433,1296,0,0.0,509,0,0.0,787,0,0.0,58,0.8,1.5,20,10,10
2771,5890,0,0.0,2378,0,0.0,3512,0,0.0,59,0.8,1.7,124,45,79
5000,4712,1741,0.17085445126235665,1876,714,0.16787233491510575,2836,1027,0.17292770449695938,60,0.8,1.9,5752,2339,3413
1088,2628,0,0.0,1096,0,0.0,1532,0,0.0,61,0.0,1.1,98,23,75
226,936,0,0.0,369,0,0.0,567,0,0.0,62,0.0,1.3,8,5,3
926,2337,0,0.0,961,0,0.0,1376,0,0.0,63,0.0,1.5,37,13,24
955,2268,0,0.0,978,0,0.0,1290,0,0.0,64,0.0,1.7,66,19,47
1006,2402,0,0.0,972,0,0.0,1430,0,0.0,65,0.0,1.9,89,20,69
732,1855,0,0.0,733,0,0.0,1122,0,0.0,66,0.8,1.1,48,15,33
568,1594,0,0.0,626,0,0.0,968,0,0.0,67,0.8,1.3,45,22,23
642,1664,0,0.0,660,0,0.0,1004,0,0.0,68,0.8,1.5,58,19,39
723,1890,0,0.0,709,0,0.0,1181,0,0.0,69,0.8,1.7,61,26,35
5000,5731,1352,0.19836487782202383,2224,509,0.2035799068977513,3507,843,0.1952160642994316,70,0.8,1.9,4732,1918,2814
1389,3113,0,0.0,1234,0,0.0,1879,0,0.0,71,0.0,1.1,114,52,62
1353,3057,0,0.0,1245,0,0.0,1812,0,0.0,72,0.0,1.3,104,44,60
1003,2457,0,0.0,930,0,0.0,1527,0,0.0,73,0.0,1.5,70,28,42
936,2226,0,0.0,899,0,0.0,1327,0,0.0,74,0.0,1.7,104,39,65
1153,2680,0,0.0,1049,0,0.0,1631,0,0.0,75,0.0,1.9,102,44,58
5000,8185,598,0.22431225111229167,3253,226,0.23935034597448387,4932,372,0.21517620423364797,76,0.8,1.1,2066,787,1279
696,1789,0,0.0,720,0,0.0,1069,0,0.0,77,0.8,1.3,64,26,38
5000,7635,866,0.1839203108163821,2963,349,0.17631142173343672,4672,517,0.18905667888204536,78,0.8,1.5,2766,1093,1673
5000,9764,197,0.18523113151940346,3909,72,0.16587047469784413,5855,125,0.19638286984862172,79,0.8,1.7,618,219,399
5000,7668,922,0.15766942572948378,3177,371,0.16449091802027982,4491,551,0.1530763701217064,80,0.8,1.9,2949,1085,1864
1190,2818,0,0.0,1135,0,0.0,1683,0,0.0,81,0.0,1.1,80,26,54
966,2340,0,0.0,905,0,0.0,1435,0,0.0,82,0.0,1.3,56,24,32
418,1254,0,0.0,506,0,0.0,748,0,0.0,83,0.0,1.5,22,8,14
619,1594,0,0.0,631,0,0.0,963,0,0.0,84,0.0,1.7,42,13,29
837,2130,0,0.0,815,0,0.0,1315,0,0.0,85,0.0,1.9,74,27,47
5000,4727,1556,0.1752422432364252,1864,648,0.1767108181266814,2863,908,0.17419418538522913,86,0.8,1.1,5675,2383,3292
5000,10314,5,0.05,4152,2,0.05,6162,3,0.05000000000000001,87,0.8,1.3,116,29,87
1183,2742,0,0.0,1127,0,0.0,1615,0,0.0,88,0.8,1.5,88,32,56
506,1439,0,0.0,599,0,0.0,840,0,0.0,89,0.8,1.7,33,15,18
5000,5455,1364,0.18766519715467272,2149,550,0.20262001247593311,3306,814,0.17756059220787515,90,0.8,1.9,4940,2025,2915
1182,2827,0,0.0,1116,0,0.0,1711,0,0.0,91,0.0,1.1,85,35,50
428,1295,0,0.0,523,0,0.0,772,0,0.0,92,0.0,1.3,13,8,5
835,2116,0,0.0,829,0,0.0,1287,0,0.0,93,0.0,1.5,37,9,28
803,1974,0,0.0,824,0,0.0,1150,0,0.0,94,0.0,1.7,60,13,47
912,2238,0,0.0,879,0,0.0,1359,0,0.0,95,0.0,1.9,105,37,68
5000,6284,1091,0.16961747011115216,2477,441,0.16463216745668688,3807,650,0.17299980621979705,96,0.8,1.1,4140,1696,2444
5000,7845,901,0.20506872569055806,3169,335,0.21333077814995136,4676,566,0.20017864163773677,97,0.8,1.3,2510,1021,1489
1214,2920,0,0.0,1138,0,0.0,1782,0,0.0,98,0.8,1.5,33,13,20
481,1376,0,0.0,532,0,0.0,844,0,0.0,99,0.8,1.7,33,15,18
1741,3922,0,0.0,1586,0,0.0,2336,0,0.0,100,0.8,1.9,143,53,90
624,1649,0,0.0,651,0,0.0,998,0,0.0,101,0.0,1.1,40,7,33
1761,3671,0,0.0,1506,0,0.0,2165,0,0.0,102,0.0,1.3,214,94,120
757,1997,0,0.0,780,0,0.0,1217,0,0.0,103,0.0,1.5,26,8,18
411,1285,0,0.0,513,0,0.0,772,0,0.0,104,0.0,1.7,29,10,19
540,1519,0,0.0,611,0,0.0,908,0,0.0,105,0.0,1.9,57,23,34
5000,7214,1019,0.2044032719661416,2965,428,0.196122378153486,4249,591,0.2104002644396044,106,0.8,1.1,3141,1228,1913
882,2115,0,0.0,836,0,0.0,1279,0,0.0,107,0.8,1.3,68,37,31
5000,7191,895,0.17380833907720314,2911,341,0.15867353352914085,4280,554,0.18312416704090193,108,0.8,1.5,3363,1291,2072
619,1676,0,0.0,707,0,0.0,969,0,0.0,109,0.8,1.7,61,19,42
668,1770,0,0.0,692,0,0.0,1078,0,0.0,110,0.8,1.9,85,42,43
783,1999,0,0.0,809,0,0.0,1190,0,0.0,111,0.0,1.1,74,38,36
1029,2302,0,0.0,895,0,0.0,1407,0,0.0,112,0.0,1.3,157,67,90
893,2186,0,0.0,887,0,0.0,1299,0,0.0,113,0.0,1.5,41,10,31
870,2222,0,0.0,881,0,0.0,1341,0,0.0,114,0.0,1.7,57,21,36
380,1175,0,0.0,453,0,0.0,722,0,0.0,115,0.0,1.9,20,6,14
726,1882,0,0.0,772,0,0.0,1110,0,0.0,116,0.8,1.1,39,7,32
5000,10312,89,0.18526159710617204,4199,37,0.14294706498561296,6113,52,0.2153700141919545,117,0.8,1.3,264,103,161
1517,3459,0,0.0,1407,0,0.0,2052,0,0.0,118,0.8,1.5,107,36,71
838,2139,0,0.0,858,0,0.0,1281,0,0.0,119,0.8,1.7,35,5,30
5000,10230,9,0.05900175919903651,4113,5,0.041425495967847635,6117,4,0.08097208823802261,120,0.8,1.9,97,49,48
793,1955,0,0.0,761,0,0.0,1194,0,0.0,121,0.0,1.1,50,20,30
1042,2472,0,0.0,984,0,0.0,1488,0,0.0,122,0.0,1.3,56,17,39
544,1522,0,0.0,619,0,0.0,903,0,0.0,123,0.0,1.5,45,18,27
1608,3531,0,0.0,1409,0,0.0,2122,0,0.0,124,0.0,1.7,134,70,64
806,1976,0,0.0,761,0,0.0,1215,0,0.0,125,0.0,1.9,55,23,32
516,1486,0,0.0,592,0,0.0,894,0,0.0,126,0.8,1.1,48,14,34
5000,4372,1467,0.15743462187105747,1752,597,0.14746978710755854,2620,870,0.16427256020876885,127,0.8,1.3,6087,2435,3652
5000,10473,1,0.01730598033051023,4205,0,0.0,6268,1,0.01730598033051023,128,0.8,1.5,27,2,25
631,1729,0,0.0,670,0,0.0,1059,0,0.0,129,0.8,1.7,22,5,17
1753,3804,0,0.0,1534,0,0.0,2270,0,0.0,130,0.8,1.9,58,21,37
1178,2776,0,0.0,1042,0,0.0,1734,0,0.0,131,0.0,1.1,92,43,49
1002,2473,0,0.0,985,0,0.0,1488,0,0.0,132,0.0,1.3,46,16,30
1634,3631,0,0.0,1432,0,0.0,2199,0,0.0,133,0.0,1.5,167,54,113
1124,2536,0,0.0,1007,0,0.0,1529,0,0.0,134,0.0,1.7,107,35,72
1492,3256,0,0.0,1257,0,0.0,1999,0,0.0,135,0.0,1.9,164,74,90
412,1257,0,0.0,512,0,0.0,745,0,0.0,136,0.8,1.1,19,10,9
5000,5462,1356,0.18435165378780932,2209,564,0.18273371218157236,3253,792,0.18550382432558424,137,0.8,1.3,4986,2009,2977
437,1290,0,0.0,526,0,0.0,764,0,0.0,138,0.8,1.5,26,10,16
5000,5731,1509,0.16417773823568818,2231,636,0.1647217497765084,3500,873,0.16378141367674015,139,0.8,1.7,4828,1989,2839
5000,8108,677,0.2176212683770792,3242,263,0.20230600168421634,4866,414,0.2273505320008061,140,0.8,1.9,2372,941,1431
1438,3142,0,0.0,1255,0,0.0,1887,0,0.0,141,0.0,1.1,139,65,74
883,2165,0,0.0,863,0,0.0,1302,0,0.0,142,0.0,1.3,86,38,48
536,1493,0,0.0,623,0,0.0,870,0,0.0,143,0.0,1.5,55,27,28
726,1926,0,0.0,798,0,0.0,1128,0,0.0,144,0.0,1.7,43,10,33
978,2398,0,0.0,973,0,0.0,1425,0,0.0,145,0.0,1.9,52,15,37
376,1186,0,0.0,459,0,0.0,727,0,0.0,146,0.8,1.1,35,19,16
5000,8810,428,0.1993781226157875,3675,158,0.2318142866070424,5135,270,0.1803969599838679,147,0.8,1.3,1693,614,1079
1164,2782,0,0.0,1134,0,0.0,1648,0,0.0,148,0.8,1.5,70,17,53
4167,8567,0,0.0,3445,0,0.0,5122,0,0.0,149,0.8,1.7,156,72,84
5000,8654,551,0.2001439321874173,3516,261,0.19709212542338186,5138,290,0.2028905582750493,150,0.8,1.9,1570,672,898
800,2104,0,0.0,817,0,0.0,1287,0,0.0,151,0.0,1.1,36,9,27
472,1422,0,0.0,542,0,0.0,880,0,0.0,152,0.0,1.3,26,11,15
747,1886,0,0.0,757,0,0.0,1129,0,0.0,153,0.0,1.5,45,12,33
1106,2547,0,0.0,1045,0,0.0,1502,0,0.0,154,0.0,1.7,64,20,44
1103,2694,0,0.0,1139,0,0.0,1555,0,0.0,155,0.0,1.9,66,14,52
470,1387,0,0.0,554,0,0.0,833,0,0.0,156,0.8,1.1,29,14,15
5000,10139,2,0.025060745273065725,4074,1,0.0001214905461314475,6065,1,0.05,157,0.8,1.3,213,89,124
462,1364,0,0.0,564,0,0.0,800,0,0.0,158,0.8,1.5,22,3,19
5000,6327,1239,0.1548859666266221,2632,490,0.14468328316440798,3695,749,0.16156061935891167,159,0.8,1.7,4269,1648,2621
854,2095,0,0.0,849,0,0.0,1246,0,0.0,160,0.8,1.9,60,21,39
1147,2691,0,0.0,1105,0,0.0,1586,0,0.0,161,0.0,1.1,74,29,45
846,2155,0,0.0,887,0,0.0,1268,0,0.0,162,0.0,1.3,47,17,30
845,2081,0,0.0,825,0,0.0,1256,0,0.0,163,0.0,1.5,24,7,17
655,1806,0,0.0,717,0,0.0,1089,0,0.0,164,0.0,1.7,44,12,32
833,2052,0,0.0,812,0,0.0,1240,0,0.0,165,0.0,1.9,60,29,31
5000,7662,765,0.21996411723562456,3160,301,0.21088189651910955,4502,464,0.22585581645043262,166,0.8,1.1,2672,1050,1622
5000,9172,479,0.2123065717466923,3673,208,0.23348518181945266,5499,271,0.19605140239195365,167,0.8,1.3,1370,589,781
1108,2575,0,0.0,1047,0,0.0,1528,0,0.0,168,0.8,1.5,94,41,53
3140,6771,0,0.0,2721,0,0.0,4050,0,0.0,169,0.8,1.7,27,11,16
783,1972,0,0.0,787,0,0.0,1185,0,0.0,170,0.8,1.9,70,30,40
1087,2662,0,0.0,1089,0,0.0,1573,0,0.0,171,0.0,1.1,74,33,41
1010,2389,0,0.0,926,0,0.0,1463,0,0.0,172,0.0,1.3,137,76,61
2578,5339,0,0.0,2019,0,0.0,3320,0,0.0,173,0.0,1.5,275,126,149
1444,3177,0,0.0,1261,0,0.0,1916,0,0.0,174,0.0,1.7,169,69,100
1668,3653,0,0.0,1453,0,0.0,2200,0,0.0,175,0.0,1.9,173,82,91
3767,7934,0,0.0,3222,0,0.0,4712,0,0.0,176,0.8,1.1,216,86,130
1320,2957,0,0.0,1207,0,0.0,1750,0,0.0,177,0.8,1.3,99,25,74
947,2345,0,0.0,930,0,0.0,1415,0,0.0,178,0.8,1.5,57,21,36
1555,3551,0,0.0,1452,0,0.0,2099,0,0.0,179,0.8,1.7,66,20,46
1093,2647,0,0.0,1004,0,0.0,1643,0,0.0,180,0.8,1.9,68,26,42
1349,3197,0,0.0,1277,0,0.0,1920,0,0.0,181,0.0,1.1,84,40,44
761,1916,0,0.0,766,0,0.0,1150,0,0.0,182,0.0,1.3,63,35,28
387,1235,0,0.0,481,0,0.0,754,0,0.0,183,0.0,1.5,20,1,19
1877,4007,0,0.0,1569,0,0.0,2438,0,0.0,184,0.0,1.7,247,109,138
551,1597,0,0.0,629,0,0.0,968,0,0.0,185,0.0,1.9,21,9,12
5000,10322,14,0.11588854041572083,4077,1,0.01936757676286062,6245,13,0.1233132299274793,186,0.8,1.1,208,72,136
5000,6545,1322,0.20376227178142733,2652,538,0.2009675859495232,3893,784,0.2056800536405657,187,0.8,1.3,4040,1609,2431
5000,6087,1378,0.18847490505405495,2400,550,0.18603711581804738,3687,828,0.19009420949826292,188,0.8,1.5,4357,1735,2622
417,1211,0,0.0,478,0,0.0,733,0,0.0,189,0.8,1.7,16,7,9
1091,2518,0,0.0,981,0,0.0,1537,0,0.0,190,0.8,1.9,77,43,34
1880,4061,0,0.0,1595,0,0.0,2466,0,0.0,191,0.0,1.1,158,60,98
986,2340,0,0.0,995,0,0.0,1345,0,0.0,192,0.0,1.3,61,12,49
515,1469,0,0.0,595,0,0.0,874,0,0.0,193,0.0,1.5,44,19,25
1406,3164,0,0.0,1280,0,0.0,1884,0,0.0,194,0.0,1.7,95,26,69
831,2017,0,0.0,795,0,0.0,1222,0,0.0,195,0.0,1.9,48,9,39
1136,2693,0,0.0,1107,0,0.0,1586,0,0.0,196,0.8,1.1,43,14,29
489,1413,0,0.0,599,0,0.0,814,0,0.0,197,0.8,1.3,36,11,25
1179,2844,0,0.0,1137,0,0.0,1707,0,0.0,198,0.8,1.5,59,30,29
5000,8408,732,0.19850105451100694,3420,267,0.20142198017611454,4988,465,0.19682387783878383,199,0.8,1.7,2147,842,1305
1013,2418,0,0.0,938,0,0.0,1480,0,0.0,200,0.8,1.9,76,35,41
855,2076,0,0.0,866,0,0.0,1210,0,0.0,201,0.0,1.1,25,7,18
1118,2578,0,0.0,1033,0,0.0,1545,0,0.0,202,0.0,1.3,64,35,29
1155,2728,0,0.0,1108,0,0.0,1620,0,0.0,203,0.0,1.5,91,33,58
601,1693,0,0.0,678,0,0.0,1015,0,0.0,204,0.0,1.7,41,14,27
1403,3055,0,0.0,1255,0,0.0,1800,0,0.0,205,0.0,1.9,137,55,82
5000,5053,1536,0.18774999871701806,2026,573,0.18734631375020613,3027,963,0.187990197560199,206,0.8,1.1,5315,2012,3303
940,2235,0,0.0,903,0,0.0,1332,0,0.0,207,0.8,1.3,99,45,54
5000,3919,1697,0.16743894973208273,1627,640,0.17057525842374927,2292,1057,0.16553995487620116,208,0.8,1.5,6723,2659,4064
780,1991,0,0.0,789,0,0.0,1202,0,0.0,209,0.8,1.7,45,14,31
621,1678,0,0.0,644,0,0.0,1034,0,0.0,210,0.8,1.9,36,14,22
1295,3047,0,0.0,1201,0,0.0,1846,0,0.0,211,0.0,1.1,62,29,33
754,1844,0,0.0,733,0,0.0,1111,0,0.0,212,0.0,1.3,88,30,58
800,2089,0,0.0,845,0,0.0,1244,0,0.0,213,0.0,1.5,33,10,23
1355,3083,0,0.0,1239,0,0.0,1844,0,0.0,214,0.0,1.7,76,23,53
907,2273,0,0.0,912,0,0.0,1361,0,0.0,215,0.0,1.9,59,34,25
5000,6337,1147,0.19299942855061977,2547,442,0.1997860902321512,3790,705,0.18874452860276605,216,0.8,1.1,4035,1639,2396
1160,2781,0,0.0,1185,0,0.0,1596,0,0.0,217,0.8,1.3,51,22,29
1278,2888,0,0.0,1157,0,0.0,1731,0,0.0,218,0.8,1.5,55,14,41
1257,2894,0,0.0,1123,0,0.0,1771,0,0.0,219,0.8,1.7,103,42,61
5000,8916,408,0.21313094079179895,3637,155,0.19484762931569571,5279,253,0.22433217904790978,220,0.8,1.9,1555,568,987
1635,3631,0,0.0,1441,0,0.0,2190,0,0.0,221,0.0,1.1,141,55,86
806,2048,0,0.0,813,0,0.0,1235,0,0.0,222,0.0,1.3,33,13,20
424,1263,0,0.0,519,0,0.0,744,0,0.0,223,0.0,1.5,36,12,24
744,1923,0,0.0,759,0,0.0,1164,0,0.0,224,0.0,1.7,52,18,34
1386,3142,0,0.0,1212,0,0.0,1930,0,0.0,225,0.0,1.9,141,58,83
659,1781,0,0.0,714,0,0.0,1067,0,0.0,226,0.8,1.1,29,7,22
5000,10203,1,0.05,4075,0,0.0,6128,1,0.05,227,0.8,1.3,195,65,130
5000,9379,302,0.1865519795866893,3778,100,0.15090203666836197,5601,202,0.20420046617992063,228,0.8,1.5,1054,353,701
5000,7234,1069,0.19623401481780625,2902,462,0.1936738618218145,4332,607,0.19818259914094985,229,0.8,1.7,3223,1323,1900
5000,7173,1035,0.18558905255152927,2898,396,0.17555713440554838,4275,639,0.19180601590960192,230,0.8,1.9,3328,1316,2012
546,1526,0,0.0,616,0,0.0,910,0,0.0,231,0.0,1.1,40,23,17
567,1528,0,0.0,613,0,0.0,915,0,0.0,232,0.0,1.3,29,7,22
572,1532,0,0.0,606,0,0.0,926,0,0.0,233,0.0,1.5,48,20,28
924,2264,0,0.0,934,0,0.0,1330,0,0.0,234,0.0,1.7,56,5,51
843,2159,0,0.0,827,0,0.0,1332,0,0.0,235,0.0,1.9,55,18,37
549,1516,0,0.0,613,0,0.0,903,0,0.0,236,0.8,1.1,42,12,30
698,1803,0,0.0,681,0,0.0,1122,0,0.0,237,0.8,1.3,85,37,48
5000,5499,1353,0.17486544154354655,2151,553,0.1832953109068755,3348,800,0.16903829434614548,238,0.8,1.5,4974,2056,2918
5000,7588,826,0.21985877242390575,3038,309,0.22216725170724239,4550,517,0.2184790430263216,239,0.8,1.7,2885,1224,1661
5000,5423,1571,0.18723619605660966,2148,603,0.1739209157238126,3275,968,0.19553073535482926,240,0.8,1.9,5046,1983,3063
828,2118,0,0.0,863,0,0.0,1255,0,0.0,241,0.0,1.1,27,7,20
2370,5051,0,0.0,1990,0,0.0,3061,0,0.0,242,0.0,1.3,182,69,113
1691,3883,0,0.0,1585,0,0.0,2298,0,0.0,243,0.0,1.5,35,6,29
1136,2581,0,0.0,1049,0,0.0,1532,0,0.0,244,0.0,1.7,80,29,51
534,1513,0,0.0,613,0,0.0,900,0,0.0,245,0.0,1.9,34,15,19
434,1301,0,0.0,506,0,0.0,795,0,0.0,246,0.8,1.1,28,17,11
5000,8487,688,0.24524957692377697,3361,302,0.2401138263024824,5126,386,0.24926770305753568,247,0.8,1.3,2021,892,1129
1434,3221,0,0.0,1282,0,0.0,1939,0,0.0,248,0.8,1.5,61,17,44
5000,4789,1537,0.18248782250687004,1892,595,0.1810284813578401,2897,942,0.18340959319017439,249,0.8,1.7,5562,2269,3293
5000,8407,528,0.22085004674628653,3395,207,0.2169578665981736,5012,321,0.22335995730908834,250,0.8,1.9,1942,787,1155
1104,2552,0,0.0,1001,0,0.0,1551,0,0.0,251,0.0,1.1,83,37,46
889,2156,0,0.0,872,0,0.0,1284,0,0.0,252,0.0,1.3,60,21,39
556,1534,0,0.0,615,0,0.0,919,0,0.0,253,0.0,1.5,37,15,22
1059,2555,0,0.0,1032,0,0.0,1523,0,0.0,254,0.0,1.7,38,16,22
1223,2833,0,0.0,1141,0,0.0,1692,0,0.0,255,0.0,1.9,64,29,35
5000,5778,1288,0.19451236283420112,2393,471,0.1952297824854855,3385,817,0.19409877084429297,256,0.8,1.1,4714,1841,2873
5000,7138,1166,0.1825899821906754,2754,525,0.1791814985631516,4384,641,0.18538164194800763,257,0.8,1.3,3396,1472,1924
981,2298,0,0.0,893,0,0.0,1405,0,0.0,258,0.8,1.5,106,55,51
384,1241,0,0.0,504,0,0.0,737,0,0.0,259,0.8,1.7,22,7,15
862,2109,0,0.0,871,0,0.0,1238,0,0.0,260,0.8,1.9,79,29,50
800,1987,0,0.0,796,0,0.0,1191,0,0.0,261,0.0,1.1,57,25,32
1517,3396,0,0.0,1337,0,0.0,2059,0,0.0,262,0.0,1.3,55,27,28
845,2070,0,0.0,849,0,0.0,1221,0,0.0,263,0.0,1.5,62,18,44
2463,5262,0,0.0,2175,0,0.0,3087,0,0.0,264,0.0,1.7,227,84,143
613,1661,0,0.0,692,0,0.0,969,0,0.0,265,0.0,1.9,43,12,31
5000,4289,1662,0.17142812436734425,1672,647,0.1793149537425387,2617,1015,0.1664007562828607,266,0.8,1.1,6218,2580,3638
5000,10087,91,0.1577675798328567,4032,42,0.16157564610806768,6055,49,0.154503523025533,267,0.8,1.3,346,138,208
1733,3956,0,0.0,1582,0,0.0,2374,0,0.0,268,0.8,1.5,108,46,62
5000,6311,1178,0.17979013725242426,2544,501,0.17871353694555367,3767,677,0.1805868532845397,269,0.8,1.7,4161,1671,2490
5000,6491,1191,0.21078755846058067,2586,459,0.21314798403681226,3905,732,0.20930745553777963,270,0.8,1.9,4029,1597,2432
463,1367,0,0.0,532,0,0.0,835,0,0.0,271,0.0,1.1,48,24,24
682,1799,0,0.0,718,0,0.0,1081,0,0.0,272,0.0,1.3,47,16,31
1387,3093,0,0.0,1221,0,0.0,1872,0,0.0,273,0.0,1.5,91,33,58
869,2163,0,0.0,878,0,0.0,1285,0,0.0,274,0.0,1.7,83,18,65
658,1725,0,0.0,690,0,0.0,1035,0,0.0,275,0.0,1.9,45,20,25
5000,4794,1525,0.19011855406646364,1848,640,0.18085735082959253,2946,885,0.1968159213790031,276,0.8,1.1,5544,2268,3276
5000,7173,1092,0.19230309477177057,2774,443,0.19801614040317797,4399,649,0.188403434964816,277,0.8,1.3,3203,1257,1946
711,1777,0,0.0,704,0,0.0,1073,0,0.0,278,0.8,1.5,41,13,28
978,2340,0,0.0,909,0,0.0,1431,0,0.0,279,0.8,1.7,47,17,30
1291,3043,0,0.0,1188,0,0.0,1855,0,0.0,280,0.8,1.9,57,24,33
861,2120,0,0.0,868,0,0.0,1252,0,0.0,281,0.0,1.1,74,28,46
925,2225,0,0.0,877,0,0.0,1348,0,0.0,282,0.0,1.3,134,60,74
550,1558,0,0.0,604,0,0.0,954,0,0.0,283,0.0,1.5,38,14,24
932,2286,0,0.0,923,0,0.0,1363,0,0.0,284,0.0,1.7,34,7,27
1257,2939,0,0.0,1160,0,0.0,1779,0,0.0,285,0.0,1.9,97,37,60
1022,2472,0,0.0,986,0,0.0,1486,0,0.0,286,0.8,1.1,51,23,28
1700,3817,0,0.0,1539,0,0.0,2278,0,0.0,287,0.8,1.3,116,52,64
5000,9367,347,0.20582298698811238,3770,159,0.2059135575400045,5597,188,0.20574638742560786,288,0.8,1.5,1033,459,574
1216,2786,0,0.0,1136,0,0.0,1650,0,0.0,289,0.8,1.7,104,50,54
623,1748,0,0.0,687,0,0.0,1061,0,0.0,290,0.8,1.9,29,12,17
1057,2534,0,0.0,1006,0,0.0,1528,0,0.0,291,0.0,1.1,68,31,37
847,2186,0,0.0,844,0,0.0,1342,0,0.0,292,0.0,1.3,40,12,28
816,2094,0,0.0,854,0,0.0,1240,0,0.0,293,0.0,1.5,42,15,27
1137,2559,0,0.0,1019,0,0.0,1540,0,0.0,294,0.0,1.7,102,36,66
802,1978,0,0.0,798,0,0.0,1180,0,0.0,295,0.0,1.9,74,32,42
5000,3169,1683,0.14287361518050995,1249,632,0.148384333291692,1920,1051,0.1395598436807316,296,0.8,1.1,7203,2895,4308
5000,9437,241,0.2778051804534269,3749,101,0.29933047801647056,5688,140,0.2622762157829456,297,0.8,1.3,1044,405,639
549,1557,0,0.0,631,0,0.0,926,0,0.0,298,0.8,1.5,40,18,22
751,1917,0,0.0,781,0,0.0,1136,0,0.0,299,0.8,1.7,53,16,37
819,2063,0,0.0,810,0,0.0,1253,0,0.0,300,0.8,1.9,52,19,33
1888,4067,0,0.0,1599,0,0.0,2468,0,0.0,301,0.0,1.1,155,89,66
929,2255,0,0.0,911,0,0.0,1344,0,0.0,302,0.0,1.3,76,37,39
565,1606,0,0.0,651,0,0.0,955,0,0.0,303,0.0,1.5,31,12,19
499,1424,0,0.0,599,0,0.0,825,0,0.0,304,0.0,1.7,39,12,27
469,1389,0,0.0,551,0,0.0,838,0,0.0,305,0.0,1.9,52,30,22
390,1231,0,0.0,488,0,0.0,743,0,0.0,306,0.8,1.1,28,11,17
5000,4810,1625,0.17227331562831494,1891,662,0.17612689760852987,2919,963,0.1696242281195898,307,0.8,1.3,5596,2222,3374
595,1570,0,0.0,622,0,0.0,948,0,0.0,308,0.8,1.5,71,32,39
1035,2568,0,0.0,1008,0,0.0,1560,0,0.0,309,0.8,1.7,47,12,35
5000,7468,923,0.17854167824891193,2876,427,0.17049087343426034,4592,496,0.18547251223249278,310,0.8,1.9,3030,1301,1729
1809,4027,0,0.0,1638,0,0.0,2389,0,0.0,311,0.0,1.1,147,56,91
842,2134,0,0.0,856,0,0.0,1278,0,0.0,312,0.0,1.3,41,10,31
390,1226,0,0.0,490,0,0.0,736,0,0.0,313,0.0,1.5,44,18,26
864,2142,0,0.0,867,0,0.0,1275,0,0.0,314,0.0,1.7,31,9,22
912,2241,0,0.0,945,0,0.0,1296,0,0.0,315,0.0,1.9,83,34,49
546,1567,0,0.0,639,0,0.0,928,0,0.0,316,0.8,1.1,44,13,31
5000,4623,1740,0.1785784253300275,1807,689,0.1730045841029163,2816,1051,0.18223244683857115,317,0.8,1.3,5972,2455,3517
5000,10110,20,0.10367159105968189,4070,8,0.10742743273122692,6040,12,0.10116769661198521,318,0.8,1.5,241,109,132
324,1118,0,0.0,453,0,0.0,665,0,0.0,319,0.8,1.7,29,7,22
5000,10540,27,0.1844580289479483,4234,10,0.10535260747965074,6306,17,0.2309906298116529,320,0.8,1.9,145,51,94
1575,3399,0,0.0,1353,0,0.0,2046,0,0.0,321,0.0,1.1,168,77,91
541,1498,0,0.0,601,0,0.0,897,0,0.0,322,0.0,1.3,20,4,16
1876,4087,0,0.0,1589,0,0.0,2498,0,0.0,323,0.0,1.5,199,71,128
719,1866,0,0.0,718,0,0.0,1148,0,0.0,324,0.0,1.7,50,16,34
1240,2809,0,0.0,1124,0,0.0,1685,0,0.0,325,0.0,1.9,85,42,43
746,1874,0,0.0,778,0,0.0,1096,0,0.0,326,0.8,1.1,53,12,41
5000,9448,227,0.22276865565875656,3879,71,0.2733405850464817,5569,156,0.199751944206651,327,0.8,1.3,942,336,606
600,1688,0,0.0,687,0,0.0,1001,0,0.0,328,0.8,1.5,26,11,15
684,1758,0,0.0,681,0,0.0,1077,0,0.0,329,0.8,1.7,39,14,25
5000,9559,203,0.1608340875092794,3856,81,0.16656535598364597,5703,122,0.15702890106318368,330,0.8,1.9,848,296,552
1514,3351,0,0.0,1340,0,0.0,2011,0,0.0,331,0.0,1.1,119,51,68
912,2256,0,0.0,888,0,0.0,1368,0,0.0,332,0.0,1.3,65,26,39
673,1768,0,0.0,734,0,0.0,1034,0,0.0,333,0.0,1.5,65,22,43
1048,2419,0,0.0,953,0,0.0,1466,0,0.0,334,0.0,1.7,107,45,62
744,1879,0,0.0,749,0,0.0,1130,0,0.0,335,0.0,1.9,44,18,26
758,1949,0,0.0,751,0,0.0,1198,0,0.0,336,0.8,1.1,23,5,18
5000,9927,112,0.20286334029093078,3870,38,0.1595759231194017,6057,74,0.22509201397360773,337,0.8,1.3,606,228,378
5000,4644,1523,0.18610136312409675,1846,598,0.18424754342134708,2798,925,0.1872998325103068,338,0.8,1.5,5722,2299,3423
532,1465,0,0.0,592,0,0.0,873,0,0.0,339,0.8,1.7,25,10,15
3643,7720,0,0.0,3087,0,0.0,4633,0,0.0,340,0.8,1.9,102,47,55
713,1804,0,0.0,712,0,0.0,1092,0,0.0,341,0.0,1.1,79,26,53
1032,2466,0,0.0,1009,0,0.0,1457,0,0.0,342,0.0,1.3,106,39,67
858,2099,0,0.0,833,0,0.0,1266,0,0.0,343,0.0,1.5,79,31,48
626,1625,0,0.0,650,0,0.0,975,0,0.0,344,0.0,1.7,31,13,18
938,2275,0,0.0,889,0,0.0,1386,0,0.0,345,0.0,1.9,49,19,30
770,1926,0,0.0,771,0,0.0,1155,0,0.0,346,0.8,1.1,63,28,35
5000,10245,112,0.14207264428268335,4129,52,0.1227852856414691,6116,60,0.1587883551050689,347,0.8,1.3,428,206,222
708,1868,0,0.0,745,0,0.0,1123,0,0.0,348,0.8,1.5,27,3,24
1275,2935,0,0.0,1170,0,0.0,1765,0,0.0,349,0.8,1.7,45,14,31
5000,9086,443,0.2323668629155215,3645,168,0.2466743376358557,5441,275,0.22362629654091734,350,0.8,1.9,1413,542,871
580,1526,0,0.0,584,0,0.0,942,0,0.0,351,0.0,1.1,47,20,27
816,2087,0,0.0,818,0,0.0,1269,0,0.0,352,0.0,1.3,45,9,36
635,1627,0,0.0,653,0,0.0,974,0,0.0,353,0.0,1.5,57,22,35
896,2248,0,0.0,889,0,0.0,1359,0,0.0,354,0.0,1.7,70,31,39
502,1376,0,0.0,530,0,0.0,846,0,0.0,355,0.0,1.9,43,18,25
5000,9631,287,0.21972507647690123,3895,92,0.24540110300293366,5736,195,0.2076112588338501,356,0.8,1.1,1054,374,680
807,2005,0,0.0,760,0,0.0,1245,0,0.0,357,0.8,1.3,58,21,37
936,2304,0,0.0,944,0,0.0,1360,0,0.0,358,0.8,1.5,38,7,31
5000,8071,671,0.19093871424746983,3178,281,0.2011219307936847,4893,390,0.18360157617186376,359,0.8,1.7,2285,894,1391
5000,2736,1701,0.13248035070457628,1104,677,0.11807550844871735,1632,1024,0.14200386457881128,360,0.8,1.9,7594,3028,4566
1824,4026,0,0.0,1608,0,0.0,2418,0,0.0,361,0.0,1.1,81,34,47
1132,2584,0,0.0,988,0,0.0,1596,0,0.0,362,0.0,1.3,97,35,62
498,1455,0,0.0,600,0,0.0,855,0,0.0,363,0.0,1.5,19,6,13
1383,3148,0,0.0,1240,0,0.0,1908,0,0.0,364,0.0,1.7,47,22,25
429,1378,0,0.0,570,0,0.0,808,0,0.0,365,0.0,1.9,13,2,11
1002,2356,0,0.0,935,0,0.0,1421,0,0.0,366,0.8,1.1,60,21,39
1001,2424,0,0.0,958,0,0.0,1466,0,0.0,367,0.8,1.3,80,40,40
5000,10395,1,0.0010101502193200496,4146,0,0.0,6249,1,0.0010101502193200496,368,0.8,1.5,34,10,24
2339,5119,0,0.0,2074,0,0.0,3045,0,0.0,369,0.8,1.7,53,11,42
5000,3369,1849,0.1547170527895835,1320,758,0.16103688959471277,2049,1091,0.15032618542176673,370,0.8,1.9,7200,2889,4311
813,2059,0,0.0,849,0,0.0,1210,0,0.0,371,0.0,1.1,40,16,24
1076,2593,0,0.0,1024,0,0.0,1569,0,0.0,372,0.0,1.3,74,28,46
1300,2863,0,0.0,1128,0,0.0,1735,0,0.0,373,0.0,1.5,120,54,66
653,1735,0,0.0,676,0,0.0,1059,0,0.0,374,0.0,1.7,34,12,22
725,1946,0,0.0,813,0,0.0,1133,0,0.0,375,0.0,1.9,58,16,42
5000,7364,897,0.26695159771207294,2781,392,0.27793251254177087,4583,505,0.258427798477931,376,0.8,1.1,3114,1385,1729
5000,8422,623,0.19856425149616014,3407,280,0.20569881595390238,5015,343,0.1927401172449421,377,0.8,1.3,2039,813,1226
637,1675,0,0.0,669,0,0.0,1006,0,0.0,378,0.8,1.5,31,5,26
5000,4721,1458,0.18226842918283465,1863,554,0.18148940869236907,2858,904,0.18274583775774383,379,0.8,1.7,5633,2354,3279
5000,9878,53,0.14648054095259835,3946,11,0.23466377966055932,5932,42,0.12338493081479902,380,0.8,1.9,424,152,272
806,1983,0,0.0,821,0,0.0,1162,0,0.0,381,0.0,1.1,60,15,45
1116,2675,0,0.0,1094,0,0.0,1581,0,0.0,382,0.0,1.3,34,8,26
1050,2505,0,0.0,961,0,0.0,1544,0,0.0,383,0.0,1.5,101,47,54
801,2078,0,0.0,860,0,0.0,1218,0,0.0,384,0.0,1.7,58,16,42
1136,2673,0,0.0,1040,0,0.0,1633,0,0.0,385,0.0,1.9,70,30,40
898,2182,0,0.0,836,0,0.0,1346,0,0.0,386,0.8,1.1,73,36,37
988,2398,0,0.0,965,0,0.0,1433,0,0.0,387,0.8,1.3,89,32,57
5000,8537,622,0.23962461269231447,3450,240,0.2607086202888187,5087,382,0.2263781157730448,388,0.8,1.5,1918,747,1171
5000,7591,828,0.1787555213000014,3058,319,0.18417854324483537,4533,509,0.17535681010078313,389,0.8,1.7,2816,1129,1687
5000,10018,18,0.196364756553017,4028,6,0.2989835098317319,5990,12,0.14505537991365958,390,0.8,1.9,293,128,165
293,994,0,0.0,401,0,0.0,593,0,0.0,391,0.0,1.1,8,6,2
1026,2352,0,0.0,917,0,0.0,1435,0,0.0,392,0.0,1.3,131,44,87
696,1858,0,0.0,724,0,0.0,1134,0,0.0,393,0.0,1.5,45,15,30
435,1314,0,0.0,516,0,0.0,798,0,0.0,394,0.0,1.7,27,11,16
542,1411,0,0.0,572,0,0.0,839,0,0.0,395,0.0,1.9,63,25,38
5000,4139,1768,0.15294661119922193,1660,705,0.14230558279664007,2479,1063,0.1600039254267103,396,0.8,1.1,6201,2474,3727
632,1731,0,0.0,733,0,0.0,998,0,0.0,397,0.8,1.3,41,8,33
5000,2696,1726,0.14307532013295368,1084,698,0.15784205847509017,1612,1028,0.1330488771730206,398,0.8,1.5,7710,3132,4578
462,1376,0,0.0,561,0,0.0,815,0,0.0,399,0.8,1.7,18,12,6
5000,3493,1572,0.14600441333004519,1388,620,0.15097109647824702,2105,952,0.14276980875873727,400,0.8,1.9,6909,2740,4169
1129,2827,0,0.0,1126,0,0.0,1701,0,0.0,401,0.0,1.1,35,13,22
926,2140,0,0.0,829,0,0.0,1311,0,0.0,402,0.0,1.3,154,71,83
968,2414,0,0.0,977,0,0.0,1437,0,0.0,403,0.0,1.5,42,16,26
599,1542,0,0.0,638,0,0.0,904,0,0.0,404,0.0,1.7,51,15,36
929,2249,0,0.0,903,0,0.0,1346,0,0.0,405,0.0,1.9,34,16,18
977,2320,0,0.0,936,0,0.0,1384,0,0.0,406,0.8,1.1,31,4,27
5000,8901,440,0.221153465269151,3680,162,0.22147966707420608,5221,278,0.22096337644750025,407,0.8,1.3,1468,522,946
517,1468,0,0.0,564,0,0.0,904,0,0.0,408,0.8,1.5,24,11,13
1470,3494,0,0.0,1383,0,0.0,2111,0,0.0,409,0.8,1.7,52,22,30
427,1308,0,0.0,493,0,0.0,815,0,0.0,410,0.8,1.9,24,6,18
929,2159,0,0.0,904,0,0.0,1255,0,0.0,411,0.0,1.1,75,14,61
739,1892,0,0.0,779,0,0.0,1113,0,0.0,412,0.0,1.3,37,8,29
749,1885,0,0.0,751,0,0.0,1134,0,0.0,413,0.0,1.5,61,20,41
813,2136,0,0.0,850,0,0.0,1286,0,0.0,414,0.0,1.7,51,18,33
1267,3011,0,0.0,1197,0,0.0,1814,0,0.0,415,0.0,1.9,69,35,34
5000,4305,1641,0.14611569269318825,1776,592,0.1479824185388713,2529,1049,0.14506221156769308,416,0.8,1.1,6271,2435,3836
5000,7730,797,0.22253980631567072,3100,323,0.2090183965523586,4630,474,0.23175376275775902,417,0.8,1.3,2833,1131,1702
2225,4846,0,0.0,1960,0,0.0,2886,0,0.0,418,0.8,1.5,115,44,71
5000,7465,1012,0.1901103075071294,3020,393,0.20794190623205788,4445,619,0.1787891147787013,419,0.8,1.7,3195,1239,1956
5000,10220,2,0.16698761772752058,4069,0,0.0,6151,2,0.16698761772752058,420,0.8,1.9,165,62,103
1296,2914,0,0.0,1161,0,0.0,1753,0,0.0,421,0.0,1.1,82,30,52
1185,2655,0,0.0,1071,0,0.0,1584,0,0.0,422,0.0,1.3,101,38,63
559,1606,0,0.0,627,0,0.0,979,0,0.0,423,0.0,1.5,34,18,16
838,2038,0,0.0,792,0,0.0,1246,0,0.0,424,0.0,1.7,89,27,62
739,1917,0,0.0,760,0,0.0,1157,0,0.0,425,0.0,1.9,59,24,35
5000,9487,210,0.16155735565588059,3732,69,0.17531758867654224,5755,141,0.15482362460321636,426,0.8,1.1,875,309,566
620,1746,0,0.0,671,0,0.0,1075,0,0.0,427,0.8,1.3,18,0,18
5000,5993,1358,0.16437203119529648,2444,524,0.1614192889535714,3549,834,0.16622723135676407,428,0.8,1.5,4518,1738,2780
5000,7660,846,0.20132567841982452,3079,295,0.19654260662939824,4581,551,0.20388648818057895,429,0.8,1.7,2979,1051,1928
5000,8357,580,0.2267786466207136,3453,226,0.225641273554304,4904,354,0.22750476614898635,430,0.8,1.9,2198,849,1349
1536,3274,0,0.0,1249,0,0.0,2025,0,0.0,431,0.0,1.1,196,80,116
678,1822,0,0.0,730,0,0.0,1092,0,0.0,432,0.0,1.3,30,14,16
904,2384,0,0.0,992,0,0.0,1392,0,0.0,433,0.0,1.5,39,14,25
639,1697,0,0.0,691,0,0.0,1006,0,0.0,434,0.0,1.7,80,18,62
586,1623,0,0.0,661,0,0.0,962,0,0.0,435,0.0,1.9,44,16,28
648,1758,0,0.0,712,0,0.0,1046,0,0.0,436,0.8,1.1,39,9,30
5000,10129,83,0.20580722573597132,4082,28,0.2024487810371519,6047,55,0.20751697940082495,437,0.8,1.3,353,120,233
5000,10191,7,0.07701717932268523,4053,1,0.05,6138,6,0.08152004254313276,438,0.8,1.5,126,23,103
1016,2435,0,0.0,943,0,0.0,1492,0,0.0,439,0.8,1.7,54,19,35
5000,4768,1604,0.16876878515749294,1896,621,0.16331542832072132,2872,983,0.17221388647553487,440,0.8,1.9,5829,2389,3440
799,2039,0,0.0,818,0,0.0,1221,0,0.0,441,0.0,1.1,50,10,40
1160,2728,0,0.0,1112,0,0.0,1616,0,0.0,442,0.0,1.3,68,40,28
1300,2876,0,0.0,1149,0,0.0,1727,0,0.0,443,0.0,1.5,123,52,71
1088,2598,0,0.0,1046,0,0.0,1552,0,0.0,444,0.0,1.7,99,43,56
938,2306,0,0.0,901,0,0.0,1405,0,0.0,445,0.0,1.9,83,43,40
5000,4564,1464,0.1852443257304071,1825,591,0.18324213019281652,2739,873,0.18659976394657668,446,0.8,1.1,5911,2389,3522
323,1112,0,0.0,450,0,0.0,662,0,0.0,447,0.8,1.3,19,6,13
1314,3056,0,0.0,1216,0,0.0,1840,0,0.0,448,0.8,1.5,89,36,53
430,1264,0,0.0,513,0,0.0,751,0,0.0,449,0.8,1.7,35,5,30
1084,2538,0,0.0,1005,0,0.0,1533,0,0.0,450,0.8,1.9,28,13,15
424,1294,0,0.0,530,0,0.0,764,0,0.0,451,0.0,1.1,59,27,32
441,1276,0,0.0,522,0,0.0,754,0,0.0,452,0.0,1.3,38,13,25
494,1438,0,0.0,557,0,0.0,881,0,0.0,453,0.0,1.5,35,8,27
1634,3479,0,0.0,1345,0,0.0,2134,0,0.0,454,0.0,1.7,276,133,143
811,2049,0,0.0,825,0,0.0,1224,0,0.0,455,0.0,1.9,59,25,34
5000,8873,545,0.21861458566171074,3574,224,0.20628107820209987,5299,321,0.2272211453843053,456,0.8,1.1,1759,692,1067
1298,3068,0,0.0,1239,0,0.0,1829,0,0.0,457,0.8,1.3,67,20,47
5000,4371,1649,0.17109797104960417,1682,666,0.17692452210319076,2689,983,0.1671503789827794,458,0.8,1.5,6123,2428,3695
927,2272,0,0.0,898,0,0.0,1374,0,0.0,459,0.8,1.7,41,4,37
2548,5560,0,0.0,2226,0,0.0,3334,0,0.0,460,0.8,1.9,33,9,24
1340,3054,0,0.0,1189,0,0.0,1865,0,0.0,461,0.0,1.1,100,49,51
1092,2527,0,0.0,1017,0,0.0,1510,0,0.0,462,0.0,1.3,112,39,73
1342,3018,0,0.0,1244,0,0.0,1774,0,0.0,463,0.0,1.5,136,46,90
1124,2619,0,0.0,1059,0,0.0,1560,0,0.0,464,0.0,1.7,109,35,74
717,1910,0,0.0,756,0,0.0,1154,0,0.0,465,0.0,1.9,35,16,19
5000,3049,1603,0.14404303519885614,1214,616,0.150656502795546,1835,987,0.1399154809541136,466,0.8,1.1,7381,2930,4451
499,1477,0,0.0,581,0,0.0,896,0,0.0,467,0.8,1.3,21,7,14
5000,9511,346,0.15835650389092853,3737,155,0.16029424123201164,5774,191,0.15678399453036385,468,0.8,1.5,984,412,572
5000,4838,1644,0.1719404326406028,1935,679,0.17998033965591578,2903,965,0.16628333744537213,469,0.8,1.7,5599,2252,3347
5000,8982,577,0.19554085079287528,3617,234,0.18822278319577931,5365,343,0.20053335171917405,470,0.8,1.9,1575,631,944
599,1643,0,0.0,622,0,0.0,1021,0,0.0,471,0.0,1.1,36,10,26
762,1896,0,0.0,743,0,0.0,1153,0,0.0,472,0.0,1.3,73,31,42
2079,4458,0,0.0,1761,0,0.0,2697,0,0.0,473,0.0,1.5,160,62,98
1692,3695,0,0.0,1506,0,0.0,2189,0,0.0,474,0.0,1.7,119,61,58
837,2133,0,0.0,882,0,0.0,1251,0,0.0,475,0.0,1.9,70,22,48
732,1913,0,0.0,762,0,0.0,1151,0,0.0,476,0.8,1.1,52,17,35
844,2101,0,0.0,818,0,0.0,1283,0,0.0,477,0.8,1.3,71,26,45
5000,10505,1,0.05,4315,0,0.0,6190,1,0.05,478,0.8,1.5,110,36,74
901,2209,0,0.0,885,0,0.0,1324,0,0.0,479,0.8,1.7,30,4,26
5000,7169,967,0.23367282627538533,2803,400,0.2360083532727141,4366,567,0.23202518818203152,480,0.8,1.9,3285,1393,1892
408,1270,0,0.0,525,0,0.0,745,0,0.0,481,0.0,1.1,27,8,19
1455,3228,0,0.0,1284,0,0.0,1944,0,0.0,482,0.0,1.3,91,32,59
1090,2595,0,0.0,1052,0,0.0,1543,0,0.0,483,0.0,1.5,106,39,67
585,1618,0,0.0,672,0,0.0,946,0,0.0,484,0.0,1.7,23,10,13
696,1844,0,0.0,747,0,0.0,1097,0,0.0,485,0.0,1.9,46,10,36
5000,6187,1062,0.20939958268550543,2437,417,0.21628003635399098,3750,645,0.20495128938355434,486,0.8,1.1,4241,1751,2490
641,1646,0,0.0,695,0,0.0,951,0,0.0,487,0.8,1.3,47,13,34
5000,9620,272,0.19044390441768666,3763,106,0.19173344682086718,5857,166,0.18962046167830648,488,0.8,1.5,948,393,555
348,1199,0,0.0,483,0,0.0,716,0,0.0,489,0.8,1.7,17,4,13
5000,8695,590,0.2097146654637086,3491,243,0.20453045249137275,5204,347,0.21334510855384584,490,0.8,1.9,1836,699,1137
323,1098,0,0.0,444,0,0.0,654,0,0.0,491,0.0,1.1,20,9,11
885,2184,0,0.0,890,0,0.0,1294,0,0.0,492,0.0,1.3,71,23,48
741,1899,0,0.0,776,0,0.0,1123,0,0.0,493,0.0,1.5,60,26,34
442,1397,0,0.0,563,0,0.0,834,0,0.0,494,0.0,1.7,22,7,15
1308,2939,0,0.0,1139,0,0.0,1800,0,0.0,495,0.0,1.9,99,44,55
661,1770,0,0.0,688,0,0.0,1082,0,0.0,496,0.8,1.1,40,12,28
5000,9297,314,0.28747463243172555,3788,125,0.31002217168247775,5509,189,0.27256223874736574,497,0.8,1.3,1139,458,681
589,1666,0,0.0,682,0,0.0,984,0,0.0,498,0.8,1.5,33,15,18
1353,3153,0,0.0,1251,0,0.0,1902,0,0.0,499,0.8,1.7,68,20,48
1210,2852,0,0.0,1198,0,0.0,1654,0,0.0,500,0.8,1.9,20,3,17
2156,4653,0,0.0,1865,0,0.0,2788,0,0.0,501,0.0,1.1,105,43,62
1253,2817,0,0.0,1133,0,0.0,1684,0,0.0,502,0.0,1.3,141,52,89
564,1522,0,0.0,601,0,0.0,921,0,0.0,503,0.0,1.5,71,29,42
800,2015,0,0.0,822,0,0.0,1193,0,0.0,504,0.0,1.7,55,19,36
523,1447,0,0.0,567,0,0.0,880,0,0.0,505,0.0,1.9,62,21,41
3943,8259,0,0.0,3319,0,0.0,4940,0,0.0,506,0.8,1.1,108,51,57
1075,2498,0,0.0,980,0,0.0,1518,0,0.0,507,0.8,1.3,81,29,52
924,2233,0,0.0,881,0,0.0,1352,0,0.0,508,0.8,1.5,51,13,38
873,2211,0,0.0,868,0,0.0,1343,0,0.0,509,0.8,1.7,74,38,36
5000,5141,1537,0.1841090365192115,2134,573,0.19195198471879998,3007,964,0.17944720112671747,510,0.8,1.9,5306,2032,3274
424,1313,0,0.0,519,0,0.0,794,0,0.0,511,0.0,1.1,23,4,19
1065,2567,0,0.0,1015,0,0.0,1552,0,0.0,512,0.0,1.3,48,20,28
1224,2937,0,0.0,1144,0,0.0,1793,0,0.0,513,0.0,1.5,69,24,45
963,2338,0,0.0,934,0,0.0,1404,0,0.0,514,0.0,1.7,110,40,70
1618,3487,0,0.0,1381,0,0.0,2106,0,0.0,515,0.0,1.9,188,79,109
5000,6404,1069,0.20232745249037312,2602,410,0.20200520478995984,3802,659,0.2025279404375195,516,0.8,1.1,4018,1588,2430
1123,2693,0,0.0,1093,0,0.0,1600,0,0.0,517,0.8,1.3,51,15,36
5000,10574,1,0.017483025134783087,4237,1,0.017483025134783087,6337,0,0.0,518,0.8,1.5,121,38,83
1407,3178,0,0.0,1268,0,0.0,1910,0,0.0,519,0.8,1.7,82,32,50
320,1085,0,0.0,434,0,0.0,651,0,0.0,520,0.8,1.9,23,11,12
951,2348,0,0.0,950,0,0.0,1398,0,0.0,521,0.0,1.1,64,16,48
2076,4391,0,0.0,1795,0,0.0,2596,0,0.0,522,0.0,1.3,180,75,105
1880,4130,0,0.0,1609,0,0.0,2521,0,0.0,523,0.0,1.5,106,40,66
1313,2891,0,0.0,1132,0,0.0,1759,0,0.0,524,0.0,1.7,183,94,89
1023,2307,0,0.0,961,0,0.0,1346,0,0.0,525,0.0,1.9,153,64,89
5000,9323,358,0.1961970943295956,3674,141,0.19736395477969593,5649,217,0.19543890389888527,526,0.8,1.1,1129,458,671
5000,3698,1597,0.17160741591363932,1489,586,0.16285236948923645,2209,1011,0.17668205212006868,527,0.8,1.3,6879,2738,4141
876,2215,0,0.0,898,0,0.0,1317,0,0.0,528,0.8,1.5,35,14,21
5000,5263,1289,0.1796336324551948,2125,527,0.182590160089551,3138,762,0.17758889483930815,529,0.8,1.7,4951,2049,2902
451,1336,0,0.0,521,0,0.0,815,0,0.0,530,0.8,1.9,35,11,24
948,2157,0,0.0,855,0,0.0,1302,0,0.0,531,0.0,1.1,187,86,101
793,2049,0,0.0,830,0,0.0,1219,0,0.0,532,0.0,1.3,31,12,19
1138,2575,0,0.0,1031,0,0.0,1544,0,0.0,533,0.0,1.5,101,51,50
909,2254,0,0.0,893,0,0.0,1361,0,0.0,534,0.0,1.7,115,51,64
1344,3015,0,0.0,1219,0,0.0,1796,0,0.0,535,0.0,1.9,97,44,53
976,2329,0,0.0,956,0,0.0,1373,0,0.0,536,0.8,1.1,65,23,42
5000,6657,1230,0.2068067888925413,2723,484,0.22106088863265233,3934,746,0.19755882069654446,537,0.8,1.3,3986,1532,2454
1443,3294,0,0.0,1305,0,0.0,1989,0,0.0,538,0.8,1.5,103,27,76
5000,9134,455,0.1881830055614327,3613,153,0.1918132990027006,5521,302,0.18634381716237963,539,0.8,1.7,1499,559,940
5000,9389,432,0.24724941959810987,3829,159,0.27797787955363074,5560,273,0.22935262423939987,540,0.8,1.9,1291,466,825
594,1612,0,0.0,639,0,0.0,973,0,0.0,541,0.0,1.1,51,14,37
662,1777,0,0.0,718,0,0.0,1059,0,0.0,542,0.0,1.3,35,12,23
2057,4497,0,0.0,1750,0,0.0,2747,0,0.0,543,0.0,1.5,138,59,79
934,2353,0,0.0,919,0,0.0,1434,0,0.0,544,0.0,1.7,70,12,58
617,1774,0,0.0,729,0,0.0,1045,0,0.0,545,0.0,1.9,47,20,27
5000,5899,1294,0.20127490575432785,2334,487,0.19703244982315093,3565,807,0.20383509911056477,546,0.8,1.1,4563,1842,2721
1031,2482,0,0.0,1005,0,0.0,1477,0,0.0,547,0.8,1.3,43,13,30
1259,2981,0,0.0,1176,0,0.0,1805,0,0.0,548,0.8,1.5,63,19,44
5000,6735,1132,0.2188285720954199,2624,450,0.2155834428395408,4111,682,0.2209697864138151,549,0.8,1.7,3673,1588,2085
5000,10010,103,0.31966740296951685,3995,54,0.37695194707935675,6015,49,0.25653749721581603,550,0.8,1.9,364,161,203
379,1264,0,0.0,503,0,0.0,761,0,0.0,551,0.0,1.1,15,6,9
452,1385,0,0.0,593,0,0.0,792,0,0.0,552,0.0,1.3,26,8,18
583,1599,0,0.0,640,0,0.0,959,0,0.0,553,0.0,1.5,29,10,19
1462,3399,0,0.0,1377,0,0.0,2022,0,0.0,554,0.0,1.7,88,30,58
1391,3146,0,0.0,1232,0,0.0,1914,0,0.0,555,0.0,1.9,81,42,39
5000,10292,30,0.16044078088349636,4144,11,0.042388326916412006,6148,19,0.22878693844338732,556,0.8,1.1,263,81,182
401,1280,0,0.0,505,0,0.0,775,0,0.0,557,0.8,1.3,18,5,13
5000,10084,71,0.18928868398295162,3967,28,0.25707985520780363,6117,43,0.14514559574351307,558,0.8,1.5,214,73,141
401,1237,0,0.0,525,0,0.0,712,0,0.0,559,0.8,1.7,29,12,17
5000,10537,1,0.05,4173,0,0.0,6364,1,0.05,560,0.8,1.9,103,47,56
1315,3108,0,0.0,1251,0,0.0,1857,0,0.0,561,0.0,1.1,50,13,37
1152,2706,0,0.0,1050,0,0.0,1656,0,0.0,562,0.0,1.3,83,30,53
588,1632,0,0.0,659,0,0.0,973,0,0.0,563,0.0,1.5,28,12,16
496,1446,0,0.0,583,0,0.0,863,0,0.0,564,0.0,1.7,29,12,17
438,1323,0,0.0,537,0,0.0,786,0,0.0,565,0.0,1.9,20,3,17
681,1736,0,0.0,680,0,0.0,1056,0,0.0,566,0.8,1.1,84,33,51
1573,3666,0,0.0,1446,0,0.0,2220,0,0.0,567,0.8,1.3,46,22,24
5000,9754,184,0.1766716456731973,3915,77,0.18818138477930266,5839,107,0.16838893622300935,568,0.8,1.5,551,226,325
5000,5045,1666,0.18429232920700217,1982,667,0.19198127573611232,3063,999,0.1791586682110897,569,0.8,1.7,5593,2271,3322
5000,7631,806,0.2025137560809966,3089,309,0.2048118491148492,4542,497,0.2010849618205127,570,0.8,1.9,2809,1081,1728
793,2001,0,0.0,765,0,0.0,1236,0,0.0,571,0.0,1.1,80,35,45
1637,3574,0,0.0,1380,0,0.0,2194,0,0.0,572,0.0,1.3,172,79,93
869,2139,0,0.0,856,0,0.0,1283,0,0.0,573,0.0,1.5,44,8,36
973,2266,0,0.0,893,0,0.0,1373,0,0.0,574,0.0,1.7,123,58,65
1018,2352,0,0.0,961,0,0.0,1391,0,0.0,575,0.0,1.9,143,61,82
799,2027,0,0.0,805,0,0.0,1222,0,0.0,576,0.8,1.1,40,22,18
846,2136,0,0.0,827,0,0.0,1309,0,0.0,577,0.8,1.3,48,10,38
996,2439,0,0.0,1001,0,0.0,1438,0,0.0,578,0.8,1.5,70,21,49
5000,10012,88,0.17056724805023807,4103,39,0.176372723840636,5909,49,0.1659465632374724,579,0.8,1.7,397,131,266
5000,7786,718,0.20342572878968485,3124,255,0.2208275658665379,4662,463,0.1938415636609644,580,0.8,1.9,2533,1012,1521
867,2173,0,0.0,879,0,0.0,1294,0,0.0,581,0.0,1.1,79,22,57
709,1813,0,0.0,726,0,0.0,1087,0,0.0,582,0.0,1.3,48,21,27
1668,3670,0,0.0,1398,0,0.0,2272,0,0.0,583,0.0,1.5,139,51,88
650,1756,0,0.0,718,0,0.0,1038,0,0.0,584,0.0,1.7,30,15,15
657,1725,0,0.0,714,0,0.0,1011,0,0.0,585,0.0,1.9,73,26,47
720,1868,0,0.0,773,0,0.0,1095,0,0.0,586,0.8,1.1,57,23,34
5000,9017,433,0.19501399158416616,3645,172,0.1564716343710064,5372,261,0.22041355265950532,587,0.8,1.3,1438,571,867
868,2177,0,0.0,888,0,0.0,1289,0,0.0,588,0.8,1.5,45,26,19
1376,3182,0,0.0,1252,0,0.0,1930,0,0.0,589,0.8,1.7,31,16,15
5000,10442,31,0.12066487370378494,4208,12,0.04957037822856111,6234,19,0.1655666603197158,590,0.8,1.9,183,84,99
1398,2986,0,0.0,1226,0,0.0,1760,0,0.0,591,0.0,1.1,234,72,162
1329,3089,0,0.0,1259,0,0.0,1830,0,0.0,592,0.0,1.3,32,10,22
1949,4230,0,0.0,1714,0,0.0,2516,0,0.0,593,0.0,1.5,140,55,85
747,1911,0,0.0,779,0,0.0,1132,0,0.0,594,0.0,1.7,46,18,28
805,1961,0,0.0,800,0,0.0,1161,0,0.0,595,0.0,1.9,87,35,52
5000,9624,198,0.1824497328071046,3829,73,0.1959445788742323,5795,125,0.1745687427039021,596,0.8,1.1,634,220,414
455,1353,0,0.0,535,0,0.0,818,0,0.0,597,0.8,1.3,29,11,18
274,1002,0,0.0,392,0,0.0,610,0,0.0,598,0.8,1.5,15,4,11
5000,4740,1465,0.1798949567643532,1812,575,0.1801183223845064,2928,890,0.1797506475153778,599,0.8,1.7,5832,2350,3482
5000,6933,1096,0.19520164531414866,2799,393,0.2020612922596555,4134,703,0.19136687824503898,600,0.8,1.9,3515,1273,2242
875,2166,0,0.0,869,0,0.0,1297,0,0.0,601,0.0,1.1,49,25,24
736,1971,0,0.0,835,0,0.0,1136,0,0.0,602,0.0,1.3,59,26,33
690,1758,0,0.0,736,0,0.0,1022,0,0.0,603,0.0,1.5,52,17,35
692,1867,0,0.0,741,0,0.0,1126,0,0.0,604,0.0,1.7,65,33,32
782,2002,0,0.0,826,0,0.0,1176,0,0.0,605,0.0,1.9,78,40,38
809,1981,0,0.0,835,0,0.0,1146,0,0.0,606,0.8,1.1,76,18,58
5000,9530,267,0.23455765883857996,3869,107,0.27108871636846077,5661,160,0.21012751411547223,607,0.8,1.3,845,313,532
1520,3422,0,0.0,1348,0,0.0,2074,0,0.0,608,0.8,1.5,44,20,24
1192,2818,0,0.0,1140,0,0.0,1678,0,0.0,609,0.8,1.7,41,12,29
1149,2760,0,0.0,1163,0,0.0,1597,0,0.0,610,0.8,1.9,81,19,62
900,2196,0,0.0,919,0,0.0,1277,0,0.0,611,0.0,1.1,47,15,32
1543,3544,0,0.0,1421,0,0.0,2123,0,0.0,612,0.0,1.3,153,57,96
393,1256,0,0.0,517,0,0.0,739,0,0.0,613,0.0,1.5,22,4,18
250,998,0,0.0,388,0,0.0,610,0,0.0,614,0.0,1.7,8,1,7
1419,3218,0,0.0,1247,0,0.0,1971,0,0.0,615,0.0,1.9,109,61,48
5000,4932,1728,0.15617255860833973,1919,722,0.15580479484357615,3013,1006,0.15643650039577445,616,0.8,1.1,5503,2225,3278
1254,3007,0,0.0,1222,0,0.0,1785,0,0.0,617,0.8,1.3,55,12,43
5000,9135,467,0.239396296312003,3660,170,0.24754157037713276,5475,297,0.2347340182275852,618,0.8,1.5,1419,523,896
5000,5735,1338,0.17942949669215927,2289,561,0.17567708497902956,3446,777,0.18213876692519115,619,0.8,1.7,4734,1899,2835
2120,4515,0,0.0,1763,0,0.0,2752,0,0.0,620,0.8,1.9,157,59,98
1014,2464,0,0.0,968,0,0.0,1496,0,0.0,621,0.0,1.1,60,17,43
395,1173,0,0.0,469,0,0.0,704,0,0.0,622,0.0,1.3,26,12,14
334,1137,0,0.0,468,0,0.0,669,0,0.0,623,0.0,1.5,18,6,12
481,1436,0,0.0,592,0,0.0,844,0,0.0,624,0.0,1.7,31,6,25
356,1178,0,0.0,475,0,0.0,703,0,0.0,625,0.0,1.9,31,8,23
818,2049,0,0.0,843,0,0.0,1206,0,0.0,626,0.8,1.1,42,15,27
544,1551,0,0.0,612,0,0.0,939,0,0.0,627,0.8,1.3,23,6,17
5000,5047,1323,0.1812095356230665,2042,544,0.18294743734050845,3005,779,0.17999590464195173,628,0.8,1.5,5424,2226,3198
5000,3116,1848,0.14559909239759722,1178,711,0.14331679144241943,1938,1137,0.1470262832323653,629,0.8,1.7,7330,2929,4401
846,2168,0,0.0,868,0,0.0,1300,0,0.0,630,0.8,1.9,37,17,20
342,1141,0,0.0,437,0,0.0,704,0,0.0,631,0.0,1.1,16,8,8
1050,2410,0,0.0,928,0,0.0,1482,0,0.0,632,0.0,1.3,151,68,83
480,1387,0,0.0,578,0,0.0,809,0,0.0,633,0.0,1.5,37,12,25
736,1882,0,0.0,770,0,0.0,1112,0,0.0,634,0.0,1.7,69,23,46
836,2039,0,0.0,844,0,0.0,1195,0,0.0,635,0.0,1.9,56,16,40
5000,9171,288,0.2700062401553614,3659,98,0.2883553447140332,5512,190,0.2605419651724675,636,0.8,1.1,1443,585,858
5000,8734,501,0.1770003474689319,3599,177,0.18616436435644573,5135,324,0.1719940789840864,637,0.8,1.3,1633,561,1072
991,2366,0,0.0,986,0,0.0,1380,0,0.0,638,0.8,1.5,68,35,33
5000,7622,834,0.20701196427452367,3178,313,0.19728381965538305,4444,521,0.21285631987105144,639,0.8,1.7,2954,1107,1847
582,1590,0,0.0,632,0,0.0,958,0,0.0,640,0.8,1.9,32,13,19
455,1355,0,0.0,550,0,0.0,805,0,0.0,641,0.0,1.1,25,6,19
407,1277,0,0.0,497,0,0.0,780,0,0.0,642,0.0,1.3,35,12,23
1531,3383,0,0.0,1331,0,0.0,2052,0,0.0,643,0.0,1.5,167,62,105
855,2030,0,0.0,788,0,0.0,1242,0,0.0,644,0.0,1.7,78,29,49
754,1939,0,0.0,786,0,0.0,1153,0,0.0,645,0.0,1.9,43,15,28
3308,6885,0,0.0,2791,0,0.0,4094,0,0.0,646,0.8,1.1,174,62,112
772,1937,0,0.0,783,0,0.0,1154,0,0.0,647,0.8,1.3,54,24,30
5000,4988,1764,0.17027673045487923,1967,792,0.17070323976762153,3021,972,0.1699292043482004,648,0.8,1.5,5508,2329,3179
5000,8452,665,0.19251665673664595,3379,260,0.17052524552890935,5073,405,0.20663459973420528,649,0.8,1.7,2207,911,1296
5000,5342,1616,0.17474102133381944,2160,651,0.17594483455509455,3182,965,0.17392891521252396,650,0.8,1.9,5125,2017,3108
680,1767,0,0.0,695,0,0.0,1072,0,0.0,651,0.0,1.1,72,37,35
897,2266,0,0.0,955,0,0.0,1311,0,0.0,652,0.0,1.3,93,32,61
421,1353,0,0.0,519,0,0.0,834,0,0.0,653,0.0,1.5,21,8,13
996,2357,0,0.0,957,0,0.0,1400,0,0.0,654,0.0,1.7,81,34,47
780,2025,0,0.0,781,0,0.0,1244,0,0.0,655,0.0,1.9,28,1,27
871,2158,0,0.0,859,0,0.0,1299,0,0.0,656,0.8,1.1,47,15,32
5000,8536,438,0.21000016985233855,3510,164,0.23915172012927335,5026,274,0.1925517966938812,657,0.8,1.3,1836,715,1121
931,2283,0,0.0,856,0,0.0,1427,0,0.0,658,0.8,1.5,96,55,41
1240,2756,0,0.0,1101,0,0.0,1655,0,0.0,659,0.8,1.7,155,48,107
5000,9634,300,0.19038449336991833,3863,120,0.2095069172662163,5771,180,0.17763621077238645,660,0.8,1.9,707,303,404
783,1936,0,0.0,799,0,0.0,1137,0,0.0,661,0.0,1.1,54,15,39
1110,2490,0,0.0,994,0,0.0,1496,0,0.0,662,0.0,1.3,140,65,75
874,2130,0,0.0,901,0,0.0,1229,0,0.0,663,0.0,1.5,61,21,40
717,1937,0,0.0,744,0,0.0,1193,0,0.0,664,0.0,1.7,34,13,21
503,1405,0,0.0,550,0,0.0,855,0,0.0,665,0.0,1.9,48,22,26
5000,7918,868,0.2139804463772037,3087,391,0.20214191249758529,4831,477,0.2236845695363876,666,0.8,1.1,2557,1117,1440
5000,6175,1175,0.19513926237925588,2524,490,0.20359385243597009,3651,685,0.18909145343357714,667,0.8,1.3,4281,1640,2641
5000,9451,330,0.21077791982537006,3767,140,0.20549308211026593,5684,190,0.2146720107733415,668,0.8,1.5,1079,447,632
1018,2420,0,0.0,994,0,0.0,1426,0,0.0,669,0.8,1.7,24,4,20
5000,10500,23,0.07385028041416565,4223,12,0.0638877018810593,6277,11,0.08471854790482712,670,0.8,1.9,137,52,85
587,1632,0,0.0,680,0,0.0,952,0,0.0,671,0.0,1.1,46,19,27
507,1458,0,0.0,587,0,0.0,871,0,0.0,672,0.0,1.3,42,13,29
551,1581,0,0.0,607,0,0.0,974,0,0.0,673,0.0,1.5,18,6,12
1116,2579,0,0.0,986,0,0.0,1593,0,0.0,674,0.0,1.7,64,23,41
595,1587,0,0.0,646,0,0.0,941,0,0.0,675,0.0,1.9,25,3,22
5000,3412,1885,0.14535505010260433,1286,821,0.14133569144936878,2126,1064,0.14845645372507263,676,0.8,1.1,7223,2996,4227
5000,8097,754,0.19629712374867542,3236,302,0.18067839639849714,4861,452,0.2067326451198122,677,0.8,1.3,2399,958,1441
612,1644,0,0.0,652,0,0.0,992,0,0.0,678,0.8,1.5,47,21,26
5000,10357,56,0.15682876266041484,4196,17,0.18528145813468466,6161,39,0.14442630565881,679,0.8,1.7,258,71,187
757,1967,0,0.0,776,0,0.0,1191,0,0.0,680,0.8,1.9,76,21,55
485,1373,0,0.0,541,0,0.0,832,0,0.0,681,0.0,1.1,40,18,22
882,2096,0,0.0,825,0,0.0,1271,0,0.0,682,0.0,1.3,104,53,51
1000,2426,0,0.0,971,0,0.0,1455,0,0.0,683,0.0,1.5,69,25,44
616,1658,0,0.0,687,0,0.0,971,0,0.0,684,0.0,1.7,53,26,27
730,1773,0,0.0,751,0,0.0,1022,0,0.0,685,0.0,1.9,53,13,40
5000,7556,898,0.19336644705524345,2981,384,0.18972107773352462,4575,514,0.19608983580921222,686,0.8,1.1,2910,1241,1669
1151,2713,0,0.0,1087,0,0.0,1626,0,0.0,687,0.8,1.3,46,13,33
5000,2971,1808,0.14737927441952672,1153,676,0.14846767795347907,1818,1132,0.14672930905826181,688,0.8,1.5,7279,2861,4418
5000,10139,25,0.11041936154040918,4051,1,0.17727583433588515,6088,24,0.10763367517393103,689,0.8,1.7,249,62,187
465,1416,0,0.0,575,0,0.0,841,0,0.0,690,0.8,1.9,21,11,10
726,1882,0,0.0,747,0,0.0,1135,0,0.0,691,0.0,1.1,57,21,36
1615,3518,0,0.0,1336,0,0.0,2182,0,0.0,692,0.0,1.3,182,93,89
510,1447,0,0.0,585,0,0.0,862,0,0.0,693,0.0,1.5,39,13,26
943,2281,0,0.0,935,0,0.0,1346,0,0.0,694,0.0,1.7,74,35,39
699,1936,0,0.0,828,0,0.0,1108,0,0.0,695,0.0,1.9,20,7,13
5000,7689,996,0.20603958633265387,3102,398,0.21718755164597217,4587,598,0.198620037512084,696,0.8,1.1,2751,1066,1685
5000,8149,884,0.16597200795014788,3216,384,0.17471158877599288,4933,500,0.15926000987589883,697,0.8,1.3,2228,906,1322
1396,3278,0,0.0,1330,0,0.0,1948,0,0.0,698,0.8,1.5,52,17,35
1186,2809,0,0.0,1108,0,0.0,1701,0,0.0,699,0.8,1.7,31,4,27
673,1719,0,0.0,692,0,0.0,1027,0,0.0,700,0.8,1.9,43,19,24
753,1908,0,0.0,772,0,0.0,1136,0,0.0,701,0.0,1.1,60,28,32
2265,4578,0,0.0,1807,0,0.0,2771,0,0.0,702,0.0,1.3,328,153,175
864,2117,0,0.0,865,0,0.0,1252,0,0.0,703,0.0,1.5,37,12,25
1088,2550,0,0.0,1054,0,0.0,1496,0,0.0,704,0.0,1.7,86,25,61
550,1541,0,0.0,611,0,0.0,930,0,0.0,705,0.0,1.9,32,6,26
5000,5736,1247,0.17751804267496385,2262,488,0.19409952889414464,3474,759,0.16685695535617573,706,0.8,1.1,4704,1853,2851
888,2097,0,0.0,868,0,0.0,1229,0,0.0,707,0.8,1.3,81,34,47
590,1622,0,0.0,655,0,0.0,967,0,0.0,708,0.8,1.5,29,10,19
494,1410,0,0.0,558,0,0.0,852,0,0.0,709,0.8,1.7,41,13,28
5000,9628,199,0.23802819757987773,3875,73,0.2429746625437903,5753,126,0.23516238851348406,710,0.8,1.9,746,299,447
1252,2916,0,0.0,1187,0,0.0,1729,0,0.0,711,0.0,1.1,96,34,62
1076,2585,0,0.0,1047,0,0.0,1538,0,0.0,712,0.0,1.3,86,35,51
918,2271,0,0.0,868,0,0.0,1403,0,0.0,713,0.0,1.5,83,36,47
600,1585,0,0.0,631,0,0.0,954,0,0.0,714,0.0,1.7,65,14,51
1409,3127,0,0.0,1253,0,0.0,1874,0,0.0,715,0.0,1.9,162,61,101
1134,2653,0,0.0,1060,0,0.0,1593,0,0.0,716,0.8,1.1,80,37,43
5000,5125,1509,0.19688022826852455,2065,605,0.19398388669032401,3060,904,0.19881859846189995,717,0.8,1.3,5160,2059,3101
816,2024,0,0.0,848,0,0.0,1176,0,0.0,718,0.8,1.5,42,9,33
451,1341,0,0.0,529,0,0.0,812,0,0.0,719,0.8,1.7,31,6,25
1741,3769,0,0.0,1466,0,0.0,2303,0,0.0,720,0.8,1.9,74,30,44
948,2252,0,0.0,916,0,0.0,1336,0,0.0,721,0.0,1.1,55,24,31
2110,4467,0,0.0,1737,0,0.0,2730,0,0.0,722,0.0,1.3,279,137,142
1279,2902,0,0.0,1135,0,0.0,1767,0,0.0,723,0.0,1.5,148,67,81
681,1805,0,0.0,771,0,0.0,1034,0,0.0,724,0.0,1.7,34,12,22
648,1763,0,0.0,724,0,0.0,1039,0,0.0,725,0.0,1.9,43,12,31
580,1567,0,0.0,636,0,0.0,931,0,0.0,726,0.8,1.1,47,14,33
5000,7778,930,0.20614604029740427,3178,374,0.21005269934915335,4600,556,0.20351817971223482,727,0.8,1.3,2798,1133,1665
868,2196,0,0.0,869,0,0.0,1327,0,0.0,728,0.8,1.5,28,4,24
658,1721,0,0.0,700,0,0.0,1021,0,0.0,729,0.8,1.7,46,14,32
5000,6442,1289,0.19643014028420255,2544,511,0.19013851187909725,3898,778,0.20056255945516505,730,0.8,1.9,3976,1603,2373
905,2298,0,0.0,940,0,0.0,1358,0,0.0,731,0.0,1.1,39,10,29
1483,3265,0,0.0,1339,0,0.0,1926,0,0.0,732,0.0,1.3,101,25,76
1374,3041,0,0.0,1223,0,0.0,1818,0,0.0,733,0.0,1.5,91,31,60
563,1585,0,0.0,634,0,0.0,951,0,0.0,734,0.0,1.7,14,3,11
1154,2666,0,0.0,1062,0,0.0,1604,0,0.0,735,0.0,1.9,77,24,53
758,1903,0,0.0,748,0,0.0,1155,0,0.0,736,0.8,1.1,53,23,30
5000,7970,982,0.1760994895800879,3244,400,0.16668082979653895,4726,582,0.1825727952732485,737,0.8,1.3,2650,1040,1610
531,1497,0,0.0,619,0,0.0,878,0,0.0,738,0.8,1.5,47,17,30
1728,3914,0,0.0,1615,0,0.0,2299,0,0.0,739,0.8,1.7,54,14,40
5000,8816,509,0.16144225469757073,3608,186,0.16046666618365155,5208,323,0.1620040487024903,740,0.8,1.9,1755,688,1067
1305,2992,0,0.0,1210,0,0.0,1782,0,0.0,741,0.0,1.1,69,23,46
1420,3243,0,0.0,1312,0,0.0,1931,0,0.0,742,0.0,1.3,95,28,67
1077,2571,0,0.0,964,0,0.0,1607,0,0.0,743,0.0,1.5,72,36,36
767,2006,0,0.0,767,0,0.0,1239,0,0.0,744,0.0,1.7,60,33,27
841,2055,0,0.0,812,0,0.0,1243,0,0.0,745,0.0,1.9,70,33,37
551,1572,0,0.0,646,0,0.0,926,0,0.0,746,0.8,1.1,30,8,22
670,1724,0,0.0,687,0,0.0,1037,0,0.0,747,0.8,1.3,27,5,22
463,1369,0,0.0,558,0,0.0,811,0,0.0,748,0.8,1.5,26,5,21
5000,8463,461,0.21204276381764267,3306,194,0.2001251425400551,5157,267,0.22070200924030925,749,0.8,1.7,2084,847,1237
5000,4198,1676,0.14659098000901438,1663,671,0.14575132274552657,2535,1005,0.14715158699787054,750,0.8,1.9,6315,2515,3800
2180,4596,0,0.0,1835,0,0.0,2761,0,0.0,751,0.0,1.1,122,36,86
878,2168,0,0.0,849,0,0.0,1319,0,0.0,752,0.0,1.3,73,29,44
574,1568,0,0.0,648,0,0.0,920,0,0.0,753,0.0,1.5,61,18,43
1114,2711,0,0.0,1041,0,0.0,1670,0,0.0,754,0.0,1.7,62,30,32
1445,3207,0,0.0,1284,0,0.0,1923,0,0.0,755,0.0,1.9,97,35,62
1900,4205,0,0.0,1707,0,0.0,2498,0,0.0,756,0.8,1.1,138,53,85
590,1619,0,0.0,675,0,0.0,944,0,0.0,757,0.8,1.3,35,9,26
5000,9174,493,0.20543939366706668,3621,191,0.19532798191787462,5553,302,0.2118343593759928,758,0.8,1.5,1376,572,804
742,1919,0,0.0,765,0,0.0,1154,0,0.0,759,0.8,1.7,27,5,22
5000,10192,22,0.07294726854032492,4091,4,0.0811760883594829,6101,18,0.07111864191384537,760,0.8,1.9,241,63,178
1187,2698,0,0.0,1062,0,0.0,1636,0,0.0,761,0.0,1.1,130,54,76
961,2291,0,0.0,949,0,0.0,1342,0,0.0,762,0.0,1.3,70,27,43
1009,2476,0,0.0,966,0,0.0,1510,0,0.0,763,0.0,1.5,58,23,35
1408,3095,0,0.0,1233,0,0.0,1862,0,0.0,764,0.0,1.7,141,72,69
1719,3752,0,0.0,1495,0,0.0,2257,0,0.0,765,0.0,1.9,101,50,51
5000,10089,44,0.17980218161807415,4024,14,0.1343042050535483,6065,30,0.2010345706815196,766,0.8,1.1,321,103,218
994,2384,0,0.0,935,0,0.0,1449,0,0.0,767,0.8,1.3,78,22,56
748,1965,0,0.0,799,0,0.0,1166,0,0.0,768,0.8,1.5,28,7,21
404,1202,0,0.0,493,0,0.0,709,0,0.0,769,0.8,1.7,28,14,14
5000,9323,335,0.20755114021663154,3781,142,0.2217998406090035,5542,193,0.19706764044607816,770,0.8,1.9,1092,475,617
930,2221,0,0.0,877,0,0.0,1344,0,0.0,771,0.0,1.1,138,51,87
1033,2471,0,0.0,984,0,0.0,1487,0,0.0,772,0.0,1.3,54,21,33
586,1574,0,0.0,639,0,0.0,935,0,0.0,773,0.0,1.5,45,20,25
691,1807,0,0.0,731,0,0.0,1076,0,0.0,774,0.0,1.7,43,12,31
915,2256,0,0.0,907,0,0.0,1349,0,0.0,775,0.0,1.9,64,12,52
5000,7475,890,0.2268298887209042,2970,386,0.2269856334437417,4505,504,0.2267106080403183,776,0.8,1.1,3009,1261,1748
559,1531,0,0.0,592,0,0.0,939,0,0.0,777,0.8,1.3,37,7,30
869,2171,0,0.0,895,0,0.0,1276,0,0.0,778,0.8,1.5,69,18,51
4292,9049,0,0.0,3529,0,0.0,5520,0,0.0,779,0.8,1.7,82,25,57
5000,9413,315,0.26923618997594106,3794,135,0.26243362214006294,5619,180,0.2743381158528496,780,0.8,1.9,970,407,563
1468,3383,0,0.0,1380,0,0.0,2003,0,0.0,781,0.0,1.1,96,37,59
2238,4674,0,0.0,1788,0,0.0,2886,0,0.0,782,0.0,1.3,248,109,139
832,2138,0,0.0,852,0,0.0,1286,0,0.0,783,0.0,1.5,77,45,32
1327,2937,0,0.0,1172,0,0.0,1765,0,0.0,784,0.0,1.7,121,50,71
1010,2469,0,0.0,1023,0,0.0,1446,0,0.0,785,0.0,1.9,42,14,28
5000,4246,1671,0.18479970008697735,1722,702,0.17578235983212495,2524,969,0.19133238621587967,786,0.8,1.1,6288,2556,3732
5000,5018,1557,0.16123527768995405,2023,574,0.16133704648410366,2995,983,0.1611758521682431,787,0.8,1.3,5543,2165,3378
1033,2413,0,0.0,936,0,0.0,1477,0,0.0,788,0.8,1.5,81,31,50
592,1600,0,0.0,650,0,0.0,950,0,0.0,789,0.8,1.7,62,31,31
5000,5669,1432,0.15716108974294088,2316,510,0.15185248140934224,3353,922,0.1600975216845194,790,0.8,1.9,4908,1841,3067
1036,2542,0,0.0,980,0,0.0,1562,0,0.0,791,0.0,1.1,102,39,63
1219,2822,0,0.0,1098,0,0.0,1724,0,0.0,792,0.0,1.3,109,53,56
231,948,0,0.0,365,0,0.0,583,0,0.0,793,0.0,1.5,10,3,7
3156,6684,0,0.0,2617,0,0.0,4067,0,0.0,794,0.0,1.7,133,56,77
1257,2908,0,0.0,1164,0,0.0,1744,0,0.0,795,0.0,1.9,124,45,79
5000,10269,1,0.004979626121554066,4107,0,0.0,6162,1,0.004979626121554066,796,0.8,1.1,104,32,72
5000,6122,1251,0.17204909620712336,2535,511,0.16745303367079034,3587,740,0.1752228637153208,797,0.8,1.3,4390,1722,2668
456,1279,0,0.0,491,0,0.0,788,0,0.0,798,0.8,1.5,24,12,12
5000,7025,950,0.1823366893174262,2771,378,0.19031031478503724,4254,572,0.1770674053545643,799,0.8,1.7,3435,1433,2002
5000,10240,9,0.0507369654792661,4060,5,0.051577905075458154,6180,4,0.049685790984026035,800,0.8,1.9,259,111,148
888,2234,0,0.0,879,0,0.0,1355,0,0.0,801,0.0,1.1,38,2,36
737,1892,0,0.0,761,0,0.0,1131,0,0.0,802,0.0,1.3,47,13,34
1307,2961,0,0.0,1218,0,0.0,1743,0,0.0,803,0.0,1.5,63,34,29
200,838,0,0.0,328,0,0.0,510,0,0.0,804,0.0,1.7,6,1,5
1067,2474,0,0.0,1009,0,0.0,1465,0,0.0,805,0.0,1.9,97,36,61
5000,9103,494,0.22524550703264337,3643,210,0.23880005227424536,5460,284,0.21522277991737435,806,0.8,1.1,1386,561,825
5000,9742,264,0.2697939897271049,3871,100,0.2727660956660681,5871,164,0.2679817300082251,807,0.8,1.3,915,394,521
5000,7032,1038,0.22003868474475938,2786,445,0.22181350554512397,4246,593,0.21870682090637444,808,0.8,1.5,3460,1446,2014
593,1605,0,0.0,661,0,0.0,944,0,0.0,809,0.8,1.7,44,20,24
691,1771,0,0.0,720,0,0.0,1051,0,0.0,810,0.8,1.9,40,13,27
2125,4553,0,0.0,1854,0,0.0,2699,0,0.0,811,0.0,1.1,205,94,111
486,1392,0,0.0,550,0,0.0,842,0,0.0,812,0.0,1.3,27,8,19
968,2284,0,0.0,927,0,0.0,1357,0,0.0,813,0.0,1.5,78,28,50
647,1723,0,0.0,678,0,0.0,1045,0,0.0,814,0.0,1.7,27,15,12
1585,3510,0,0.0,1382,0,0.0,2128,0,0.0,815,0.0,1.9,127,47,80
761,1935,0,0.0,768,0,0.0,1167,0,0.0,816,0.8,1.1,34,10,24
5000,8263,802,0.19245212722759497,3346,321,0.20166652921037267,4917,481,0.18630280698545013,817,0.8,1.3,2229,900,1329
616,1698,0,0.0,676,0,0.0,1022,0,0.0,818,0.8,1.5,51,25,26
5000,10364,1,0.05,4173,0,0.0,6191,1,0.05,819,0.8,1.7,102,30,72
1258,2987,0,0.0,1181,0,0.0,1806,0,0.0,820,0.8,1.9,99,45,54
555,1584,0,0.0,618,0,0.0,966,0,0.0,821,0.0,1.1,29,15,14
1171,2801,0,0.0,1119,0,0.0,1682,0,0.0,822,0.0,1.3,88,33,55
811,2035,0,0.0,807,0,0.0,1228,0,0.0,823,0.0,1.5,38,10,28
1364,3057,0,0.0,1212,0,0.0,1845,0,0.0,824,0.0,1.7,111,52,59
1008,2436,0,0.0,986,0,0.0,1450,0,0.0,825,0.0,1.9,35,7,28
5000,7233,992,0.2094548016882342,2894,379,0.23353116019733494,4339,613,0.19456909226743602,826,0.8,1.1,3273,1266,2007
5000,2876,1843,0.1316281640147121,1150,738,0.12051529735822661,1726,1105,0.13905015097623816,827,0.8,1.3,7673,3008,4665
551,1542,0,0.0,629,0,0.0,913,0,0.0,828,0.8,1.5,38,16,22
536,1529,0,0.0,633,0,0.0,896,0,0.0,829,0.8,1.7,31,10,21
1100,2520,0,0.0,1011,0,0.0,1509,0,0.0,830,0.8,1.9,79,30,49
802,1938,0,0.0,758,0,0.0,1180,0,0.0,831,0.0,1.1,91,29,62
538,1533,0,0.0,641,0,0.0,892,0,0.0,832,0.0,1.3,37,9,28
1140,2673,0,0.0,1030,0,0.0,1643,0,0.0,833,0.0,1.5,89,41,48
1051,2469,0,0.0,972,0,0.0,1497,0,0.0,834,0.0,1.7,140,65,75
666,1752,0,0.0,727,0,0.0,1025,0,0.0,835,0.0,1.9,45,21,24
633,1686,0,0.0,689,0,0.0,997,0,0.0,836,0.8,1.1,59,24,35
5000,9627,351,0.21372643270774935,3917,167,0.21656086354122517,5710,184,0.21115387863606208,837,0.8,1.3,977,400,577
690,1821,0,0.0,735,0,0.0,1086,0,0.0,838,0.8,1.5,45,24,21
559,1497,0,0.0,626,0,0.0,871,0,0.0,839,0.8,1.7,36,15,21
5000,6015,1342,0.18816452518267135,2492,528,0.18918309701396321,3523,814,0.18750382994075232,840,0.8,1.9,4446,1728,2718
1046,2539,0,0.0,1005,0,0.0,1534,0,0.0,841,0.0,1.1,51,26,25
1411,3262,0,0.0,1277,0,0.0,1985,0,0.0,842,0.0,1.3,84,14,70
603,1644,0,0.0,649,0,0.0,995,0,0.0,843,0.0,1.5,58,21,37
618,1627,0,0.0,685,0,0.0,942,0,0.0,844,0.0,1.7,73,23,50
1080,2511,0,0.0,998,0,0.0,1513,0,0.0,845,0.0,1.9,95,43,52
5000,4627,1526,0.17419138013228308,1794,606,0.16736279662575812,2833,920,0.17868933839853748,846,0.8,1.1,5846,2351,3495
3997,8360,0,0.0,3299,0,0.0,5061,0,0.0,847,0.8,1.3,72,29,43
900,2232,0,0.0,878,0,0.0,1354,0,0.0,848,0.8,1.5,20,5,15
1853,4032,0,0.0,1603,0,0.0,2429,0,0.0,849,0.8,1.7,119,47,72
5000,8032,709,0.17970364951594406,3315,274,0.20455407508379983,4717,435,0.16405073777894988,850,0.8,1.9,2358,932,1426
1109,2766,0,0.0,1079,0,0.0,1687,0,0.0,851,0.0,1.1,53,20,33
441,1369,0,0.0,581,0,0.0,788,0,0.0,852,0.0,1.3,23,5,18
452,1367,0,0.0,574,0,0.0,793,0,0.0,853,0.0,1.5,21,6,15
1060,2532,0,0.0,1031,0,0.0,1501,0,0.0,854,0.0,1.7,70,31,39
722,1871,0,0.0,765,0,0.0,1106,0,0.0,855,0.0,1.9,62,14,48
5000,3871,1685,0.15098248366580297,1509,684,0.14993690952005773,2362,1001,0.15169694192323535,856,0.8,1.1,6778,2690,4088
552,1584,0,0.0,618,0,0.0,966,0,0.0,857,0.8,1.3,42,24,18
5000,5912,1289,0.18167688313158084,2343,480,0.19996970498838842,3569,809,0.170823292907517,858,0.8,1.5,4653,1862,2791
5000,10270,103,0.14948497860653281,4139,28,0.15784665949543014,6131,75,0.14636328440801114,859,0.8,1.7,292,54,238
5000,4710,1583,0.1669689510383431,1866,644,0.162521118868867,2844,939,0.1700194344431808,860,0.8,1.9,5758,2271,3487
540,1540,0,0.0,623,0,0.0,917,0,0.0,861,0.0,1.1,32,11,21
417,1325,0,0.0,538,0,0.0,787,0,0.0,862,0.0,1.3,6,3,3
887,2135,0,0.0,857,0,0.0,1278,0,0.0,863,0.0,1.5,63,16,47
422,1329,0,0.0,527,0,0.0,802,0,0.0,864,0.0,1.7,23,5,18
794,1916,0,0.0,761,0,0.0,1155,0,0.0,865,0.0,1.9,54,25,29
467,1358,0,0.0,521,0,0.0,837,0,0.0,866,0.8,1.1,38,15,23
5000,9831,232,0.19172702343717546,3945,82,0.17317326454297324,5886,150,0.20186974496600607,867,0.8,1.3,668,256,412
883,2190,0,0.0,897,0,0.0,1293,0,0.0,868,0.8,1.5,51,22,29
5000,8200,754,0.20374648534694684,3297,294,0.20971805396449952,4903,460,0.19992987410007618,869,0.8,1.7,2287,887,1400
5000,7985,867,0.2032652995872329,3154,349,0.19577909738604313,4831,518,0.20830909218996485,870,0.8,1.9,2632,1099,1533
443,1385,0,0.0,550,0,0.0,835,0,0.0,871,0.0,1.1,44,17,27
978,2408,0,0.0,963,0,0.0,1445,0,0.0,872,0.0,1.3,89,32,57
1497,3358,0,0.0,1316,0,0.0,2042,0,0.0,873,0.0,1.5,93,27,66
1221,2826,0,0.0,1136,0,0.0,1690,0,0.0,874,0.0,1.7,94,42,52
1381,3113,0,0.0,1212,0,0.0,1901,0,0.0,875,0.0,1.9,122,49,73
1316,3027,0,0.0,1211,0,0.0,1816,0,0.0,876,0.8,1.1,73,31,42
947,2331,0,0.0,949,0,0.0,1382,0,0.0,877,0.8,1.3,57,16,41
5000,6077,1146,0.18918884282841142,2482,464,0.20276166955124258,3595,682,0.1799545442955761,878,0.8,1.5,4462,1785,2677
5000,5365,1520,0.18291256598117572,2111,660,0.17945585706826067,3254,860,0.18556538910038972,879,0.8,1.7,5112,2099,3013
1580,3554,0,0.0,1407,0,0.0,2147,0,0.0,880,0.8,1.9,80,32,48
853,2141,0,0.0,861,0,0.0,1280,0,0.0,881,0.0,1.1,41,17,24
769,1909,0,0.0,746,0,0.0,1163,0,0.0,882,0.0,1.3,86,33,53
723,1914,0,0.0,785,0,0.0,1129,0,0.0,883,0.0,1.5,47,8,39
776,1926,0,0.0,743,0,0.0,1183,0,0.0,884,0.0,1.7,81,36,45
1140,2651,0,0.0,1069,0,0.0,1582,0,0.0,885,0.0,1.9,59,20,39
301,1082,0,0.0,450,0,0.0,632,0,0.0,886,0.8,1.1,16,3,13
701,1771,0,0.0,717,0,0.0,1054,0,0.0,887,0.8,1.3,57,13,44
5000,9034,461,0.19177827935621913,3657,161,0.18675587698109697,5377,300,0.19447363529753464,888,0.8,1.5,1501,554,947
2263,4892,0,0.0,1978,0,0.0,2914,0,0.0,889,0.8,1.7,102,36,66
408,1299,0,0.0,526,0,0.0,773,0,0.0,890,0.8,1.9,43,12,31
846,2112,0,0.0,824,0,0.0,1288,0,0.0,891,0.0,1.1,45,12,33
1077,2587,0,0.0,1013,0,0.0,1574,0,0.0,892,0.0,1.3,117,58,59
1998,4383,0,0.0,1742,0,0.0,2641,0,0.0,893,0.0,1.5,99,46,53
2045,4252,0,0.0,1703,0,0.0,2549,0,0.0,894,0.0,1.7,304,147,157
1670,3698,0,0.0,1454,0,0.0,2244,0,0.0,895,0.0,1.9,136,60,76
323,1121,0,0.0,451,0,0.0,670,0,0.0,896,0.8,1.1,8,4,4
1572,3566,0,0.0,1434,0,0.0,2132,0,0.0,897,0.8,1.3,120,58,62
680,1774,0,0.0,710,0,0.0,1064,0,0.0,898,0.8,1.5,45,17,28
999,2433,0,0.0,954,0,0.0,1479,0,0.0,899,0.8,1.7,86,33,53
5000,6842,1120,0.20691737870063856,2739,419,0.2085757158365632,4103,701,0.20592616149671228,900,0.8,1.9,3577,1402,2175
821,2163,0,0.0,876,0,0.0,1287,0,0.0,901,0.0,1.1,24,5,19
1111,2457,0,0.0,954,0,0.0,1503,0,0.0,902,0.0,1.3,220,115,105
914,2276,0,0.0,887,0,0.0,1389,0,0.0,903,0.0,1.5,82,32,50
689,1824,0,0.0,718,0,0.0,1106,0,0.0,904,0.0,1.7,45,6,39
830,2038,0,0.0,849,0,0.0,1189,0,0.0,905,0.0,1.9,85,33,52
5000,8281,576,0.16691372447041816,3309,247,0.16776126908507652,4972,329,0.1662774219785621,906,0.8,1.1,2151,897,1254
5000,8047,786,0.2800397034368063,3120,321,0.28950164068230544,4927,465,0.2735079144995907,907,0.8,1.3,2465,1067,1398
5000,7750,927,0.24622025613227924,2984,358,0.2523163838349671,4766,569,0.2423847311453507,908,0.8,1.5,2883,1179,1704
1608,3617,0,0.0,1461,0,0.0,2156,0,0.0,909,0.8,1.7,67,17,50
341,1114,0,0.0,428,0,0.0,686,0,0.0,910,0.8,1.9,18,5,13
520,1420,0,0.0,574,0,0.0,846,0,0.0,911,0.0,1.1,52,20,32
1158,2776,0,0.0,1081,0,0.0,1695,0,0.0,912,0.0,1.3,41,14,27
1473,3347,0,0.0,1376,0,0.0,1971,0,0.0,913,0.0,1.5,91,37,54
234,876,0,0.0,349,0,0.0,527,0,0.0,914,0.0,1.7,18,4,14
860,2185,0,0.0,891,0,0.0,1294,0,0.0,915,0.0,1.9,76,29,47
5000,4386,1695,0.168194457281234,1646,670,0.16407698973558718,2740,1025,0.1708858750915591,916,0.8,1.1,6110,2488,3622
5000,9146,442,0.19825744470405063,3773,164,0.21553815151073621,5373,278,0.1880630709044233,917,0.8,1.3,1280,452,828
335,1101,0,0.0,428,0,0.0,673,0,0.0,918,0.8,1.5,16,5,11
646,1616,0,0.0,655,0,0.0,961,0,0.0,919,0.8,1.7,27,12,15
5000,4884,1566,0.2009584399995049,1907,639,0.2075141180800271,2977,927,0.19643947743914497,920,0.8,1.9,5522,2252,3270
814,2059,0,0.0,817,0,0.0,1242,0,0.0,921,0.0,1.1,49,15,34
687,1762,0,0.0,683,0,0.0,1079,0,0.0,922,0.0,1.3,44,13,31
572,1548,0,0.0,643,0,0.0,905,0,0.0,923,0.0,1.5,56,25,31
1064,2457,0,0.0,997,0,0.0,1460,0,0.0,924,0.0,1.7,118,35,83
881,2248,0,0.0,890,0,0.0,1358,0,0.0,925,0.0,1.9,49,13,36
5000,4210,1716,0.17658464952362513,1686,678,0.18447125253103477,2524,1038,0.17143328455346726,926,0.8,1.1,6339,2555,3784
2599,5643,0,0.0,2263,0,0.0,3380,0,0.0,927,0.8,1.3,69,12,57
5000,10274,98,0.12049154357426992,4204,35,0.11719973425650786,6070,63,0.12232032652858214,928,0.8,1.5,341,96,245
5000,3372,1805,0.1555276156716406,1417,761,0.14911819560658232,1955,1044,0.16019961631293303,929,0.8,1.7,7078,2868,4210
5000,5093,1399,0.17425852679549073,2018,541,0.16264093723212286,3075,858,0.18158383676493378,930,0.8,1.9,5236,2113,3123
718,1884,0,0.0,759,0,0.0,1125,0,0.0,931,0.0,1.1,37,8,29
940,2262,0,0.0,869,0,0.0,1393,0,0.0,932,0.0,1.3,63,32,31
790,1966,0,0.0,735,0,0.0,1231,0,0.0,933,0.0,1.5,50,19,31
488,1392,0,0.0,556,0,0.0,836,0,0.0,934,0.0,1.7,32,16,16
2149,4587,0,0.0,1818,0,0.0,2769,0,0.0,935,0.0,1.9,166,57,109
650,1711,0,0.0,695,0,0.0,1016,0,0.0,936,0.8,1.1,62,19,43
4970,10453,0,0.0,4168,0,0.0,6285,0,0.0,937,0.8,1.3,87,21,66
502,1437,0,0.0,547,0,0.0,890,0,0.0,938,0.8,1.5,29,12,17
787,2045,0,0.0,825,0,0.0,1220,0,0.0,939,0.8,1.7,23,3,20
902,2223,0,0.0,888,0,0.0,1335,0,0.0,940,0.8,1.9,49,23,26
763,1878,0,0.0,757,0,0.0,1121,0,0.0,941,0.0,1.1,70,36,34
685,1717,0,0.0,696,0,0.0,1021,0,0.0,942,0.0,1.3,64,27,37
515,1528,0,0.0,614,0,0.0,914,0,0.0,943,0.0,1.5,34,8,26
1225,2860,0,0.0,1102,0,0.0,1758,0,0.0,944,0.0,1.7,81,33,48
1338,2988,0,0.0,1200,0,0.0,1788,0,0.0,945,0.0,1.9,73,24,49
5000,9060,464,0.21349712598695608,3659,175,0.18530801293830026,5401,289,0.23056665810984456,946,0.8,1.1,1332,526,806
5000,9534,228,0.23278417855227249,3972,78,0.2377486789326989,5562,150,0.23020263835445073,947,0.8,1.3,899,301,598
1450,3264,0,0.0,1329,0,0.0,1935,0,0.0,948,0.8,1.5,67,18,49
5000,9749,67,0.15263533895495598,3862,20,0.15928916112985925,5887,47,0.14980392526350783,949,0.8,1.7,520,195,325
1047,2463,0,0.0,1003,0,0.0,1460,0,0.0,950,0.8,1.9,107,45,62
2216,4805,0,0.0,1910,0,0.0,2895,0,0.0,951,0.0,1.1,115,50,65
1673,3543,0,0.0,1372,0,0.0,2171,0,0.0,952,0.0,1.3,224,91,133
825,2104,0,0.0,860,0,0.0,1244,0,0.0,953,0.0,1.5,50,8,42
861,2099,0,0.0,836,0,0.0,1263,0,0.0,954,0.0,1.7,57,32,25
1973,4299,0,0.0,1700,0,0.0,2599,0,0.0,955,0.0,1.9,194,92,102
751,1913,0,0.0,774,0,0.0,1139,0,0.0,956,0.8,1.1,33,16,17
5000,8282,629,0.2415750656972817,3299,246,0.25101485254197575,4983,383,0.23551191278920128,957,0.8,1.3,1998,810,1188
5000,9981,30,0.12048025232665857,4030,12,0.1280188750521706,5951,18,0.11545450384298389,958,0.8,1.5,462,174,288
5000,3821,1789,0.16731445251041785,1516,706,0.16810672350118938,2305,1083,0.16679797668448534,959,0.8,1.7,6625,2658,3967
5000,7403,953,0.2002973509462515,3033,366,0.22191182175356516,4370,587,0.186820525877296,960,0.8,1.9,3107,1123,1984
952,2338,0,0.0,959,0,0.0,1379,0,0.0,961,0.0,1.1,43,15,28
615,1695,0,0.0,659,0,0.0,1036,0,0.0,962,0.0,1.3,20,4,16
1775,3842,0,0.0,1530,0,0.0,2312,0,0.0,963,0.0,1.5,215,98,117
1166,2706,0,0.0,1053,0,0.0,1653,0,0.0,964,0.0,1.7,32,5,27
1197,2774,0,0.0,1117,0,0.0,1657,0,0.0,965,0.0,1.9,99,36,63
661,1700,0,0.0,680,0,0.0,1020,0,0.0,966,0.8,1.1,35,17,18
5000,9585,325,0.1930223809621328,3829,124,0.1820349046615627,5756,201,0.19980072455054426,967,0.8,1.3,973,370,603
5000,9201,373,0.1994431452426299,3711,152,0.21659224920839307,5490,221,0.1876482864064489,968,0.8,1.5,1240,496,744
5000,10131,133,0.3442513175030375,4072,61,0.32128145429025595,6059,72,0.3637118960583109,969,0.8,1.7,451,204,247
620,1663,0,0.0,707,0,0.0,956,0,0.0,970,0.8,1.9,40,8,32
600,1656,0,0.0,660,0,0.0,996,0,0.0,971,0.0,1.1,34,13,21
1338,3058,0,0.0,1227,0,0.0,1831,0,0.0,972,0.0,1.3,130,54,76
1588,3609,0,0.0,1408,0,0.0,2201,0,0.0,973,0.0,1.5,85,32,53
933,2341,0,0.0,930,0,0.0,1411,0,0.0,974,0.0,1.7,48,13,35
1489,3431,0,0.0,1316,0,0.0,2115,0,0.0,975,0.0,1.9,102,49,53
5000,4738,1638,0.1707580359968452,1904,695,0.17328381091714973,2834,943,0.1688965157745635,976,0.8,1.1,5685,2183,3502
3061,6319,0,0.0,2513,0,0.0,3806,0,0.0,977,0.8,1.3,133,53,80
638,1769,0,0.0,687,0,0.0,1082,0,0.0,978,0.8,1.5,34,12,22
5000,8425,792,0.21157510057419485,3432,306,0.21937055381707796,4993,486,0.20666685223608328,979,0.8,1.7,2270,888,1382
583,1594,0,0.0,597,0,0.0,997,0,0.0,980,0.8,1.9,47,21,26
416,1327,0,0.0,544,0,0.0,783,0,0.0,981,0.0,1.1,22,10,12
1320,3032,0,0.0,1225,0,0.0,1807,0,0.0,982,0.0,1.3,109,44,65
1050,2508,0,0.0,1004,0,0.0,1504,0,0.0,983,0.0,1.5,113,57,56
664,1786,0,0.0,697,0,0.0,1089,0,0.0,984,0.0,1.7,52,31,21
1605,3597,0,0.0,1471,0,0.0,2126,0,0.0,985,0.0,1.9,86,38,48
710,1810,0,0.0,723,0,0.0,1087,0,0.0,986,0.8,1.1,56,18,38
1770,3922,0,0.0,1539,0,0.0,2383,0,0.0,987,0.8,1.3,126,61,65
1467,3254,0,0.0,1282,0,0.0,1972,0,0.0,988,0.8,1.5,97,31,66
1037,2464,0,0.0,1016,0,0.0,1448,0,0.0,989,0.8,1.7,57,17,40
975,2345,0,0.0,968,0,0.0,1377,0,0.0,990,0.8,1.9,33,12,21
1440,3164,0,0.0,1297,0,0.0,1867,0,0.0,991,0.0,1.1,158,48,110
975,2358,0,0.0,951,0,0.0,1407,0,0.0,992,0.0,1.3,35,15,20
851,2149,0,0.0,856,0,0.0,1293,0,0.0,993,0.0,1.5,62,29,33
752,1967,0,0.0,824,0,0.0,1143,0,0.0,994,0.0,1.7,51,14,37
561,1566,0,0.0,640,0,0.0,926,0,0.0,995,0.0,1.9,34,10,24
2549,5536,0,0.0,2271,0,0.0,3265,0,0.0,996,0.8,1.1,69,18,51
738,1928,0,0.0,763,0,0.0,1165,0,0.0,997,0.8,1.3,22,8,14
1029,2464,0,0.0,983,0,0.0,1481,0,0.0,998,0.8,1.5,34,16,18
5000,4401,1659,0.16475338905583706,1762,664,0.17151038949277814,2639,995,0.16024419479440094,999,0.8,1.7,6176,2502,3674
5000,7651,731,0.2525280459697338,3041,302,0.27055498803693506,4610,429,0.2398377510879277,1000,0.8,1.9,2905,1155,1750
