step,susceptible_status,infected_status,filtermeanvirulence_pathogen,susceptible_status_is_minority,infected_status_is_minority,filtermeanvirulence_pathogen_is_minority,susceptible_status_#84_f=is_minority,infected_status_#84_f=is_minority,filtermeanvirulence_pathogen_#84_f=is_minority,ensemble,mutation_rate,virulence_init,total_infected,total_minority_infected,total_majority_infected
5000,6021,2312,0.10000000000000005,654,220,0.10000000000000006,5367,2092,0.10000000000000006,1,0.0,0.1,4553,433,4120
5000,855,788,0.3000000000000003,73,73,0.30000000000000004,782,715,0.3000000000000004,2,0.0,0.3,9589,890,8699
5000,1652,403,0.5,174,30,0.5,1478,373,0.5,3,0.0,0.5,8882,862,8020
5000,8553,117,0.7000000000000002,836,13,0.7,7717,104,0.7000000000000001,4,0.0,0.7,1703,164,1539
1070,2491,0,0.0,259,0,0.0,2232,0,0.0,5,0.0,0.9,233,24,209
5000,8977,576,0.17747364967226775,933,77,0.19822773756779002,8044,499,0.17427111506714713,6,0.8,0.1,1491,141,1350
5000,2984,1726,0.12720595499437776,339,157,0.14250417474321805,2645,1569,0.12567515798955434,7,0.8,0.3,7624,687,6937
5000,3419,1710,0.16381668295896615,337,176,0.16193352706430983,3082,1534,0.16403274256617564,8,0.8,0.5,7131,693,6438
5000,4931,1539,0.1678237360717516,467,153,0.1657992206652022,4464,1386,0.16804722153870832,9,0.8,0.7,5681,583,5098
5000,10152,8,0.1772873656716019,1010,0,0.0,9142,8,0.1772873656716019,10,0.8,0.9,307,28,279
5000,1971,2880,0.0999999999999999,199,251,0.10000000000000006,1772,2629,0.09999999999999995,11,0.0,0.1,8461,812,7649
5000,829,815,0.30000000000000043,73,71,0.3,756,744,0.3000000000000003,12,0.0,0.3,9498,984,8514
5000,4131,696,0.5,443,77,0.5,3688,619,0.5,13,0.0,0.5,6244,594,5650
1409,3207,0,0.0,328,0,0.0,2879,0,0.0,14,0.0,0.7,103,8,95
678,1865,0,0.0,187,0,0.0,1678,0,0.0,15,0.0,0.9,27,2,25
5000,4490,1689,0.13536747752765876,461,176,0.14447045505715583,4029,1513,0.13430857201200017,16,0.8,0.1,5849,573,5276
5000,8843,469,0.2192993088167998,903,43,0.2708385434637944,7940,426,0.2140969917045445,17,0.8,0.3,1486,100,1386
5000,10140,14,0.08315625543593619,1003,0,0.0,9137,14,0.08315625543593619,18,0.8,0.5,173,20,153
5000,8672,553,0.17610954263701448,865,64,0.139673929788265,7807,489,0.180878211803313,19,0.8,0.7,1723,175,1548
5000,7497,814,0.17901830321083015,740,80,0.16877706801991355,6757,734,0.18013451413082104,20,0.8,0.9,2902,275,2627
5000,1484,2579,0.10000000000000003,162,244,0.10000000000000002,1322,2335,0.10000000000000006,21,0.0,0.1,9048,910,8138
5000,891,686,0.3000000000000004,79,67,0.3,812,619,0.3000000000000003,22,0.0,0.3,9567,972,8595
5000,1677,339,0.5,167,16,0.5,1510,323,0.5,23,0.0,0.5,8577,837,7740
476,1369,0,0.0,152,0,0.0,1217,0,0.0,24,0.0,0.7,34,2,32
658,1760,0,0.0,170,0,0.0,1590,0,0.0,25,0.0,0.9,32,1,31
5000,3226,2216,0.13659723726623746,318,240,0.13289450121598273,2908,1976,0.1370469622925843,26,0.8,0.1,7411,766,6645
5000,4303,1629,0.17642567232785042,427,143,0.1728077489257225,3876,1486,0.17677383050181011,27,0.8,0.3,6169,605,5564
5000,2017,1581,0.13130429347433945,221,148,0.13066231878651396,1796,1433,0.1313705965125796,28,0.8,0.5,8337,871,7466
5000,3996,1597,0.13720719306895718,426,149,0.13663784956267447,3570,1448,0.13726577883030813,29,0.8,0.7,6435,603,5832
2127,4734,0,0.0,462,0,0.0,4272,0,0.0,30,0.8,0.9,43,0,43
5000,1692,2731,0.09999999999999996,158,280,0.10000000000000005,1534,2451,0.10000000000000006,31,0.0,0.1,8840,936,7904
5000,938,680,0.30000000000000027,98,75,0.30000000000000004,840,605,0.3000000000000004,32,0.0,0.3,9549,943,8606
2288,4801,0,0.0,452,0,0.0,4349,0,0.0,33,0.0,0.5,274,16,258
3344,5097,0,0.0,514,0,0.0,4583,0,0.0,34,0.0,0.7,1914,192,1722
782,2039,0,0.0,211,0,0.0,1828,0,0.0,35,0.0,0.9,36,2,34
5000,3670,1962,0.14394927006225897,392,236,0.15306586877541647,3278,1726,0.14270273628687938,36,0.8,0.1,6851,713,6138
5000,1844,1782,0.1131184546785814,174,179,0.11802683625764668,1670,1603,0.11257035717224784,37,0.8,0.3,8580,877,7703
5000,3989,1723,0.1743379116564715,403,191,0.1792458163503205,3586,1532,0.17372602536631143,38,0.8,0.5,6505,711,5794
5000,8670,402,0.2575684840615609,883,28,0.18660379706646377,7787,374,0.2628813483285736,39,0.8,0.7,1787,189,1598
401,1229,0,0.0,129,0,0.0,1100,0,0.0,40,0.8,0.9,31,0,31
5000,2001,2947,0.0999999999999999,216,309,0.10000000000000005,1785,2638,0.10000000000000002,41,0.0,0.1,8522,829,7693
5000,1005,872,0.30000000000000043,102,77,0.30000000000000004,903,795,0.30000000000000043,42,0.0,0.3,9292,909,8383
5000,3346,361,0.5,386,33,0.5,2960,328,0.5,43,0.0,0.5,6979,667,6312
3536,7369,0,0.0,777,0,0.0,6592,0,0.0,44,0.0,0.7,318,26,292
523,1417,0,0.0,157,0,0.0,1260,0,0.0,45,0.0,0.9,71,7,64
5000,2537,1761,0.12894717593597266,258,167,0.10530783537203423,2279,1594,0.13142381952077675,46,0.8,0.1,8002,798,7204
5000,2921,1485,0.12465493560311913,314,125,0.12329611227037994,2607,1360,0.12477982745355476,47,0.8,0.3,7638,735,6903
5000,7452,592,0.1919558808442294,807,50,0.18403510074828794,6645,542,0.19268658011507273,48,0.8,0.5,3058,256,2802
1021,2516,0,0.0,253,0,0.0,2263,0,0.0,49,0.8,0.7,57,0,57
650,1751,0,0.0,183,0,0.0,1568,0,0.0,50,0.8,0.9,43,4,39
5000,1710,2886,0.09999999999999995,157,302,0.10000000000000007,1553,2584,0.10000000000000002,51,0.0,0.1,8852,891,7961
5000,797,617,0.30000000000000027,73,66,0.29999999999999993,724,551,0.30000000000000016,52,0.0,0.3,9601,975,8626
1511,3403,0,0.0,344,0,0.0,3059,0,0.0,53,0.0,0.5,80,4,76
2167,4369,0,0.0,444,0,0.0,3925,0,0.0,54,0.0,0.7,423,48,375
892,2236,0,0.0,243,0,0.0,1993,0,0.0,55,0.0,0.9,92,4,88
5000,3836,1856,0.1400506678727871,401,207,0.12884809332550007,3435,1649,0.14145693405307108,56,0.8,0.1,6606,641,5965
5000,8027,901,0.13516921789088351,814,86,0.12594340104228108,7213,815,0.13614273966877283,57,0.8,0.3,2418,203,2215
5000,2494,1466,0.13059531787704626,245,137,0.14610362334800772,2249,1329,0.12899664379915185,58,0.8,0.5,7902,796,7106
1200,2847,0,0.0,294,0,0.0,2553,0,0.0,59,0.8,0.7,60,0,60
5000,9164,325,0.13967395518260764,975,21,0.09237947315894497,8189,304,0.1429410082171369,60,0.8,0.9,1423,102,1321
5000,1538,2679,0.09999999999999995,160,251,0.10000000000000006,1378,2428,0.10000000000000009,61,0.0,0.1,9025,878,8147
5000,903,684,0.3000000000000004,84,67,0.3,819,617,0.30000000000000027,62,0.0,0.3,9496,917,8579
5000,4560,815,0.5,421,78,0.5,4139,737,0.5,63,0.0,0.5,6006,576,5430
1176,2788,0,0.0,277,0,0.0,2511,0,0.0,64,0.0,0.7,68,5,63
1616,3511,0,0.0,353,0,0.0,3158,0,0.0,65,0.0,0.9,141,15,126
5000,2330,1901,0.10725624948925692,244,198,0.10751146080369947,2086,1703,0.1072265772401321,66,0.8,0.1,8070,787,7283
5000,2502,1745,0.13732610633067666,244,167,0.12429118365358041,2258,1578,0.13870559434529964,67,0.8,0.3,8001,839,7162
5000,5170,1559,0.16115442648974027,509,161,0.1523425007375509,4661,1398,0.16216924769582217,68,0.8,0.5,5368,548,4820
5000,6768,1093,0.22922643172487966,679,121,0.23008536288154186,6089,972,0.2291195071673118,69,0.8,0.7,3778,395,3383
5000,9607,287,0.17218543526558366,948,24,0.11906131474720165,8659,263,0.17703326375395315,70,0.8,0.9,943,106,837
5000,2321,3027,0.09999999999999998,243,304,0.10000000000000009,2078,2723,0.09999999999999998,71,0.0,0.1,8051,770,7281
5000,827,717,0.3000000000000004,65,75,0.30000000000000004,762,642,0.30000000000000016,72,0.0,0.3,9747,968,8779
5000,3337,644,0.5,341,59,0.5,2996,585,0.5,73,0.0,0.5,7250,653,6597
1329,3027,0,0.0,262,0,0.0,2765,0,0.0,74,0.0,0.7,141,12,129
2667,5259,0,0.0,492,0,0.0,4767,0,0.0,75,0.0,0.9,507,67,440
5000,4001,1807,0.1353836876354019,448,165,0.11723665182493849,3553,1642,0.1372072326468066,76,0.8,0.1,6511,649,5862
5000,2002,1655,0.12234654530078876,170,203,0.11766817301887253,1832,1452,0.12300061525480326,77,0.8,0.3,8451,892,7559
5000,3104,1594,0.136026669818865,345,167,0.14317614775577694,2759,1427,0.13518997548427195,78,0.8,0.5,7354,766,6588
5000,9389,169,0.13785127771166478,951,14,0.14828978876161172,8438,155,0.13690844445554054,79,0.8,0.7,920,78,842
1708,3804,0,0.0,377,0,0.0,3427,0,0.0,80,0.8,0.9,52,2,50
5000,1550,2572,0.10000000000000003,174,248,0.10000000000000005,1376,2324,0.10000000000000005,81,0.0,0.1,8914,906,8008
5000,856,716,0.3000000000000004,98,75,0.30000000000000004,758,641,0.30000000000000043,82,0.0,0.3,9652,970,8682
5000,1727,432,0.5,187,51,0.5,1540,381,0.5,83,0.0,0.5,8647,849,7798
2889,5665,0,0.0,574,0,0.0,5091,0,0.0,84,0.0,0.7,691,68,623
2491,5119,0,0.0,515,0,0.0,4604,0,0.0,85,0.0,0.9,428,54,374
5000,4557,1565,0.1625364287822011,525,175,0.19475824148843807,4032,1390,0.15847972574364605,86,0.8,0.1,5896,568,5328
5000,1909,1540,0.11316939128886193,173,130,0.12183993558039076,1736,1410,0.11236997940382734,87,0.8,0.3,8490,780,7710
5000,9302,422,0.14182967056723314,982,34,0.1241402006053647,8320,388,0.14337977875976798,88,0.8,0.5,1146,76,1070
5000,9728,213,0.19658198401619356,1033,17,0.19750400099862042,8695,196,0.19650201315547292,89,0.8,0.7,736,47,689
3916,8066,0,0.0,803,0,0.0,7263,0,0.0,90,0.8,0.9,106,2,104
5000,2243,3056,0.09999999999999991,224,326,0.10000000000000002,2019,2730,0.09999999999999996,91,0.0,0.1,8076,798,7278
5000,1022,721,0.30000000000000043,99,85,0.30000000000000004,923,636,0.3000000000000003,92,0.0,0.3,9345,944,8401
5000,1234,747,0.5,95,87,0.5,1139,660,0.5,93,0.0,0.5,9280,989,8291
2839,5845,0,0.0,604,0,0.0,5241,0,0.0,94,0.0,0.7,306,19,287
411,1300,0,0.0,128,0,0.0,1172,0,0.0,95,0.0,0.9,13,1,12
5000,2695,2137,0.13636677992772533,258,196,0.1482036434350418,2437,1941,0.13517150674512157,96,0.8,0.1,7904,797,7107
5000,3312,1849,0.13465576843078983,347,169,0.1315754445408689,2965,1680,0.1349656343459069,97,0.8,0.3,7189,741,6448
5000,3384,1661,0.16277508575337774,349,155,0.16185306955887308,3035,1506,0.16286998117844295,98,0.8,0.5,7032,681,6351
5000,3509,1755,0.14732650497090913,374,176,0.12816988727083403,3135,1579,0.14946175811543927,99,0.8,0.7,7036,685,6351
792,1972,0,0.0,203,0,0.0,1769,0,0.0,100,0.8,0.9,47,5,42
5000,4989,2829,0.09999999999999999,528,301,0.10000000000000007,4461,2528,0.10000000000000007,101,0.0,0.1,5527,548,4979
5000,1001,671,0.30000000000000043,104,54,0.3,897,617,0.30000000000000027,102,0.0,0.3,9609,956,8653
5000,10078,15,0.5,1002,1,0.5,9076,14,0.5,103,0.0,0.5,398,20,378
2686,4333,0,0.0,440,0,0.0,3893,0,0.0,104,0.0,0.7,1446,122,1324
1365,3097,0,0.0,312,0,0.0,2785,0,0.0,105,0.0,0.9,47,1,46
5000,2867,1785,0.1318930785024883,303,165,0.13660152846057694,2564,1620,0.1314135141549052,106,0.8,0.1,7809,765,7044
5000,2490,1848,0.11591478204324158,255,184,0.12298834083164041,2235,1664,0.11513260967721672,107,0.8,0.3,7876,800,7076
5000,8981,584,0.165379685504865,1003,74,0.15145488534286153,7978,510,0.16740014670484202,108,0.8,0.5,1586,155,1431
5000,10095,24,0.09819467986429857,963,1,0.5599658607795999,9132,23,0.07811767199841593,109,0.8,0.7,400,29,371
555,1560,0,0.0,161,0,0.0,1399,0,0.0,110,0.8,0.9,22,0,22
5000,1908,2964,0.09999999999999998,175,299,0.10000000000000006,1733,2665,0.09999999999999996,111,0.0,0.1,8470,864,7606
5000,871,683,0.3000000000000003,73,71,0.3,798,612,0.30000000000000016,112,0.0,0.3,9536,924,8612
5000,4938,497,0.5,502,62,0.5,4436,435,0.5,113,0.0,0.5,5433,519,4914
2535,5148,0,0.0,514,0,0.0,4634,0,0.0,114,0.0,0.7,395,33,362
1799,3995,0,0.0,412,0,0.0,3583,0,0.0,115,0.0,0.9,213,23,190
5000,2667,1901,0.15610628419854286,251,213,0.16279800667003477,2416,1688,0.15526189030847898,116,0.8,0.1,7712,797,6915
5000,2481,1862,0.11230125992129017,252,197,0.11441129348181138,2229,1665,0.11205160429881408,117,0.8,0.3,7883,806,7077
5000,9915,179,0.1763550444078003,982,12,0.24978950107076262,8933,167,0.1710783169829168,118,0.8,0.5,532,36,496
5000,7435,922,0.19451609258074537,743,124,0.19969631197421542,6692,798,0.1937111462088277,119,0.8,0.7,3156,337,2819
712,1864,0,0.0,192,0,0.0,1672,0,0.0,120,0.8,0.9,23,2,21
5000,2063,2954,0.09999999999999999,216,292,0.10000000000000003,1847,2662,0.09999999999999998,121,0.0,0.1,8597,824,7773
5000,990,638,0.3000000000000004,126,52,0.3,864,586,0.30000000000000027,122,0.0,0.3,9488,927,8561
5000,3752,684,0.5,395,65,0.5,3357,619,0.5,123,0.0,0.5,6734,696,6038
1637,3642,0,0.0,416,0,0.0,3226,0,0.0,124,0.0,0.7,79,2,77
1048,2457,0,0.0,238,0,0.0,2219,0,0.0,125,0.0,0.9,97,15,82
5000,3401,1995,0.13102471951625844,328,208,0.13254052721360954,3073,1787,0.1308482852683295,126,0.8,0.1,7127,721,6406
5000,2507,1774,0.11604889417007838,282,177,0.11623029682850221,2225,1597,0.11602878880342773,127,0.8,0.3,7970,782,7188
5000,9912,121,0.1182220591537716,972,9,0.1165216949991226,8940,112,0.1183586955590559,128,0.8,0.5,521,21,500
1131,2651,0,0.0,281,0,0.0,2370,0,0.0,129,0.8,0.7,62,2,60
5000,10024,80,0.21541470058799345,986,3,0.5882647558625399,9038,77,0.2008880750578163,130,0.8,0.9,536,45,491
5000,2331,3172,0.09999999999999992,212,315,0.10000000000000006,2119,2857,0.09999999999999994,131,0.0,0.1,7944,796,7148
5000,975,890,0.3000000000000004,84,105,0.30000000000000004,891,785,0.3000000000000005,132,0.0,0.3,9620,999,8621
5000,4283,668,0.5,403,67,0.5,3880,601,0.5,133,0.0,0.5,6068,568,5500
1462,3247,0,0.0,334,0,0.0,2913,0,0.0,134,0.0,0.7,134,10,124
1217,2843,0,0.0,275,0,0.0,2568,0,0.0,135,0.0,0.9,108,7,101
5000,2496,2049,0.12584467643533565,217,184,0.13516650634262986,2279,1865,0.12492498919515224,136,0.8,0.1,8096,812,7284
5000,2396,1795,0.1452048011301568,206,172,0.15842758611054708,2190,1623,0.14380349551301128,137,0.8,0.3,8034,847,7187
5000,10041,49,0.08985021714802832,1012,3,0.03992988510845281,9029,46,0.09310589097669628,138,0.8,0.5,379,16,363
566,1636,0,0.0,161,0,0.0,1475,0,0.0,139,0.8,0.7,28,3,25
638,1715,0,0.0,152,0,0.0,1563,0,0.0,140,0.8,0.9,27,2,25
5000,1595,2714,0.09999999999999999,158,259,0.10000000000000002,1437,2455,0.10000000000000006,141,0.0,0.1,8842,853,7989
5000,1026,595,0.3000000000000002,104,55,0.3,922,540,0.30000000000000027,142,0.0,0.3,9325,930,8395
5000,2297,448,0.5,260,48,0.5,2037,400,0.5,143,0.0,0.5,8189,814,7375
552,1575,0,0.0,169,0,0.0,1406,0,0.0,144,0.0,0.7,31,0,31
800,2061,0,0.0,204,0,0.0,1857,0,0.0,145,0.0,0.9,61,0,61
5000,2389,2003,0.11776743812065205,242,196,0.11060738227487192,2147,1807,0.11854406841715065,146,0.8,0.1,7968,772,7196
5000,2306,1609,0.12066873162601147,214,159,0.13621783570007154,2092,1450,0.1189636919378904,147,0.8,0.3,8059,828,7231
5000,5953,1450,0.18738515105890813,657,136,0.19051787694191397,5296,1314,0.18706091154590293,148,0.8,0.5,4542,421,4121
5000,6726,1361,0.2243421368370038,599,131,0.22812741537735323,6127,1230,0.2239389892851454,149,0.8,0.7,3800,398,3402
5000,10401,2,0.14288381626931312,1014,0,0.0,9387,2,0.14288381626931312,150,0.8,0.9,126,12,114
5000,1461,2670,0.09999999999999996,150,273,0.10000000000000009,1311,2397,0.10000000000000006,151,0.0,0.1,9046,973,8073
5000,860,727,0.3000000000000003,75,82,0.30000000000000004,785,645,0.3000000000000002,152,0.0,0.3,9644,913,8731
5000,1442,485,0.5,158,43,0.5,1284,442,0.5,153,0.0,0.5,9209,935,8274
1068,2518,0,0.0,242,0,0.0,2276,0,0.0,154,0.0,0.7,89,7,82
1390,3006,0,0.0,308,0,0.0,2698,0,0.0,155,0.0,0.9,158,11,147
5000,3084,1991,0.1207442566754614,292,216,0.10434771301277906,2792,1775,0.12273955438314554,156,0.8,0.1,7316,704,6612
5000,3580,1806,0.16019606606141262,353,200,0.166376265967547,3227,1606,0.15942642721880554,157,0.8,0.3,6859,727,6132
963,2349,0,0.0,234,0,0.0,2115,0,0.0,158,0.8,0.5,23,0,23
5000,10454,4,0.17841151823294404,1038,0,0.0,9416,4,0.17841151823294404,159,0.8,0.7,71,1,70
5000,10192,7,0.23043623942728206,1004,0,0.0,9188,7,0.23043623942728206,160,0.8,0.9,219,16,203
5000,1713,2826,0.1,157,292,0.10000000000000003,1556,2534,0.10000000000000007,161,0.0,0.1,8739,907,7832
5000,8262,680,0.30000000000000027,886,95,0.3000000000000001,7376,585,0.30000000000000027,162,0.0,0.3,2124,190,1934
5000,7356,337,0.5,746,28,0.5,6610,309,0.5,163,0.0,0.5,3157,283,2874
3103,5764,0,0.0,600,0,0.0,5164,0,0.0,164,0.0,0.7,983,76,907
899,2170,0,0.0,218,0,0.0,1952,0,0.0,165,0.0,0.9,49,1,48
5000,2293,1687,0.10174388118784773,263,161,0.11439208280821551,2030,1526,0.10040943789762545,166,0.8,0.1,8281,789,7492
5000,3030,1999,0.12196769228643829,296,228,0.11198103696356441,2734,1771,0.1232533825256338,167,0.8,0.3,7418,785,6633
5000,2946,1808,0.13223351515008558,276,203,0.1295037053207221,2670,1605,0.13257878081697705,168,0.8,0.5,7648,792,6856
5000,7895,577,0.2263540953783832,878,47,0.33628624269472895,7017,530,0.216605395522028,169,0.8,0.7,2459,203,2256
5000,8486,779,0.18317085500223684,904,82,0.16285557593985964,7582,697,0.1855608878331047,170,0.8,0.9,2084,224,1860
5000,1506,2659,0.09999999999999999,145,269,0.10000000000000007,1361,2390,0.10000000000000007,171,0.0,0.1,8855,919,7936
5000,2545,1860,0.3000000000000004,266,215,0.2999999999999999,2279,1645,0.3000000000000003,172,0.0,0.3,7968,809,7159
4089,8427,0,0.0,870,0,0.0,7557,0,0.0,173,0.0,0.5,282,1,281
2455,5191,0,0.0,512,0,0.0,4679,0,0.0,174,0.0,0.7,230,18,212
1051,2533,0,0.0,251,0,0.0,2282,0,0.0,175,0.0,0.9,43,0,43
5000,3301,2208,0.1529663791161479,313,197,0.163050975419561,2988,2011,0.1519784798263557,176,0.8,0.1,7376,758,6618
5000,2198,1947,0.11588412344403307,231,217,0.1119163728267455,1967,1730,0.116381812394294,177,0.8,0.3,8234,899,7335
5000,10577,3,0.035675023587314274,1105,0,0.0,9472,3,0.035675023587314274,178,0.8,0.5,67,3,64
5000,10153,75,0.3010219175850797,1014,9,0.4029364236858745,9139,66,0.28712448493497134,179,0.8,0.7,392,36,356
1105,2616,0,0.0,269,0,0.0,2347,0,0.0,180,0.8,0.9,63,1,62
5000,2270,3001,0.0999999999999999,226,297,0.10000000000000006,2044,2704,0.10000000000000002,181,0.0,0.1,8111,802,7309
5000,1054,599,0.30000000000000027,104,56,0.3,950,543,0.3000000000000003,182,0.0,0.3,9487,972,8515
5000,5024,687,0.5,527,57,0.5,4497,630,0.5,183,0.0,0.5,5632,519,5113
1355,3099,0,0.0,296,0,0.0,2803,0,0.0,184,0.0,0.7,113,9,104
933,2353,0,0.0,218,0,0.0,2135,0,0.0,185,0.0,0.9,96,4,92
5000,4415,1742,0.15060763838719346,460,185,0.13662752654405474,3955,1557,0.15226873067427152,186,0.8,0.1,5994,604,5390
5000,7925,831,0.2128799800984817,827,94,0.21224041560889229,7098,737,0.21296155277422313,187,0.8,0.3,2562,233,2329
5000,2978,1573,0.12988405590711824,320,142,0.09788295476857735,2658,1431,0.13305956699144583,188,0.8,0.5,7534,698,6836
5000,10199,66,0.10865448151762043,1017,2,0.048013521967085984,9182,64,0.11054951150357462,189,0.8,0.7,298,10,288
5000,8242,629,0.1576192944468888,876,60,0.14448625611982713,7366,569,0.15900414910352095,190,0.8,0.9,2352,201,2151
5000,1833,2771,0.1,194,324,0.10000000000000002,1639,2447,0.10000000000000005,191,0.0,0.1,8651,876,7775
5000,882,633,0.30000000000000027,81,49,0.3000000000000002,801,584,0.3000000000000002,192,0.0,0.3,9440,934,8506
1868,4070,0,0.0,414,0,0.0,3656,0,0.0,193,0.0,0.5,108,4,104
1559,3268,0,0.0,326,0,0.0,2942,0,0.0,194,0.0,0.7,204,11,193
1155,2676,0,0.0,282,0,0.0,2394,0,0.0,195,0.0,0.9,50,2,48
5000,3409,1968,0.11846679385379182,370,189,0.10093954728192983,3039,1779,0.1203288790713758,196,0.8,0.1,7050,695,6355
5000,3045,1723,0.14664318911355323,296,189,0.13944814777700634,2749,1534,0.14752967073846024,197,0.8,0.3,7457,821,6636
5000,10488,19,0.07288428851258434,1106,0,0.0,9382,19,0.07288428851258434,198,0.8,0.5,91,0,91
2875,6145,0,0.0,625,0,0.0,5520,0,0.0,199,0.8,0.7,39,2,37
867,2131,0,0.0,228,0,0.0,1903,0,0.0,200,0.8,0.9,45,0,45
5000,2500,3107,0.09999999999999994,233,316,0.10000000000000007,2267,2791,0.09999999999999996,201,0.0,0.1,8067,809,7258
5000,925,652,0.3000000000000003,102,58,0.30000000000000004,823,594,0.30000000000000016,202,0.0,0.3,9563,959,8604
5000,1297,426,0.5,112,39,0.5,1185,387,0.5,203,0.0,0.5,9110,939,8171
1263,2979,0,0.0,317,0,0.0,2662,0,0.0,204,0.0,0.7,108,8,100
632,1685,0,0.0,154,0,0.0,1531,0,0.0,205,0.0,0.9,40,1,39
5000,2735,1949,0.12406709658618761,291,191,0.13394937472020862,2444,1758,0.12299342472976099,206,0.8,0.1,7512,759,6753
5000,2146,1508,0.1129274874603269,238,143,0.09427796773143671,1908,1365,0.11488124667002013,207,0.8,0.3,8383,826,7557
5000,9015,455,0.2024195489348597,893,56,0.22660162794100222,8122,399,0.1990255729339975,208,0.8,0.5,1407,133,1274
5000,10419,1,0.007556226204214533,1053,0,0.0,9366,1,0.007556226204214533,209,0.8,0.7,147,8,139
653,1784,0,0.0,185,0,0.0,1599,0,0.0,210,0.8,0.9,38,3,35
5000,1742,2823,0.09999999999999998,170,265,0.10000000000000005,1572,2558,0.10000000000000009,211,0.0,0.1,8850,916,7934
5000,814,772,0.30000000000000027,69,78,0.3000000000000001,745,694,0.30000000000000027,212,0.0,0.3,9617,972,8645
5000,1401,419,0.5,140,41,0.5,1261,378,0.5,213,0.0,0.5,9218,919,8299
1361,3232,0,0.0,307,0,0.0,2925,0,0.0,214,0.0,0.7,42,2,40
1276,2915,0,0.0,310,0,0.0,2605,0,0.0,215,0.0,0.9,143,10,133
5000,2830,1774,0.12978500873002627,278,179,0.1291499909079605,2552,1595,0.12985627405300418,216,0.8,0.1,7663,759,6904
5000,2534,1719,0.13211913627849844,261,160,0.14143258757731308,2273,1559,0.13116329778727953,217,0.8,0.3,7859,787,7072
5000,4953,1593,0.1997474252593958,453,180,0.23517855798329784,4500,1413,0.1952339051671789,218,0.8,0.5,5500,581,4919
5000,10181,102,0.21665595010694635,1035,9,0.14157564281284482,9146,93,0.22392178629669807,219,0.8,0.7,352,38,314
5000,10357,4,0.05,1113,0,0.0,9244,4,0.05,220,0.8,0.9,101,5,96
5000,4323,2595,0.1,459,260,0.10000000000000003,3864,2335,0.10000000000000006,221,0.0,0.1,6151,558,5593
5000,849,682,0.3000000000000003,78,78,0.3000000000000001,771,604,0.3000000000000004,222,0.0,0.3,9648,1001,8647
5000,1704,459,0.5,184,53,0.5,1520,406,0.5,223,0.0,0.5,8767,874,7893
1821,4010,0,0.0,404,0,0.0,3606,0,0.0,224,0.0,0.7,153,10,143
1839,3727,0,0.0,341,0,0.0,3386,0,0.0,225,0.0,0.9,404,45,359
5000,2644,1718,0.14623125075473772,253,152,0.14697775878700586,2391,1566,0.14615879275926855,226,0.8,0.1,7706,818,6888
5000,2763,1852,0.11482095298647774,289,187,0.12156214021143683,2474,1665,0.1140638346615124,227,0.8,0.3,7686,750,6936
5000,10079,61,0.1623490866494427,1060,0,0.0,9019,61,0.1623490866494427,228,0.8,0.5,327,7,320
5000,10459,2,0.04879728093740877,1078,0,0.0,9381,2,0.04879728093740877,229,0.8,0.7,41,1,40
5000,9903,65,0.087427780350355,991,2,0.05,8912,63,0.08861596385354088,230,0.8,0.9,393,30,363
5000,2443,2940,0.09999999999999991,266,320,0.10000000000000009,2177,2620,0.09999999999999994,231,0.0,0.1,8090,785,7305
5000,912,991,0.3000000000000005,87,95,0.3000000000000001,825,896,0.30000000000000043,232,0.0,0.3,9454,921,8533
2377,5007,0,0.0,499,0,0.0,4508,0,0.0,233,0.0,0.5,187,13,174
928,2333,0,0.0,206,0,0.0,2127,0,0.0,234,0.0,0.7,52,0,52
583,1622,0,0.0,166,0,0.0,1456,0,0.0,235,0.0,0.9,52,5,47
5000,2112,1748,0.10849147549360237,212,181,0.11039368227250687,1900,1567,0.10827175665060194,236,0.8,0.1,8222,863,7359
5000,3046,2008,0.134209306810025,271,210,0.12154944319849892,2775,1798,0.13568793381693284,237,0.8,0.3,7370,753,6617
5000,4764,1352,0.17567829918039768,454,101,0.16448900771462047,4310,1251,0.1765816712331902,238,0.8,0.5,5562,511,5051
5000,9973,116,0.18108981949242162,1019,4,0.26539129898877745,8954,112,0.17807905236755175,239,0.8,0.7,622,52,570
526,1543,0,0.0,154,0,0.0,1389,0,0.0,240,0.8,0.9,36,2,34
5000,2902,3234,0.09999999999999992,266,345,0.10000000000000006,2636,2889,0.09999999999999999,241,0.0,0.1,7421,826,6595
5000,972,679,0.30000000000000027,96,75,0.30000000000000004,876,604,0.3000000000000004,242,0.0,0.3,9428,1026,8402
5000,1139,434,0.5,101,42,0.5,1038,392,0.5,243,0.0,0.5,9306,900,8406
5000,6211,170,0.7000000000000002,610,19,0.7,5601,151,0.7000000000000002,244,0.0,0.7,4121,437,3684
854,2179,0,0.0,228,0,0.0,1951,0,0.0,245,0.0,0.9,55,0,55
5000,2586,2155,0.14535342800443052,234,218,0.16287510908955918,2352,1937,0.14338144737636754,246,0.8,0.1,8061,816,7245
5000,2644,1909,0.1395549770877208,251,215,0.15240318458115176,2393,1694,0.1379243014023089,247,0.8,0.3,7918,802,7116
5000,3233,1931,0.14460182034979946,344,185,0.16299834960355217,2889,1746,0.1426525890142071,248,0.8,0.5,7258,702,6556
5000,10484,2,0.017697645411853924,1091,0,0.0,9393,2,0.017697645411853924,249,0.8,0.7,97,4,93
725,1876,0,0.0,175,0,0.0,1701,0,0.0,250,0.8,0.9,62,6,56
5000,2068,3020,0.09999999999999998,209,314,0.10000000000000006,1859,2706,0.1,251,0.0,0.1,8503,877,7626
5000,937,638,0.3000000000000004,84,56,0.3,853,582,0.3000000000000002,252,0.0,0.3,9597,996,8601
5000,2368,772,0.5,227,86,0.5,2141,686,0.5,253,0.0,0.5,8148,834,7314
3071,6419,0,0.0,626,0,0.0,5793,0,0.0,254,0.0,0.7,218,14,204
1880,3882,0,0.0,403,0,0.0,3479,0,0.0,255,0.0,0.9,349,36,313
5000,3217,2009,0.13060894868585313,343,174,0.15844775331200694,2874,1835,0.1279691928248445,256,0.8,0.1,7282,640,6642
5000,1906,1384,0.12195135367472025,180,113,0.14185358605493167,1726,1271,0.12018191838049216,257,0.8,0.3,8427,844,7583
5000,2146,1549,0.10590038335835832,220,151,0.10122774087193069,1926,1398,0.10640508222491811,258,0.8,0.5,8217,853,7364
840,2138,0,0.0,220,0,0.0,1918,0,0.0,259,0.8,0.7,42,3,39
531,1486,0,0.0,140,0,0.0,1346,0,0.0,260,0.8,0.9,24,1,23
5000,1677,2779,0.09999999999999999,145,276,0.10000000000000003,1532,2503,0.10000000000000006,261,0.0,0.1,8679,850,7829
5000,1100,1034,0.3000000000000001,123,90,0.3000000000000001,977,944,0.30000000000000054,262,0.0,0.3,9424,899,8525
5000,1958,533,0.5,202,65,0.5,1756,468,0.5,263,0.0,0.5,8603,890,7713
2093,4714,0,0.0,483,0,0.0,4231,0,0.0,264,0.0,0.7,65,1,64
2619,4878,0,0.0,502,0,0.0,4376,0,0.0,265,0.0,0.9,866,97,769
5000,2524,1854,0.12729180008864252,275,216,0.13107843106822822,2249,1638,0.12679246413529058,266,0.8,0.1,7935,842,7093
5000,2020,1942,0.12972814999296545,175,186,0.12267908384050799,1845,1756,0.1304748050637838,267,0.8,0.3,8345,873,7472
5000,10206,97,0.15781123502127417,963,6,0.15279302827759714,9243,91,0.1581421057955825,268,0.8,0.5,240,12,228
639,1725,0,0.0,171,0,0.0,1554,0,0.0,269,0.8,0.7,33,4,29
838,2053,0,0.0,203,0,0.0,1850,0,0.0,270,0.8,0.9,100,6,94
5000,4563,2724,0.09999999999999996,487,259,0.10000000000000002,4076,2465,0.10000000000000006,271,0.0,0.1,6048,545,5503
5000,771,790,0.3000000000000004,57,80,0.3000000000000001,714,710,0.30000000000000027,272,0.0,0.3,9699,945,8754
2651,5691,0,0.0,573,0,0.0,5118,0,0.0,273,0.0,0.5,93,5,88
4485,7525,0,0.0,788,0,0.0,6737,0,0.0,274,0.0,0.7,2062,208,1854
1841,4057,0,0.0,425,0,0.0,3632,0,0.0,275,0.0,0.9,152,17,135
5000,5490,1717,0.16710580671812836,555,191,0.17123438750268222,4935,1526,0.1665890577470603,276,0.8,0.1,5015,499,4516
5000,2672,1666,0.12211466683746958,277,177,0.12041798693871743,2395,1489,0.12231635410548782,277,0.8,0.3,7828,800,7028
5000,7058,938,0.20837329373060925,664,77,0.25097643974112865,6394,861,0.20456325628251398,278,0.8,0.5,3473,348,3125
3224,6869,0,0.0,706,0,0.0,6163,0,0.0,279,0.8,0.7,53,0,53
5000,10276,15,0.08746205282079779,970,0,0.0,9306,15,0.08746205282079779,280,0.8,0.9,290,21,269
5000,2009,2908,0.09999999999999996,197,306,0.10000000000000003,1812,2602,0.09999999999999998,281,0.0,0.1,8489,891,7598
5000,1028,616,0.30000000000000027,94,59,0.30000000000000004,934,557,0.3000000000000003,282,0.0,0.3,9254,937,8317
5000,2513,320,0.5,292,22,0.5,2221,298,0.5,283,0.0,0.5,8088,758,7330
5000,7335,24,0.6999999999999998,753,3,0.6999999999999998,6582,21,0.6999999999999998,284,0.0,0.7,3146,284,2862
1121,2546,0,0.0,233,0,0.0,2313,0,0.0,285,0.0,0.9,105,15,90
5000,3292,1831,0.13975906960892082,333,185,0.14253615850608867,2959,1646,0.1394469423634918,286,0.8,0.1,7177,724,6453
5000,2875,1676,0.14101672915582056,310,168,0.15849999463090536,2565,1508,0.13906899135753525,287,0.8,0.3,7416,737,6679
5000,6097,1421,0.19945205616736583,596,142,0.2126532796013729,5501,1279,0.19798640039908671,288,0.8,0.5,4397,457,3940
5000,10170,48,0.12490729914591729,1016,2,0.06588149940074273,9154,46,0.12747363826527272,289,0.8,0.7,252,5,247
1088,2546,0,0.0,270,0,0.0,2276,0,0.0,290,0.8,0.9,107,7,100
5000,1654,2683,0.09999999999999994,157,261,0.10000000000000003,1497,2422,0.10000000000000009,291,0.0,0.1,8828,827,8001
5000,988,668,0.3000000000000004,112,60,0.30000000000000004,876,608,0.30000000000000043,292,0.0,0.3,9381,929,8452
5000,6399,481,0.5,661,50,0.5,5738,431,0.5,293,0.0,0.5,4089,401,3688
5000,7893,92,0.7000000000000002,741,7,0.7000000000000001,7152,85,0.7000000000000001,294,0.0,0.7,2893,300,2593
2224,4573,0,0.0,431,0,0.0,4142,0,0.0,295,0.0,0.9,220,22,198
5000,2471,1721,0.10426639287945096,260,153,0.09800523917482071,2211,1568,0.10487733453557879,296,0.8,0.1,8150,795,7355
5000,2726,1999,0.12368563411536646,284,207,0.11610614772638944,2442,1792,0.12456116630427173,297,0.8,0.3,7758,798,6960
5000,9950,67,0.0971203620058449,1026,1,0.05,8924,66,0.09783430688472133,298,0.8,0.5,347,9,338
5000,4139,1548,0.15900621225434658,434,141,0.14253243989557352,3705,1407,0.16065710202164366,299,0.8,0.7,6235,635,5600
1145,2634,0,0.0,249,0,0.0,2385,0,0.0,300,0.8,0.9,87,8,79
5000,2076,2992,0.09999999999999992,200,308,0.10000000000000003,1876,2684,0.09999999999999992,301,0.0,0.1,8330,884,7446
5000,844,841,0.3000000000000004,78,75,0.30000000000000004,766,766,0.30000000000000043,302,0.0,0.3,9453,934,8519
5000,1430,327,0.5,163,40,0.5,1267,287,0.5,303,0.0,0.5,8984,908,8076
745,1894,0,0.0,192,0,0.0,1702,0,0.0,304,0.0,0.7,70,4,66
1317,2984,0,0.0,310,0,0.0,2674,0,0.0,305,0.0,0.9,136,11,125
5000,5309,1592,0.16645395544249555,604,173,0.16511148558925445,4705,1419,0.16661762512861997,306,0.8,0.1,5273,524,4749
5000,3227,1710,0.1493114502044609,307,167,0.15987352971858454,2920,1543,0.14816830874052137,307,0.8,0.3,7233,737,6496
5000,2854,1530,0.1439708080820414,298,129,0.15181772010454983,2556,1401,0.1432482872748297,308,0.8,0.5,7552,724,6828
5000,10421,2,0.029105678519230904,1051,0,0.0,9370,2,0.029105678519230904,309,0.8,0.7,140,1,139
5000,10102,35,0.09747571624272289,1010,2,0.08979963599641133,9092,33,0.09794093322734779,310,0.8,0.9,338,26,312
5000,3876,3175,0.09999999999999992,356,293,0.10000000000000003,3520,2882,0.0999999999999999,311,0.0,0.1,6510,642,5868
5000,921,670,0.30000000000000043,84,74,0.30000000000000004,837,596,0.3000000000000002,312,0.0,0.3,9584,964,8620
1142,2718,0,0.0,283,0,0.0,2435,0,0.0,313,0.0,0.5,93,8,85
3197,6158,0,0.0,598,0,0.0,5560,0,0.0,314,0.0,0.7,865,97,768
914,2283,0,0.0,234,0,0.0,2049,0,0.0,315,0.0,0.9,58,0,58
5000,7154,1089,0.14333176944360335,726,125,0.15103445784450484,6428,964,0.14233297686049898,316,0.8,0.1,3408,315,3093
5000,9011,441,0.1360288903783805,922,28,0.11374429215780342,8089,413,0.1375397105967247,317,0.8,0.3,1496,89,1407
5000,6623,1173,0.19956100761691722,664,126,0.19611019025258236,5959,1047,0.1999762922280979,318,0.8,0.5,3787,355,3432
5000,4573,1850,0.1916601460307042,431,190,0.1856069202336303,4142,1660,0.19235298512795962,319,0.8,0.7,5953,644,5309
923,2216,0,0.0,224,0,0.0,1992,0,0.0,320,0.8,0.9,61,9,52
5000,3447,3029,0.09999999999999995,357,296,0.10000000000000005,3090,2733,0.09999999999999994,321,0.0,0.1,7190,654,6536
5000,879,690,0.3000000000000002,88,64,0.3000000000000001,791,626,0.30000000000000016,322,0.0,0.3,9529,923,8606
5000,1699,416,0.5,173,53,0.5,1526,363,0.5,323,0.0,0.5,8623,883,7740
5000,5428,200,0.6999999999999997,503,19,0.7,4925,181,0.7000000000000002,324,0.0,0.7,5025,509,4516
1055,2594,0,0.0,262,0,0.0,2332,0,0.0,325,0.0,0.9,66,4,62
5000,2035,1862,0.13551063859927492,163,182,0.15045172314780877,1872,1680,0.13389202110651707,326,0.8,0.1,8286,809,7477
5000,3269,1902,0.13201594985306525,372,224,0.1368627674665355,2897,1678,0.13136893725150545,327,0.8,0.3,7187,737,6450
5000,8593,498,0.19911791884421293,908,50,0.23979362323718978,7685,448,0.19457821969321107,328,0.8,0.5,1889,176,1713
5000,9207,211,0.2852347813133006,947,17,0.5033724548191215,8260,194,0.2661196243566049,329,0.8,0.7,1414,119,1295
565,1589,0,0.0,180,0,0.0,1409,0,0.0,330,0.8,0.9,26,0,26
5000,1798,2897,0.09999999999999998,180,296,0.10000000000000005,1618,2601,0.09999999999999996,331,0.0,0.1,8519,852,7667
5000,885,673,0.3000000000000005,82,77,0.30000000000000004,803,596,0.3000000000000002,332,0.0,0.3,9469,957,8512
2804,5823,0,0.0,584,0,0.0,5239,0,0.0,333,0.0,0.5,237,10,227
2414,5049,0,0.0,537,0,0.0,4512,0,0.0,334,0.0,0.7,200,12,188
485,1411,0,0.0,139,0,0.0,1272,0,0.0,335,0.0,0.9,41,4,37
5000,5302,1644,0.17033608209971451,519,154,0.1618199697571831,4783,1490,0.17121627089216404,336,0.8,0.1,5294,511,4783
5000,2000,1483,0.10803300334334907,175,141,0.10063427765587475,1825,1342,0.10881036572929086,337,0.8,0.3,8360,844,7516
5000,10477,2,0.0972967189965881,1087,0,0.0,9390,2,0.0972967189965881,338,0.8,0.5,63,1,62
5000,3141,1654,0.14933324967619038,290,158,0.1716651933448448,2851,1496,0.14697466204273624,339,0.8,0.7,7317,711,6606
565,1530,0,0.0,165,0,0.0,1365,0,0.0,340,0.8,0.9,27,0,27
5000,2119,2848,0.09999999999999996,235,295,0.10000000000000005,1884,2553,0.10000000000000009,341,0.0,0.1,8278,795,7483
5000,1000,641,0.30000000000000043,96,56,0.3,904,585,0.30000000000000027,342,0.0,0.3,9524,955,8569
1180,2779,0,0.0,259,0,0.0,2520,0,0.0,343,0.0,0.5,57,0,57
4035,7692,0,0.0,760,0,0.0,6932,0,0.0,344,0.0,0.7,740,66,674
979,2341,0,0.0,231,0,0.0,2110,0,0.0,345,0.0,0.9,76,7,69
5000,1813,1907,0.10853807950514456,193,175,0.10595193803133958,1620,1732,0.10879938132842164,346,0.8,0.1,8765,880,7885
5000,2630,2126,0.11779013016982591,245,243,0.1179607631350335,2385,1883,0.11776811008987613,347,0.8,0.3,7770,831,6939
5000,2972,1747,0.13748182144918095,269,164,0.11895754265370448,2703,1583,0.139400950774802,348,0.8,0.5,7422,755,6667
5000,4108,1578,0.15138251198300606,448,142,0.1622500004537,3660,1436,0.15030787175818816,349,0.8,0.7,6322,618,5704
1549,3434,0,0.0,356,0,0.0,3078,0,0.0,350,0.8,0.9,90,5,85
5000,1714,2745,0.09999999999999992,168,274,0.10000000000000002,1546,2471,0.10000000000000006,351,0.0,0.1,8832,852,7980
5000,980,621,0.3000000000000003,109,51,0.3,871,570,0.30000000000000027,352,0.0,0.3,9653,912,8741
1181,2801,0,0.0,263,0,0.0,2538,0,0.0,353,0.0,0.5,60,0,60
756,1978,0,0.0,194,0,0.0,1784,0,0.0,354,0.0,0.7,66,4,62
346,1098,0,0.0,96,0,0.0,1002,0,0.0,355,0.0,0.9,22,1,21
5000,3149,1854,0.13733052214856342,320,195,0.15127514253735047,2829,1659,0.13569146188586684,356,0.8,0.1,7456,750,6706
5000,2149,1569,0.10536788219328123,228,131,0.07795803864244877,1921,1438,0.10786488463080493,357,0.8,0.3,8336,803,7533
5000,10131,62,0.11921741809719004,1043,3,0.25103973591858947,9088,59,0.11251458837745787,358,0.8,0.5,331,14,317
745,1870,0,0.0,175,0,0.0,1695,0,0.0,359,0.8,0.7,30,1,29
5000,3021,1837,0.13278142457412992,305,154,0.15271573451098383,2716,1683,0.13095737007010408,360,0.8,0.9,7232,669,6563
5000,1764,2723,0.09999999999999998,199,273,0.10000000000000009,1565,2450,0.10000000000000005,361,0.0,0.1,8659,856,7803
5000,1126,531,0.3000000000000001,128,40,0.3000000000000001,998,491,0.3000000000000002,362,0.0,0.3,9290,898,8392
5000,2456,871,0.5,224,83,0.5,2232,788,0.5,363,0.0,0.5,7991,848,7143
1581,3443,0,0.0,370,0,0.0,3073,0,0.0,364,0.0,0.7,181,18,163
1790,3953,0,0.0,422,0,0.0,3531,0,0.0,365,0.0,0.9,163,17,146
5000,2764,1946,0.1252629135080229,258,222,0.12105376927735259,2506,1724,0.1258049262801858,366,0.8,0.1,7757,814,6943
5000,7071,1163,0.15653984945525679,717,111,0.1501583614659185,6354,1052,0.15721318136287704,367,0.8,0.3,3372,297,3075
5000,10270,2,0.05,938,0,0.0,9332,2,0.05,368,0.8,0.5,155,8,147
5000,3732,1835,0.12860274312898418,442,205,0.1292670653203888,3290,1630,0.12851919340552528,369,0.8,0.7,6793,699,6094
5000,9672,195,0.16063757953588811,960,18,0.18229571729445343,8712,177,0.15843505705196625,370,0.8,0.9,627,52,575
5000,2347,2905,0.09999999999999996,259,306,0.10000000000000003,2088,2599,0.09999999999999999,371,0.0,0.1,8057,808,7249
5000,884,986,0.30000000000000043,85,113,0.2999999999999999,799,873,0.30000000000000043,372,0.0,0.3,9670,927,8743
5000,2427,849,0.5,220,92,0.5,2207,757,0.5,373,0.0,0.5,8150,822,7328
1570,3524,0,0.0,354,0,0.0,3170,0,0.0,374,0.0,0.7,142,16,126
1001,2357,0,0.0,232,0,0.0,2125,0,0.0,375,0.0,0.9,115,17,98
5000,4571,1811,0.1770503102460781,416,197,0.19545114041975994,4155,1614,0.17480436009476744,376,0.8,0.1,6032,622,5410
5000,2193,1849,0.10775475920383497,226,171,0.11631770363870482,1967,1678,0.10688213494974512,377,0.8,0.3,8259,806,7453
5000,4361,1391,0.15464255823471848,460,121,0.16928727309275216,3901,1270,0.15324727437816568,378,0.8,0.5,5975,560,5415
5000,10369,1,0.0009794233510772576,1068,0,0.0,9301,1,0.0009794233510772576,379,0.8,0.7,94,6,88
5000,4782,1702,0.1596710369637719,483,178,0.14767430173220186,4299,1524,0.16107223044882402,380,0.8,0.9,5611,565,5046
5000,2733,2887,0.09999999999999998,316,299,0.10000000000000006,2417,2588,0.1,381,0.0,0.1,7827,735,7092
5000,875,735,0.3000000000000005,59,69,0.3,816,666,0.3000000000000004,382,0.0,0.3,9891,949,8942
5000,9855,3,0.5,1034,0,0.0,8821,3,0.5,383,0.0,0.5,568,33,535
5000,6282,128,0.7000000000000004,611,12,0.7000000000000001,5671,116,0.7000000000000002,384,0.0,0.7,4191,432,3759
2309,4799,0,0.0,472,0,0.0,4327,0,0.0,385,0.0,0.9,224,20,204
5000,3574,2046,0.14199232962653216,390,188,0.15604155560735633,3184,1858,0.14057077177701924,386,0.8,0.1,6945,648,6297
5000,2223,1608,0.103973553335694,233,149,0.10489398325751985,1990,1459,0.10387955466650135,387,0.8,0.3,8203,809,7394
5000,2522,1841,0.12218737080102166,248,203,0.1184793469426007,2274,1638,0.12264691221937297,388,0.8,0.5,7778,815,6963
5000,9902,86,0.1793885692995052,986,7,0.11812275564197752,8916,79,0.18481718569953937,389,0.8,0.7,517,23,494
802,2006,0,0.0,211,0,0.0,1795,0,0.0,390,0.8,0.9,54,3,51
5000,2351,2917,0.09999999999999994,255,270,0.10000000000000007,2096,2647,0.10000000000000002,391,0.0,0.1,8151,827,7324
5000,896,668,0.3000000000000004,75,70,0.3,821,598,0.30000000000000027,392,0.0,0.3,9577,967,8610
5000,2306,417,0.5,255,42,0.5,2051,375,0.5,393,0.0,0.5,8261,826,7435
5000,9531,3,0.6999999999999998,940,0,0.0,8591,3,0.6999999999999998,394,0.0,0.7,975,80,895
527,1435,0,0.0,153,0,0.0,1282,0,0.0,395,0.0,0.9,45,3,42
5000,2301,1746,0.11442162652579768,204,168,0.10580992510823763,2097,1578,0.11533846165770521,396,0.8,0.1,8049,823,7226
5000,4143,1786,0.16945853298019864,403,194,0.18138084084029515,3740,1592,0.16800568893192053,397,0.8,0.3,6420,631,5789
5000,9831,134,0.10015102530614595,1014,3,0.16054739388588118,8817,131,0.09876790236157185,398,0.8,0.5,813,44,769
5000,10242,13,0.18006940265681265,1066,0,0.0,9176,13,0.18006940265681265,399,0.8,0.7,226,14,212
522,1467,0,0.0,145,0,0.0,1322,0,0.0,400,0.8,0.9,31,0,31
5000,3698,3027,0.09999999999999998,389,295,0.10000000000000005,3309,2732,0.09999999999999995,401,0.0,0.1,6777,677,6100
5000,7131,1037,0.30000000000000016,696,119,0.2999999999999999,6435,918,0.3000000000000003,402,0.0,0.3,3321,318,3003
5000,1504,502,0.5,127,66,0.5,1377,436,0.5,403,0.0,0.5,8907,878,8029
1577,3515,0,0.0,365,0,0.0,3150,0,0.0,404,0.0,0.7,93,3,90
635,1686,0,0.0,176,0,0.0,1510,0,0.0,405,0.0,0.9,58,4,54
5000,2215,2022,0.10609217219417091,242,212,0.10864362654245235,1973,1810,0.10579332781746613,406,0.8,0.1,8206,831,7375
5000,2075,1784,0.12714164656294352,185,178,0.13625232870094897,1890,1606,0.12613186983780972,407,0.8,0.3,8324,838,7486
5000,2639,1700,0.13930153801799214,235,176,0.18367004164533096,2404,1524,0.13417761633924433,408,0.8,0.5,7794,781,7013
2751,5931,0,0.0,583,0,0.0,5348,0,0.0,409,0.8,0.7,102,11,91
1289,2916,0,0.0,304,0,0.0,2612,0,0.0,410,0.8,0.9,40,0,40
5000,1563,2496,0.10000000000000007,171,243,0.10000000000000002,1392,2253,0.10000000000000006,411,0.0,0.1,8980,857,8123
5000,1469,1404,0.3000000000000004,132,127,0.2999999999999997,1337,1277,0.3000000000000004,412,0.0,0.3,9069,940,8129
1161,2869,0,0.0,271,0,0.0,2598,0,0.0,413,0.0,0.5,56,2,54
990,2447,0,0.0,254,0,0.0,2193,0,0.0,414,0.0,0.7,57,0,57
1762,3647,0,0.0,356,0,0.0,3291,0,0.0,415,0.0,0.9,368,39,329
5000,7849,770,0.18432275765085251,785,85,0.18087352012699606,7064,685,0.18475076522680547,416,0.8,0.1,2577,238,2339
5000,3204,1961,0.15736160950541264,322,216,0.16506482144567164,2882,1745,0.15640808871509976,417,0.8,0.3,7240,744,6496
5000,3212,1831,0.15306182986551287,328,167,0.1477587359133267,2884,1664,0.15359405143403154,418,0.8,0.5,7390,714,6676
5000,9392,273,0.13100886529280314,970,14,0.17431626248714518,8422,259,0.12866792490391982,419,0.8,0.7,1028,61,967
5000,6710,993,0.26300890448913244,645,98,0.30871241578869113,6065,895,0.2580044976652701,420,0.8,0.9,3699,374,3325
5000,1408,2379,0.10000000000000006,132,234,0.10000000000000006,1276,2145,0.10000000000000006,421,0.0,0.1,9107,900,8207
5000,1040,652,0.3000000000000003,117,67,0.3,923,585,0.30000000000000027,422,0.0,0.3,9400,932,8468
5000,1147,450,0.5,104,40,0.5,1043,410,0.5,423,0.0,0.5,9481,931,8550
1345,3123,0,0.0,315,0,0.0,2808,0,0.0,424,0.0,0.7,55,1,54
937,2332,0,0.0,222,0,0.0,2110,0,0.0,425,0.0,0.9,59,7,52
5000,5479,1564,0.18037238526932772,571,173,0.1886866159228311,4908,1391,0.17933833645332756,426,0.8,0.1,4970,490,4480
5000,2920,1787,0.13151118786204857,296,197,0.14956692112717185,2624,1590,0.1292740938663069,427,0.8,0.3,7462,776,6686
5000,5714,1288,0.20473710942748213,595,104,0.2486273918395542,5119,1184,0.20088188191831355,428,0.8,0.5,4729,419,4310
1393,3172,0,0.0,307,0,0.0,2865,0,0.0,429,0.8,0.7,45,3,42
1022,2516,0,0.0,249,0,0.0,2267,0,0.0,430,0.8,0.9,40,4,36
5000,2527,2977,0.09999999999999994,242,295,0.10000000000000005,2285,2682,0.09999999999999994,431,0.0,0.1,7697,753,6944
5000,2574,1884,0.3000000000000005,246,184,0.2999999999999999,2328,1700,0.3000000000000003,432,0.0,0.3,7858,828,7030
5000,7195,528,0.5,709,58,0.5,6486,470,0.5,433,0.0,0.5,3193,326,2867
953,2360,0,0.0,260,0,0.0,2100,0,0.0,434,0.0,0.7,17,0,17
1160,2581,0,0.0,232,0,0.0,2349,0,0.0,435,0.0,0.9,150,14,136
5000,2971,1724,0.1273470317238364,318,166,0.129564559700557,2653,1558,0.12711076109217043,436,0.8,0.1,7368,718,6650
5000,3919,1825,0.1607832498120368,390,188,0.16856866149331476,3529,1637,0.15988914022371647,437,0.8,0.3,6592,656,5936
5000,9813,229,0.32656257540166217,944,27,0.46716063657798657,8869,202,0.30776976524443056,438,0.8,0.5,617,63,554
5000,10400,1,0.05,1036,0,0.0,9364,1,0.05,439,0.8,0.7,54,0,54
5000,9657,293,0.12734644181769358,970,26,0.08619655513761568,8687,267,0.1313535468876637,440,0.8,0.9,843,71,772
5000,2263,2999,0.09999999999999992,216,272,0.10000000000000009,2047,2727,0.09999999999999998,441,0.0,0.1,8334,797,7537
5000,10225,2,0.3,1027,0,0.0,9198,2,0.3,442,0.0,0.3,224,3,221
5000,1597,439,0.5,146,39,0.5,1451,400,0.5,443,0.0,0.5,8930,881,8049
1545,3400,0,0.0,339,0,0.0,3061,0,0.0,444,0.0,0.7,138,3,135
766,1939,0,0.0,186,0,0.0,1753,0,0.0,445,0.0,0.9,40,2,38
5000,6237,1564,0.14720912393982627,664,149,0.1375601646012994,5573,1415,0.14822516276769943,446,0.8,0.1,4442,409,4033
5000,2169,1758,0.11653146016251784,212,165,0.11122792170596636,1957,1593,0.11708079088777266,447,0.8,0.3,8346,872,7474
5000,1913,2007,0.11783283072000988,171,189,0.1313014829335173,1742,1818,0.11643262430177398,448,0.8,0.5,8691,829,7862
5000,10082,25,0.08054366821440448,1073,1,0.15905843804878045,9009,24,0.0772722194713055,449,0.8,0.7,427,20,407
1025,2581,0,0.0,242,0,0.0,2339,0,0.0,450,0.8,0.9,24,1,23
5000,1884,2787,0.09999999999999998,196,238,0.10000000000000007,1688,2549,0.10000000000000007,451,0.0,0.1,8542,808,7734
5000,1046,600,0.30000000000000027,126,55,0.3,920,545,0.3000000000000004,452,0.0,0.3,9397,942,8455
1218,2854,0,0.0,312,0,0.0,2542,0,0.0,453,0.0,0.5,85,4,81
2082,4409,0,0.0,444,0,0.0,3965,0,0.0,454,0.0,0.7,233,20,213
1348,2802,0,0.0,284,0,0.0,2518,0,0.0,455,0.0,0.9,331,46,285
5000,4905,1881,0.16380338739409275,481,214,0.14326313400482327,4424,1667,0.1664402285610415,456,0.8,0.1,5718,619,5099
5000,3302,1961,0.1349699941472993,353,207,0.11618673348301738,2949,1754,0.13718671875249103,457,0.8,0.3,7150,704,6446
5000,2552,1977,0.132537403076639,236,199,0.14099864480750712,2316,1778,0.13159039120687363,458,0.8,0.5,8113,808,7305
5000,10056,33,0.14373918777718347,1033,0,0.0,9023,33,0.14373918777718347,459,0.8,0.7,306,14,292
5000,2485,1509,0.12416782451488922,240,163,0.1275272197110131,2245,1346,0.12376100325414018,460,0.8,0.9,8026,801,7225
5000,2861,3095,0.09999999999999996,297,271,0.10000000000000009,2564,2824,0.1,461,0.0,0.1,7577,701,6876
5000,906,696,0.3000000000000003,91,75,0.30000000000000004,815,621,0.3000000000000003,462,0.0,0.3,9666,946,8720
2623,5501,0,0.0,565,0,0.0,4936,0,0.0,463,0.0,0.5,209,12,197
1570,3583,0,0.0,349,0,0.0,3234,0,0.0,464,0.0,0.7,49,1,48
805,2078,0,0.0,207,0,0.0,1871,0,0.0,465,0.0,0.9,49,2,47
5000,4680,1938,0.12965335378651568,488,192,0.10239949281777001,4192,1746,0.13265034193428155,466,0.8,0.1,5916,527,5389
5000,2636,2003,0.11577973124614581,285,187,0.11188771674297895,2351,1816,0.11618050586734195,467,0.8,0.3,7856,763,7093
5000,10430,1,0.0021265255195442034,1079,0,0.0,9351,1,0.0021265255195442034,468,0.8,0.5,128,6,122
5000,8697,650,0.14953059793835619,908,60,0.14930521795701912,7789,590,0.14955351793645824,469,0.8,0.7,1896,165,1731
661,1746,0,0.0,181,0,0.0,1565,0,0.0,470,0.8,0.9,40,7,33
5000,1462,2514,0.10000000000000006,139,223,0.10000000000000009,1323,2291,0.10000000000000009,471,0.0,0.1,9177,940,8237
5000,811,677,0.30000000000000027,68,67,0.3,743,610,0.30000000000000016,472,0.0,0.3,9694,990,8704
5000,3471,412,0.5,381,50,0.5,3090,362,0.5,473,0.0,0.5,7006,666,6340
1026,2493,0,0.0,258,0,0.0,2235,0,0.0,474,0.0,0.7,43,1,42
1865,3911,0,0.0,399,0,0.0,3512,0,0.0,475,0.0,0.9,312,41,271
5000,6856,1184,0.16040994934275038,715,120,0.14975062285564417,6141,1064,0.16161212902174735,476,0.8,0.1,3643,337,3306
5000,2200,1835,0.13894845472938486,241,173,0.15405531068406184,1959,1662,0.1373759600963168,477,0.8,0.3,8334,833,7501
5000,2493,1849,0.12429332120694561,247,181,0.1335966845432794,2246,1668,0.12328378357872237,478,0.8,0.5,8214,842,7372
5000,9364,361,0.25756983224670366,891,46,0.19458132214945836,8473,315,0.26676815435614265,479,0.8,0.7,868,97,771
5000,4345,1864,0.1565408651693608,428,195,0.15544565192133392,3917,1669,0.15666882597425308,480,0.8,0.9,6188,604,5584
5000,2643,3153,0.09999999999999995,258,298,0.10000000000000006,2385,2855,0.09999999999999996,481,0.0,0.1,7851,784,7067
5000,928,759,0.3000000000000003,101,87,0.30000000000000004,827,672,0.30000000000000043,482,0.0,0.3,9782,950,8832
5000,5407,508,0.5,598,51,0.5,4809,457,0.5,483,0.0,0.5,5013,429,4584
3109,6086,0,0.0,628,0,0.0,5458,0,0.0,484,0.0,0.7,667,88,579
1522,3320,0,0.0,337,0,0.0,2983,0,0.0,485,0.0,0.9,132,12,120
5000,7159,1160,0.15579183390327933,758,129,0.15367709814039987,6401,1031,0.15605643226740296,486,0.8,0.1,3356,295,3061
5000,2147,1976,0.11717592481786883,196,234,0.12117181381161032,1951,1742,0.11663916360975428,487,0.8,0.3,8186,819,7367
5000,10091,65,0.09050625510538239,1043,9,0.09376063930892418,9048,56,0.08998322907267031,488,0.8,0.5,357,28,329
5000,8231,738,0.19541050753933661,855,68,0.1876977330765817,7376,670,0.19619329658928789,489,0.8,0.7,2206,212,1994
1228,2951,0,0.0,310,0,0.0,2641,0,0.0,490,0.8,0.9,22,2,20
5000,1681,2947,0.0999999999999999,158,307,0.10000000000000003,1523,2640,0.10000000000000002,491,0.0,0.1,8739,922,7817
5000,930,778,0.3000000000000004,103,93,0.3000000000000001,827,685,0.3000000000000004,492,0.0,0.3,9680,985,8695
2689,5717,0,0.0,558,0,0.0,5159,0,0.0,493,0.0,0.5,109,1,108
1154,2689,0,0.0,296,0,0.0,2393,0,0.0,494,0.0,0.7,54,3,51
1216,2821,0,0.0,293,0,0.0,2528,0,0.0,495,0.0,0.9,102,6,96
5000,2280,1780,0.11090844561680906,233,162,0.11490488812982859,2047,1618,0.11050830736766865,496,0.8,0.1,8251,775,7476
5000,2398,1585,0.11847375536287268,254,141,0.1006604063793924,2144,1444,0.12021314747275547,497,0.8,0.3,8050,817,7233
5000,2618,1588,0.12097924898104033,263,153,0.12189306022108382,2355,1435,0.12088181823558622,498,0.8,0.5,7985,771,7214
1869,4128,0,0.0,441,0,0.0,3687,0,0.0,499,0.8,0.7,77,1,76
1445,3365,0,0.0,338,0,0.0,3027,0,0.0,500,0.8,0.9,65,4,61
5000,2274,3104,0.09999999999999994,217,297,0.10000000000000006,2057,2807,0.09999999999999994,501,0.0,0.1,8242,815,7427
5000,4929,1565,0.30000000000000043,504,164,0.29999999999999993,4425,1401,0.3000000000000004,502,0.0,0.3,5572,596,4976
3639,7540,0,0.0,744,0,0.0,6796,0,0.0,503,0.0,0.5,178,8,170
4506,8513,0,0.0,846,0,0.0,7667,0,0.0,504,0.0,0.7,968,131,837
475,1390,0,0.0,141,0,0.0,1249,0,0.0,505,0.0,0.9,39,1,38
5000,3310,1740,0.1294397775981981,357,183,0.1693151834335779,2953,1557,0.12475307286610142,506,0.8,0.1,7082,655,6427
5000,2248,1678,0.12128353791628553,247,173,0.13353592211331225,2001,1505,0.11987512431755755,507,0.8,0.3,8430,874,7556
5000,8345,530,0.21564775431277838,878,23,0.2532188654277698,7467,507,0.2139433449328084,508,0.8,0.5,2197,178,2019
5000,2241,1758,0.12709244190054478,265,180,0.1374586348087047,1976,1578,0.1259099864357357,509,0.8,0.7,8145,807,7338
1114,2684,0,0.0,249,0,0.0,2435,0,0.0,510,0.8,0.9,50,1,49
5000,3424,3055,0.09999999999999992,345,303,0.10000000000000009,3079,2752,0.09999999999999991,511,0.0,0.1,7070,681,6389
5000,1270,1356,0.30000000000000027,131,136,0.2999999999999999,1139,1220,0.30000000000000016,512,0.0,0.3,9154,931,8223
4304,8703,0,0.0,921,0,0.0,7782,0,0.0,513,0.0,0.5,515,32,483
2282,5010,0,0.0,512,0,0.0,4498,0,0.0,514,0.0,0.7,113,2,111
555,1569,0,0.0,160,0,0.0,1409,0,0.0,515,0.0,0.9,30,0,30
5000,3199,1793,0.1395645297801584,339,147,0.12331665501557021,2860,1646,0.1410155854243835,516,0.8,0.1,7452,687,6765
5000,2028,1881,0.10396837651938444,218,180,0.08299791250528983,1810,1701,0.10618747324045268,517,0.8,0.3,8419,862,7557
5000,4398,1529,0.1598393749163021,451,164,0.177846537153089,3947,1365,0.15767587703583832,518,0.8,0.5,6048,571,5477
5000,8732,376,0.17185684065808288,908,18,0.1749041878383795,7824,358,0.17170362208477186,519,0.8,0.7,1703,109,1594
5000,10346,13,0.08175963931389521,1007,0,0.0,9339,13,0.08175963931389521,520,0.8,0.9,135,1,134
5000,2066,3020,0.09999999999999998,176,297,0.10000000000000006,1890,2723,0.09999999999999998,521,0.0,0.1,8474,867,7607
5000,1014,684,0.3000000000000004,116,62,0.3000000000000001,898,622,0.3000000000000004,522,0.0,0.3,9609,927,8682
3901,8014,0,0.0,829,0,0.0,7185,0,0.0,523,0.0,0.5,377,27,350
1884,4113,0,0.0,455,0,0.0,3658,0,0.0,524,0.0,0.7,93,5,88
742,1905,0,0.0,170,0,0.0,1735,0,0.0,525,0.0,0.9,92,8,84
5000,2072,1858,0.10716096051728508,197,163,0.10188503806334566,1875,1695,0.10766832061167571,526,0.8,0.1,8415,820,7595
5000,7642,697,0.18258582849817,831,58,0.2625087198558049,6811,639,0.1753314815517806,527,0.8,0.3,2691,248,2443
5000,9677,179,0.17184114826624955,954,19,0.24984074219568678,8723,160,0.1625786964871289,528,0.8,0.5,827,56,771
5000,8937,453,0.17428572263996983,889,30,0.1817635600715207,8048,423,0.17375537955971804,529,0.8,0.7,1717,118,1599
5000,3681,1268,0.1461091697043491,414,129,0.12615423296259642,3267,1139,0.14836921082786633,530,0.8,0.9,6916,670,6246
5000,1432,2572,0.10000000000000003,138,235,0.10000000000000006,1294,2337,0.10000000000000006,531,0.0,0.1,8878,880,7998
5000,1449,1674,0.3000000000000003,128,149,0.29999999999999993,1321,1525,0.3000000000000004,532,0.0,0.3,8943,915,8028
3223,6688,0,0.0,655,0,0.0,6033,0,0.0,533,0.0,0.5,200,11,189
1117,2578,0,0.0,244,0,0.0,2334,0,0.0,534,0.0,0.7,70,4,66
628,1744,0,0.0,176,0,0.0,1568,0,0.0,535,0.0,0.9,30,3,27
5000,3151,2251,0.1194392501049008,316,238,0.10315335575347759,2835,2013,0.1213647557460527,536,0.8,0.1,7369,763,6606
5000,2261,1754,0.1148708690886553,236,171,0.10770114014764662,2025,1583,0.11564536286560573,537,0.8,0.3,8180,761,7419
5000,2721,1871,0.13774784701319986,314,185,0.14995788892379333,2407,1686,0.13640807373119523,538,0.8,0.5,7695,776,6919
5000,10379,3,0.03659316760356008,1103,0,0.0,9276,3,0.03659316760356008,539,0.8,0.7,113,3,110
818,2020,0,0.0,213,0,0.0,1807,0,0.0,540,0.8,0.9,61,7,54
5000,2171,2932,0.09999999999999992,204,298,0.10000000000000006,1967,2634,0.10000000000000003,541,0.0,0.1,8279,843,7436
5000,781,698,0.3000000000000003,73,53,0.3,708,645,0.3000000000000002,542,0.0,0.3,9485,870,8615
5000,2684,523,0.5,291,48,0.5,2393,475,0.5,543,0.0,0.5,7695,753,6942
1461,3195,0,0.0,296,0,0.0,2899,0,0.0,544,0.0,0.7,134,16,118
1366,2999,0,0.0,297,0,0.0,2702,0,0.0,545,0.0,0.9,193,16,177
5000,2485,2161,0.13952748795938777,197,235,0.13579755906786423,2288,1926,0.13998259350949585,546,0.8,0.1,7976,873,7103
5000,2976,1552,0.134753367329136,292,164,0.14961453194861166,2684,1388,0.13299743721559568,547,0.8,0.3,7486,743,6743
5000,10552,5,0.12893092870850204,1091,0,0.0,9461,5,0.12893092870850204,548,0.8,0.5,85,1,84
5000,3175,1530,0.1543243800294364,301,127,0.14651036238349993,2874,1403,0.15503170735732943,549,0.8,0.7,7405,722,6683
5000,9732,123,0.16794741642218006,982,5,0.24249251112185516,8750,118,0.16478872596880398,550,0.8,0.9,652,40,612
5000,1545,2545,0.10000000000000007,178,231,0.10000000000000003,1367,2314,0.10000000000000003,551,0.0,0.1,9100,880,8220
5000,850,655,0.3000000000000004,80,73,0.30000000000000004,770,582,0.3000000000000002,552,0.0,0.3,9697,974,8723
5000,2644,841,0.5,264,79,0.5,2380,762,0.5,553,0.0,0.5,8002,832,7170
5000,9235,15,0.6999999999999998,943,0,0.0,8292,15,0.6999999999999998,554,0.0,0.7,1266,113,1153
1121,2672,0,0.0,274,0,0.0,2398,0,0.0,555,0.0,0.9,83,5,78
5000,3220,1681,0.12923525333371408,321,158,0.12348381667034719,2899,1523,0.12983192240319008,556,0.8,0.1,7368,698,6670
5000,4273,1745,0.14781168844409484,498,170,0.16708837489713332,3775,1575,0.14573103022376685,557,0.8,0.3,6209,587,5622
5000,8756,519,0.14929340319705614,889,51,0.14230867808910602,7867,468,0.1500545591383071,558,0.8,0.5,1611,141,1470
5000,10251,1,0.011299667826501159,1102,0,0.0,9149,1,0.011299667826501159,559,0.8,0.7,230,13,217
848,2088,0,0.0,209,0,0.0,1879,0,0.0,560,0.8,0.9,28,0,28
5000,1693,2632,0.10000000000000003,155,255,0.10000000000000009,1538,2377,0.10000000000000006,561,0.0,0.1,8639,859,7780
5000,973,600,0.30000000000000027,112,58,0.30000000000000004,861,542,0.3000000000000003,562,0.0,0.3,9479,895,8584
5000,5382,617,0.5,602,70,0.5,4780,547,0.5,563,0.0,0.5,5096,477,4619
5000,6395,320,0.6999999999999993,594,38,0.6999999999999998,5801,282,0.6999999999999995,564,0.0,0.7,4161,476,3685
1187,2645,0,0.0,278,0,0.0,2367,0,0.0,565,0.0,0.9,144,18,126
5000,2858,1797,0.10418820547630683,271,193,0.09561220716101212,2587,1604,0.10522010552297262,566,0.8,0.1,7600,754,6846
5000,2142,1699,0.11533866588721797,206,160,0.1306649714453376,1936,1539,0.11374528779150701,567,0.8,0.3,8391,813,7578
5000,8255,655,0.19714386346642299,816,67,0.23148492116102926,7439,588,0.19323085179033678,568,0.8,0.5,1962,201,1761
5000,4542,1306,0.15670030329281143,451,128,0.1336167362350758,4091,1178,0.1592085346878795,569,0.8,0.7,5839,602,5237
1455,3279,0,0.0,336,0,0.0,2943,0,0.0,570,0.8,0.9,45,2,43
5000,6686,1926,0.0999999999999999,705,181,0.1,5981,1745,0.09999999999999991,571,0.0,0.1,3796,345,3451
5000,887,696,0.3000000000000003,77,67,0.3,810,629,0.3000000000000002,572,0.0,0.3,9629,941,8688
4034,8035,0,0.0,803,0,0.0,7232,0,0.0,573,0.0,0.5,534,26,508
1842,3923,0,0.0,406,0,0.0,3517,0,0.0,574,0.0,0.7,138,10,128
1248,2870,0,0.0,289,0,0.0,2581,0,0.0,575,0.0,0.9,105,9,96
5000,3158,1980,0.13093284041475678,315,199,0.14016771582292667,2843,1781,0.12990098179250756,576,0.8,0.1,7297,698,6599
5000,2051,1755,0.11514092240934568,159,176,0.11049245337785228,1892,1579,0.11565905448632026,577,0.8,0.3,8367,843,7524
5000,2661,1543,0.13205897542375664,262,142,0.1155272171608372,2399,1401,0.13373457119344587,578,0.8,0.5,7680,808,6872
5000,9165,527,0.17660463138897037,942,69,0.20506376705098245,8223,458,0.17231711968443142,579,0.8,0.7,1409,143,1266
5000,10242,8,0.07729176796133477,1029,0,0.0,9213,8,0.07729176796133477,580,0.8,0.9,97,6,91
5000,1464,2613,0.09999999999999994,138,256,0.10000000000000009,1326,2357,0.10000000000000006,581,0.0,0.1,8971,909,8062
5000,9947,60,0.30000000000000004,1080,4,0.3,8867,56,0.3,582,0.0,0.3,573,14,559
5000,1947,560,0.5,188,56,0.5,1759,504,0.5,583,0.0,0.5,8545,831,7714
1506,3257,0,0.0,323,0,0.0,2934,0,0.0,584,0.0,0.7,108,9,99
839,2100,0,0.0,214,0,0.0,1886,0,0.0,585,0.0,0.9,57,1,56
5000,3249,1935,0.1356854219976998,307,191,0.13877092154082313,2942,1744,0.13534750318305727,586,0.8,0.1,7126,693,6433
5000,5269,1721,0.20009489901549646,495,165,0.2106923770729616,4774,1556,0.19897113045541823,587,0.8,0.3,5436,539,4897
5000,2950,1829,0.12312579869403553,284,224,0.12207802393485008,2666,1605,0.12327203018690629,588,0.8,0.5,7448,782,6666
5000,9828,23,0.09924603792821607,943,0,0.0,8885,23,0.09924603792821607,589,0.8,0.7,539,23,516
1202,2827,0,0.0,263,0,0.0,2564,0,0.0,590,0.8,0.9,51,1,50
5000,2367,3007,0.09999999999999991,235,344,0.10000000000000006,2132,2663,0.09999999999999998,591,0.0,0.1,7999,869,7130
5000,981,912,0.30000000000000054,120,89,0.30000000000000004,861,823,0.3000000000000004,592,0.0,0.3,9649,944,8705
2196,4780,0,0.0,450,0,0.0,4330,0,0.0,593,0.0,0.5,98,0,98
1989,4186,0,0.0,374,0,0.0,3812,0,0.0,594,0.0,0.7,204,13,191
470,1354,0,0.0,131,0,0.0,1223,0,0.0,595,0.0,0.9,17,0,17
5000,2784,2004,0.12870637920836683,261,224,0.14272865315616548,2523,1780,0.12694177844190224,596,0.8,0.1,7654,795,6859
5000,1918,1963,0.1195634763733658,171,214,0.12218434664284344,1747,1749,0.1192427981357053,597,0.8,0.3,8478,880,7598
5000,9377,312,0.18311654566801705,978,29,0.15872471355775283,8399,283,0.18561606203267308,598,0.8,0.5,1005,75,930
5000,10093,107,0.12513030143165388,1025,7,0.15642882584410564,9068,100,0.1229394047227823,599,0.8,0.7,382,19,363
866,2235,0,0.0,209,0,0.0,2026,0,0.0,600,0.8,0.9,25,2,23
5000,2483,3243,0.09999999999999992,244,351,0.10000000000000009,2239,2892,0.09999999999999999,601,0.0,0.1,8140,861,7279
5000,1072,734,0.30000000000000043,112,78,0.3000000000000001,960,656,0.30000000000000043,602,0.0,0.3,9478,937,8541
5000,1514,455,0.5,158,42,0.5,1356,413,0.5,603,0.0,0.5,8864,881,7983
2181,4619,0,0.0,471,0,0.0,4148,0,0.0,604,0.0,0.7,253,21,232
1440,3013,0,0.0,300,0,0.0,2713,0,0.0,605,0.0,0.9,255,27,228
5000,7409,1005,0.18630272431143727,739,115,0.1786211025407095,6670,890,0.18729529341664364,606,0.8,0.1,2977,331,2646
5000,3498,1849,0.16171765578979908,353,191,0.1852615297159536,3145,1658,0.15900542423377034,607,0.8,0.3,6857,684,6173
911,2210,0,0.0,228,0,0.0,1982,0,0.0,608,0.8,0.5,47,2,45
5000,9459,179,0.12494826676542968,1018,10,0.1469345006631936,8441,169,0.12364730617976316,609,0.8,0.7,939,73,866
1058,2497,0,0.0,230,0,0.0,2267,0,0.0,610,0.8,0.9,37,2,35
5000,2553,3220,0.09999999999999995,264,300,0.10000000000000007,2289,2920,0.09999999999999994,611,0.0,0.1,7924,782,7142
5000,979,768,0.30000000000000043,110,89,0.30000000000000004,869,679,0.30000000000000027,612,0.0,0.3,9370,927,8443
2359,4979,0,0.0,525,0,0.0,4454,0,0.0,613,0.0,0.5,286,10,276
1574,3484,0,0.0,355,0,0.0,3129,0,0.0,614,0.0,0.7,161,8,153
1864,3873,0,0.0,376,0,0.0,3497,0,0.0,615,0.0,0.9,298,33,265
5000,2880,2100,0.13864390743192287,275,184,0.12633511115389826,2605,1916,0.1398259630243846,616,0.8,0.1,7722,737,6985
5000,9782,91,0.13814143614132762,1045,2,0.4254390880633112,8737,89,0.13168530913184484,617,0.8,0.3,620,18,602
5000,1782,1718,0.10726621788976663,136,176,0.1191318751589754,1646,1542,0.10591190162557683,618,0.8,0.5,8592,850,7742
5000,1970,1453,0.1246150715694559,196,133,0.11846752286379977,1774,1320,0.12523448367388948,619,0.8,0.7,8442,868,7574
5000,5096,1407,0.18641250250431282,524,124,0.2128586384677366,4572,1283,0.1838565236582766,620,0.8,0.9,5386,503,4883
5000,1872,2877,0.0999999999999999,179,287,0.10000000000000009,1693,2590,0.1,621,0.0,0.1,8496,842,7654
5000,862,698,0.3000000000000003,82,75,0.30000000000000004,780,623,0.3000000000000004,622,0.0,0.3,9606,940,8666
5000,8867,192,0.5,928,22,0.5,7939,170,0.5,623,0.0,0.5,1813,172,1641
1638,3590,0,0.0,326,0,0.0,3264,0,0.0,624,0.0,0.7,45,0,45
1659,3591,0,0.0,353,0,0.0,3238,0,0.0,625,0.0,0.9,177,19,158
5000,4663,2004,0.14898038067320374,403,233,0.14298454550874323,4260,1771,0.14976921725892886,626,0.8,0.1,5984,630,5354
5000,3713,1982,0.12711554015037455,389,203,0.10875928612509432,3324,1779,0.12921015485927384,627,0.8,0.3,7013,692,6321
5000,5369,1721,0.1972799429543455,521,172,0.20398334469532464,4848,1549,0.19653560137949175,628,0.8,0.5,5105,546,4559
5000,7946,795,0.18424927833786386,807,90,0.16454077693612412,7139,705,0.18676525724021367,629,0.8,0.7,2527,253,2274
738,1937,0,0.0,220,0,0.0,1717,0,0.0,630,0.8,0.9,15,0,15
5000,1461,2532,0.10000000000000007,128,248,0.10000000000000005,1333,2284,0.10000000000000007,631,0.0,0.1,9025,886,8139
5000,985,643,0.3000000000000002,102,60,0.30000000000000004,883,583,0.3000000000000002,632,0.0,0.3,9531,960,8571
5000,2596,572,0.5,288,51,0.5,2308,521,0.5,633,0.0,0.5,7923,723,7200
1024,2465,0,0.0,227,0,0.0,2238,0,0.0,634,0.0,0.7,78,6,72
1723,3786,0,0.0,366,0,0.0,3420,0,0.0,635,0.0,0.9,153,14,139
5000,3747,1970,0.13434424970776312,362,222,0.12194967353621117,3385,1748,0.1359183892444247,636,0.8,0.1,6750,720,6030
5000,9804,99,0.1585243664307999,946,2,0.18079506333660192,8858,97,0.1580651768038762,637,0.8,0.3,476,17,459
5000,6150,1277,0.177399821036124,649,110,0.1784185436162937,5501,1167,0.177303797485294,638,0.8,0.5,4335,391,3944
5000,10278,28,0.0864808726609159,1006,0,0.0,9272,28,0.0864808726609159,639,0.8,0.7,215,4,211
927,2213,0,0.0,218,0,0.0,1995,0,0.0,640,0.8,0.9,78,5,73
5000,1569,2703,0.10000000000000002,155,273,0.10000000000000009,1414,2430,0.10000000000000009,641,0.0,0.1,8881,859,8022
5000,888,736,0.3000000000000005,101,59,0.30000000000000004,787,677,0.30000000000000027,642,0.0,0.3,9653,945,8708
5000,10089,1,0.5,1037,0,0.0,9052,1,0.5,643,0.0,0.5,212,2,210
2784,5841,0,0.0,602,0,0.0,5239,0,0.0,644,0.0,0.7,235,26,209
588,1620,0,0.0,167,0,0.0,1453,0,0.0,645,0.0,0.9,34,4,30
5000,2367,1882,0.11635013211210683,230,200,0.10589941650852036,2137,1682,0.11759278557269978,646,0.8,0.1,8166,813,7353
5000,2452,1923,0.11209871776605354,252,199,0.10238523544997945,2200,1724,0.11321993759256095,647,0.8,0.3,8000,821,7179
5000,3261,1642,0.12241327463266534,372,158,0.12135600638168027,2889,1484,0.12252584092892928,648,0.8,0.5,7345,701,6644
5000,10257,103,0.15347933904680847,1003,13,0.17049012424584414,9254,90,0.15102222562917003,649,0.8,0.7,302,24,278
5000,2730,1880,0.133815600498835,270,179,0.10781713526520474,2460,1701,0.1365514766168949,650,0.8,0.9,7788,830,6958
5000,2516,3143,0.09999999999999995,249,314,0.10000000000000006,2267,2829,0.09999999999999999,651,0.0,0.1,7961,795,7166
5000,910,699,0.3000000000000003,95,76,0.30000000000000004,815,623,0.3000000000000004,652,0.0,0.3,9435,922,8513
5000,2164,405,0.5,242,37,0.5,1922,368,0.5,653,0.0,0.5,8276,793,7483
1715,3724,0,0.0,386,0,0.0,3338,0,0.0,654,0.0,0.7,223,21,202
1098,2522,0,0.0,249,0,0.0,2273,0,0.0,655,0.0,0.9,122,19,103
5000,3625,1861,0.15620424339223538,373,156,0.1734974544664018,3252,1705,0.15462199064879262,656,0.8,0.1,6756,635,6121
5000,2338,1487,0.12000042523119656,252,139,0.09787193391617803,2086,1348,0.12228222070062356,657,0.8,0.3,7961,755,7206
5000,7412,905,0.15599224405816667,736,71,0.13830148456909175,6676,834,0.1574982919283397,658,0.8,0.5,2912,239,2673
5000,7756,706,0.17994074280772512,849,68,0.2008136202673502,6907,638,0.1777160474045049,659,0.8,0.7,2858,264,2594
5000,9668,239,0.2072566044003715,969,29,0.2148451620634214,8699,210,0.20620866072309318,660,0.8,0.9,737,80,657
5000,2210,2988,0.09999999999999992,231,290,0.10000000000000002,1979,2698,0.10000000000000002,661,0.0,0.1,8226,789,7437
5000,997,698,0.3000000000000003,106,60,0.30000000000000004,891,638,0.3000000000000004,662,0.0,0.3,9487,865,8622
5000,8927,6,0.5,965,0,0.0,7962,6,0.5,663,0.0,0.5,1455,104,1351
1380,3167,0,0.0,321,0,0.0,2846,0,0.0,664,0.0,0.7,75,12,63
991,2417,0,0.0,267,0,0.0,2150,0,0.0,665,0.0,0.9,45,3,42
5000,3829,1661,0.16235792860930395,400,177,0.15034598243335123,3429,1484,0.1637906203027969,666,0.8,0.1,6526,685,5841
5000,2308,1915,0.10944561402918625,238,186,0.1129640063104335,2070,1729,0.10906711723085659,667,0.8,0.3,8282,766,7516
5000,3668,1523,0.1303164582751564,418,150,0.13971967660104198,3250,1373,0.12928915838521987,668,0.8,0.5,6594,632,5962
1557,3478,0,0.0,350,0,0.0,3128,0,0.0,669,0.8,0.7,74,1,73
5000,9890,264,0.20556322879179273,1017,25,0.20048734855904246,8873,239,0.20609417860693388,670,0.8,0.9,718,64,654
5000,1460,2783,0.09999999999999998,118,262,0.10000000000000003,1342,2521,0.10000000000000006,671,0.0,0.1,8878,872,8006
5000,911,711,0.3000000000000003,80,72,0.30000000000000004,831,639,0.3000000000000004,672,0.0,0.3,9450,941,8509
5000,4893,621,0.5,503,70,0.5,4390,551,0.5,673,0.0,0.5,5504,517,4987
2161,4747,0,0.0,470,0,0.0,4277,0,0.0,674,0.0,0.7,115,1,114
1193,2710,0,0.0,271,0,0.0,2439,0,0.0,675,0.0,0.9,219,20,199
5000,8364,701,0.17585704245630535,881,60,0.18726803010595322,7483,641,0.17478893128785158,676,0.8,0.1,2041,171,1870
5000,3289,1992,0.14033058075845345,312,221,0.14105426210063696,2977,1771,0.1402402738264249,677,0.8,0.3,7085,732,6353
5000,8599,421,0.21739858531237355,886,31,0.22677079806808498,7713,390,0.21665361455486828,678,0.8,0.5,1724,156,1568
5000,10558,20,0.21997186694552306,1105,3,0.28190831368984304,9453,17,0.20904190575534898,679,0.8,0.7,162,10,152
5000,4935,1774,0.17183391379548565,458,176,0.16169710995809886,4477,1598,0.1729503577725696,680,0.8,0.9,5738,572,5166
5000,1892,2675,0.09999999999999996,214,248,0.10000000000000005,1678,2427,0.10000000000000009,681,0.0,0.1,8450,787,7663
5000,816,637,0.3000000000000003,69,59,0.30000000000000004,747,578,0.3000000000000001,682,0.0,0.3,9720,973,8747
5000,1142,542,0.5,104,54,0.5,1038,488,0.5,683,0.0,0.5,9463,935,8528
1336,3114,0,0.0,300,0,0.0,2814,0,0.0,684,0.0,0.7,58,0,58
766,1992,0,0.0,194,0,0.0,1798,0,0.0,685,0.0,0.9,63,6,57
5000,3229,2019,0.12873063619830719,339,210,0.12557245684711307,2890,1809,0.12909725735018707,686,0.8,0.1,7247,717,6530
5000,2146,1774,0.12313892598526838,188,168,0.1265115194250008,1958,1606,0.12278612667152303,687,0.8,0.3,8223,822,7401
5000,2323,1942,0.12047855484296552,219,202,0.11407330366899658,2104,1740,0.12122215296775964,688,0.8,0.5,8203,836,7367
5000,3129,2004,0.12421757888617756,306,219,0.11101737035938848,2823,1785,0.12583710026845588,689,0.8,0.7,7565,795,6770
5000,3787,1745,0.1557672358024041,371,162,0.12609872185830773,3416,1583,0.15880343242839495,690,0.8,0.9,6584,637,5947
5000,1559,2500,0.10000000000000007,136,237,0.10000000000000007,1423,2263,0.10000000000000006,691,0.0,0.1,8674,862,7812
5000,1024,628,0.3000000000000002,124,66,0.29999999999999993,900,562,0.3000000000000001,692,0.0,0.3,9516,934,8582
5000,3524,344,0.5,391,49,0.5,3133,295,0.5,693,0.0,0.5,6924,632,6292
1820,4037,0,0.0,424,0,0.0,3613,0,0.0,694,0.0,0.7,196,13,183
976,2448,0,0.0,252,0,0.0,2196,0,0.0,695,0.0,0.9,43,3,40
5000,3184,1703,0.14667720715821736,320,175,0.14646267716743083,2864,1528,0.14670177701972759,696,0.8,0.1,7503,747,6756
5000,2893,2066,0.14371374648983887,254,225,0.1469549609446241,2639,1841,0.14331761761839582,697,0.8,0.3,7461,805,6656
5000,10371,12,0.14255159376611892,1049,0,0.0,9322,12,0.14255159376611892,698,0.8,0.5,147,3,144
5000,6189,1297,0.15408218989980138,633,118,0.14672042724515616,5556,1179,0.15481899057261578,699,0.8,0.7,4370,412,3958
5000,10541,3,0.05000000000000001,1016,0,0.0,9525,3,0.05000000000000001,700,0.8,0.9,50,3,47
5000,1569,2642,0.10000000000000002,164,253,0.10000000000000007,1405,2389,0.10000000000000006,701,0.0,0.1,8754,857,7897
5000,852,746,0.3000000000000004,83,80,0.3000000000000001,769,666,0.3000000000000004,702,0.0,0.3,9697,1009,8688
5000,1695,547,0.5,192,66,0.5,1503,481,0.5,703,0.0,0.5,8902,899,8003
976,2389,0,0.0,250,0,0.0,2139,0,0.0,704,0.0,0.7,34,2,32
2024,4144,0,0.0,443,0,0.0,3701,0,0.0,705,0.0,0.9,353,26,327
5000,3633,1943,0.1527607627734874,384,216,0.17043799571915438,3249,1727,0.15054982917981977,706,0.8,0.1,6930,703,6227
5000,10019,52,0.09371931350242638,1043,3,0.07778467247299635,8976,49,0.09469490376953432,707,0.8,0.3,270,5,265
5000,4349,1696,0.17276040714898858,400,173,0.17627495590102332,3949,1523,0.17236118394865893,708,0.8,0.5,6173,641,5532
977,2315,0,0.0,230,0,0.0,2085,0,0.0,709,0.8,0.7,66,1,65
5000,9853,234,0.23441493653418252,899,27,0.2214601987549486,8954,207,0.2361046849401695,710,0.8,0.9,549,62,487
5000,1644,2826,0.1,152,279,0.10000000000000005,1492,2547,0.10000000000000009,711,0.0,0.1,8788,843,7945
5000,916,729,0.3000000000000004,105,86,0.30000000000000004,811,643,0.3000000000000002,712,0.0,0.3,9559,992,8567
5000,2047,628,0.5,201,59,0.5,1846,569,0.5,713,0.0,0.5,8445,879,7566
1356,3006,0,0.0,317,0,0.0,2689,0,0.0,714,0.0,0.7,108,6,102
540,1496,0,0.0,149,0,0.0,1347,0,0.0,715,0.0,0.9,37,4,33
5000,2442,1859,0.10650237711935766,255,180,0.1176856641679412,2187,1679,0.10530345414809796,716,0.8,0.1,8073,761,7312
5000,2353,1986,0.11489991568979922,233,182,0.1266808418749403,2120,1804,0.11371137435626506,717,0.8,0.3,7996,768,7228
5000,5615,1394,0.17168349554589693,623,126,0.13248254328570638,4992,1268,0.17557885830992215,718,0.8,0.5,4711,418,4293
5000,5795,1709,0.18139126725004762,551,189,0.16237884666515603,5244,1520,0.1837553116517216,719,0.8,0.7,4578,514,4064
5000,9700,113,0.10690145324700942,1028,10,0.08666660130882722,8672,103,0.10886600197887174,720,0.8,0.9,553,35,518
5000,3356,3139,0.09999999999999988,350,340,0.10000000000000005,3006,2799,0.09999999999999995,721,0.0,0.1,7031,749,6282
5000,999,719,0.30000000000000043,106,82,0.30000000000000004,893,637,0.3000000000000003,722,0.0,0.3,9386,918,8468
5000,2912,869,0.5,279,100,0.5,2633,769,0.5,723,0.0,0.5,7503,764,6739
2293,4522,0,0.0,449,0,0.0,4073,0,0.0,724,0.0,0.7,555,49,506
1062,2432,0,0.0,229,0,0.0,2203,0,0.0,725,0.0,0.9,141,15,126
5000,5806,1211,0.21401024713996253,600,117,0.21826165408080309,5206,1094,0.21355557199181044,726,0.8,0.1,4690,445,4245
5000,4616,1826,0.1752878217361663,485,214,0.19056491308092394,4131,1612,0.17325972152042304,727,0.8,0.3,5887,625,5262
5000,3921,1822,0.15073932503758022,390,197,0.1548001072385728,3531,1625,0.15024703328767525,728,0.8,0.5,6825,694,6131
5000,10266,30,0.15770923278904536,967,0,0.0,9299,30,0.15770923278904536,729,0.8,0.7,122,2,120
949,2219,0,0.0,212,0,0.0,2007,0,0.0,730,0.8,0.9,67,6,61
5000,1438,2402,0.10000000000000006,125,222,0.10000000000000007,1313,2180,0.10000000000000009,731,0.0,0.1,9160,893,8267
5000,1044,608,0.30000000000000043,110,61,0.30000000000000004,934,547,0.3000000000000001,732,0.0,0.3,9366,915,8451
3669,7096,0,0.0,746,0,0.0,6350,0,0.0,733,0.0,0.5,642,34,608
3354,6056,0,0.0,584,0,0.0,5472,0,0.0,734,0.0,0.7,1160,107,1053
906,2201,0,0.0,233,0,0.0,1968,0,0.0,735,0.0,0.9,57,3,54
5000,2273,1845,0.11618923806707143,212,164,0.11670769005723902,2061,1681,0.11613865738510387,736,0.8,0.1,8122,818,7304
5000,4357,1725,0.14041487762979094,484,153,0.12325154548178784,3873,1572,0.14208535461366148,737,0.8,0.3,5990,533,5457
5000,3006,1658,0.14095051622620577,316,157,0.1453106466464338,2690,1501,0.1404944599464085,738,0.8,0.5,7437,706,6731
1603,3508,0,0.0,351,0,0.0,3157,0,0.0,739,0.8,0.7,64,9,55
829,2064,0,0.0,214,0,0.0,1850,0,0.0,740,0.8,0.9,46,2,44
5000,1699,2594,0.09999999999999999,190,278,0.10000000000000005,1509,2316,0.10000000000000005,741,0.0,0.1,8750,849,7901
5000,945,614,0.3000000000000002,93,55,0.3,852,559,0.3000000000000003,742,0.0,0.3,9411,915,8496
5000,2732,700,0.5,278,70,0.5,2454,630,0.5,743,0.0,0.5,7772,748,7024
1389,3176,0,0.0,315,0,0.0,2861,0,0.0,744,0.0,0.7,81,2,79
853,2263,0,0.0,215,0,0.0,2048,0,0.0,745,0.0,0.9,24,0,24
5000,4474,1711,0.17960192594488178,430,173,0.20850857479316523,4044,1538,0.17635039782345588,746,0.8,0.1,6083,633,5450
5000,2308,1689,0.11840631294755699,212,152,0.10752895450449447,2096,1537,0.11948201788141873,747,0.8,0.3,8161,770,7391
5000,4650,1522,0.21176698472545716,424,160,0.22812848510438682,4226,1362,0.20984492888064898,748,0.8,0.5,5914,640,5274
5000,9627,196,0.0925875732635796,983,2,0.05,8644,194,0.0930266204106268,749,0.8,0.7,810,32,778
1784,4071,0,0.0,425,0,0.0,3646,0,0.0,750,0.8,0.9,59,3,56
5000,1587,2810,0.09999999999999992,146,311,0.10000000000000005,1441,2499,0.10000000000000009,751,0.0,0.1,8763,873,7890
5000,912,606,0.3000000000000004,86,62,0.3000000000000001,826,544,0.3000000000000003,752,0.0,0.3,9661,961,8700
4163,8627,0,0.0,879,0,0.0,7748,0,0.0,753,0.0,0.5,189,9,180
1120,2660,0,0.0,257,0,0.0,2403,0,0.0,754,0.0,0.7,60,1,59
3228,6319,0,0.0,598,0,0.0,5721,0,0.0,755,0.0,0.9,775,90,685
5000,9254,504,0.1881353778989748,954,55,0.1994704252343787,8300,449,0.18674689771312353,756,0.8,0.1,1410,127,1283
5000,6739,1035,0.19631848471421473,668,94,0.2213349052571845,6071,941,0.19381950115306804,757,0.8,0.3,3686,357,3329
5000,2969,1697,0.1441111242190832,309,170,0.15412324538185115,2660,1527,0.14299648073665322,758,0.8,0.5,7364,757,6607
2022,4336,0,0.0,460,0,0.0,3876,0,0.0,759,0.8,0.7,98,5,93
1132,2757,0,0.0,310,0,0.0,2447,0,0.0,760,0.8,0.9,39,3,36
5000,1544,2747,0.09999999999999994,105,268,0.10000000000000007,1439,2479,0.10000000000000007,761,0.0,0.1,8994,903,8091
5000,849,695,0.30000000000000027,70,61,0.30000000000000004,779,634,0.3000000000000003,762,0.0,0.3,9640,966,8674
1694,3843,0,0.0,386,0,0.0,3457,0,0.0,763,0.0,0.5,56,0,56
1884,4131,0,0.0,395,0,0.0,3736,0,0.0,764,0.0,0.7,202,19,183
605,1620,0,0.0,154,0,0.0,1466,0,0.0,765,0.0,0.9,64,7,57
5000,4241,2012,0.12780708665908597,427,202,0.1360789346440037,3814,1810,0.12688393014364205,766,0.8,0.1,6178,577,5601
5000,3702,1770,0.1665391497851951,383,180,0.1866701981254732,3319,1590,0.16426016318063535,767,0.8,0.3,6710,611,6099
5000,6950,1266,0.15256017888344983,712,160,0.12839793679828154,6238,1106,0.15605562077642174,768,0.8,0.5,3536,384,3152
5000,6867,923,0.1671424561413107,709,94,0.16005636581249544,6158,829,0.1679459452738905,769,0.8,0.7,3530,312,3218
5000,10364,4,0.027439355968692646,1021,0,0.0,9343,4,0.027439355968692646,770,0.8,0.9,131,17,114
5000,1466,2578,0.10000000000000003,146,252,0.10000000000000006,1320,2326,0.10000000000000006,771,0.0,0.1,9085,876,8209
5000,988,685,0.3000000000000004,97,70,0.3,891,615,0.3000000000000002,772,0.0,0.3,9365,976,8389
5000,2229,437,0.5,237,49,0.5,1992,388,0.5,773,0.0,0.5,8281,824,7457
675,1848,0,0.0,194,0,0.0,1654,0,0.0,774,0.0,0.7,28,2,26
2721,5429,0,0.0,510,0,0.0,4919,0,0.0,775,0.0,0.9,480,53,427
5000,2930,1891,0.14963485472700036,272,206,0.15327912846980116,2658,1685,0.14918932333767274,776,0.8,0.1,7419,778,6641
5000,3286,1976,0.12875134921342873,320,216,0.1196999750020055,2966,1760,0.12986219968483062,777,0.8,0.3,7190,698,6492
5000,4440,1762,0.17283141289505405,401,196,0.16102415531168637,4039,1566,0.17430920503192504,778,0.8,0.5,6037,621,5416
5000,2173,1639,0.11577625786491712,228,146,0.125934521557767,1945,1493,0.11478288445623923,779,0.8,0.7,8398,803,7595
761,1925,0,0.0,189,0,0.0,1736,0,0.0,780,0.8,0.9,77,10,67
5000,6989,1777,0.0999999999999999,722,180,0.1,6267,1597,0.09999999999999988,781,0.0,0.1,3476,326,3150
5000,2805,1855,0.3000000000000005,287,207,0.29999999999999977,2518,1648,0.3000000000000004,782,0.0,0.3,7720,786,6934
5000,1715,608,0.5,180,57,0.5,1535,551,0.5,783,0.0,0.5,8746,876,7870
3941,7291,0,0.0,715,0,0.0,6576,0,0.0,784,0.0,0.7,1162,108,1054
1505,3257,0,0.0,328,0,0.0,2929,0,0.0,785,0.0,0.9,204,26,178
5000,2278,1941,0.10419912260661812,241,200,0.10284425962097563,2037,1741,0.10435476453489416,786,0.8,0.1,8278,850,7428
5000,3601,1829,0.15804856944912535,370,192,0.19273987962745762,3231,1637,0.1539797047244828,787,0.8,0.3,6963,671,6292
5000,10105,68,0.18299123875710196,1011,0,0.0,9094,68,0.18299123875710196,788,0.8,0.5,342,7,335
5000,3864,1851,0.16707745785205505,402,182,0.18093864937618,3462,1669,0.16556593187398985,789,0.8,0.7,6538,654,5884
5000,10400,1,0.05,1042,0,0.0,9358,1,0.05,790,0.8,0.9,146,21,125
5000,1603,2704,0.10000000000000002,180,277,0.10000000000000003,1423,2427,0.10000000000000009,791,0.0,0.1,8816,912,7904
5000,906,636,0.3000000000000003,77,64,0.3000000000000001,829,572,0.30000000000000027,792,0.0,0.3,9549,971,8578
5000,2689,673,0.5,310,66,0.5,2379,607,0.5,793,0.0,0.5,7697,767,6930
2352,4920,0,0.0,513,0,0.0,4407,0,0.0,794,0.0,0.7,188,20,168
1985,3934,0,0.0,361,0,0.0,3573,0,0.0,795,0.0,0.9,439,61,378
5000,6851,1177,0.18228250955322675,720,112,0.20532413976714328,6131,1065,0.17985935219739702,796,0.8,0.1,3720,329,3391
5000,2634,1997,0.12513008401544579,225,218,0.14816783087294025,2409,1779,0.12230702116275677,797,0.8,0.3,7762,800,6962
5000,3871,1971,0.17927382602076866,300,197,0.17652040727434626,3571,1774,0.17957958898189894,798,0.8,0.5,6535,657,5878
5000,10316,5,0.09045691349478177,1052,0,0.0,9264,5,0.09045691349478177,799,0.8,0.7,150,6,144
1088,2602,0,0.0,244,0,0.0,2358,0,0.0,800,0.8,0.9,45,0,45
5000,3026,3148,0.09999999999999996,300,323,0.10000000000000002,2726,2825,0.1,801,0.0,0.1,7295,727,6568
5000,984,666,0.3000000000000004,79,59,0.30000000000000004,905,607,0.30000000000000043,802,0.0,0.3,9610,937,8673
5000,1342,545,0.5,115,62,0.5,1227,483,0.5,803,0.0,0.5,9034,921,8113
1831,3848,0,0.0,383,0,0.0,3465,0,0.0,804,0.0,0.7,292,32,260
1563,3430,0,0.0,320,0,0.0,3110,0,0.0,805,0.0,0.9,142,14,128
5000,9689,309,0.1529453235099591,946,19,0.12160460552926383,8743,290,0.1549986808949012,806,0.8,0.1,846,61,785
5000,3216,1916,0.14123376233126086,323,191,0.14836382029362735,2893,1725,0.14044428924673208,807,0.8,0.3,7389,724,6665
5000,2592,1663,0.10329713893064232,293,180,0.09109568650724831,2299,1483,0.10477809741763552,808,0.8,0.5,8018,790,7228
2863,6094,0,0.0,637,0,0.0,5457,0,0.0,809,0.8,0.7,95,5,90
408,1292,0,0.0,137,0,0.0,1155,0,0.0,810,0.8,0.9,22,3,19
5000,2311,2861,0.09999999999999992,275,291,0.10000000000000003,2036,2570,0.10000000000000005,811,0.0,0.1,8219,805,7414
5000,1024,589,0.3000000000000003,98,50,0.3,926,539,0.30000000000000027,812,0.0,0.3,9479,976,8503
5000,1596,562,0.5,150,39,0.5,1446,523,0.5,813,0.0,0.5,8826,852,7974
1138,2633,0,0.0,255,0,0.0,2378,0,0.0,814,0.0,0.7,95,4,91
716,1827,0,0.0,180,0,0.0,1647,0,0.0,815,0.0,0.9,21,0,21
5000,2137,1793,0.10784082436012703,221,187,0.12199439286150336,1916,1606,0.1061928061099668,816,0.8,0.1,8386,861,7525
5000,2468,2050,0.13979250770961127,228,192,0.12616315278964668,2240,1858,0.14120092328799308,817,0.8,0.3,7895,825,7070
5000,7185,947,0.1914289798157726,796,86,0.25857786104216524,6389,861,0.18472189063404232,818,0.8,0.5,3445,290,3155
1283,3124,0,0.0,321,0,0.0,2803,0,0.0,819,0.8,0.7,34,1,33
1023,2523,0,0.0,250,0,0.0,2273,0,0.0,820,0.8,0.9,88,9,79
5000,4699,2863,0.09999999999999995,493,272,0.10000000000000009,4206,2591,0.1,821,0.0,0.1,5869,572,5297
5000,810,860,0.3000000000000005,75,84,0.30000000000000004,735,776,0.3000000000000003,822,0.0,0.3,9646,1001,8645
5000,1278,559,0.5,132,55,0.5,1146,504,0.5,823,0.0,0.5,9159,901,8258
4719,9054,0,0.0,935,0,0.0,8119,0,0.0,824,0.0,0.7,863,87,776
814,1991,0,0.0,188,0,0.0,1803,0,0.0,825,0.0,0.9,31,0,31
5000,4917,1889,0.17868616490927747,454,191,0.17793793300879132,4463,1698,0.17877032998171136,826,0.8,0.1,5572,595,4977
5000,2246,1830,0.12250978201403988,178,173,0.11034747972200983,2068,1657,0.12377959390089635,827,0.8,0.3,8212,796,7416
5000,8082,650,0.15521099993477921,830,46,0.1326556965489671,7252,604,0.15692878794098344,828,0.8,0.5,2437,180,2257
5000,7848,700,0.16369515114132888,808,59,0.1375477393705401,7040,641,0.16610185518887413,829,0.8,0.7,2577,214,2363
430,1338,0,0.0,135,0,0.0,1203,0,0.0,830,0.8,0.9,26,0,26
5000,1360,2520,0.10000000000000006,124,257,0.10000000000000009,1236,2263,0.10000000000000006,831,0.0,0.1,8978,897,8081
5000,846,595,0.3000000000000002,70,61,0.30000000000000004,776,534,0.30000000000000016,832,0.0,0.3,9509,959,8550
5000,9055,48,0.5,921,0,0.0,8134,48,0.5,833,0.0,0.5,1266,100,1166
4539,9008,0,0.0,919,0,0.0,8089,0,0.0,834,0.0,0.7,444,41,403
567,1589,0,0.0,170,0,0.0,1419,0,0.0,835,0.0,0.9,37,3,34
5000,3222,1908,0.11768008365012277,339,191,0.10259128776504624,2883,1717,0.11935856938923146,836,0.8,0.1,7281,695,6586
5000,3943,1869,0.12703187407209854,425,198,0.11771002942070853,3518,1671,0.12813643735215552,837,0.8,0.3,6540,622,5918
5000,2034,1277,0.11776447745552855,216,97,0.09807379333761203,1818,1180,0.11938311843810302,838,0.8,0.5,8294,823,7471
5000,10535,2,0.033642311021681505,1010,0,0.0,9525,2,0.033642311021681505,839,0.8,0.7,98,5,93
5000,5507,1669,0.17276923234270242,579,179,0.17588157902950144,4928,1490,0.17239533297563062,840,0.8,0.9,5030,563,4467
5000,1580,2642,0.10000000000000002,179,241,0.10000000000000009,1401,2401,0.10000000000000007,841,0.0,0.1,8948,855,8093
5000,907,699,0.3000000000000003,94,69,0.3,813,630,0.3000000000000002,842,0.0,0.3,9558,949,8609
3162,6509,0,0.0,663,0,0.0,5846,0,0.0,843,0.0,0.5,120,7,113
1299,2714,0,0.0,290,0,0.0,2424,0,0.0,844,0.0,0.7,349,27,322
566,1575,0,0.0,154,0,0.0,1421,0,0.0,845,0.0,0.9,61,7,54
5000,4675,1764,0.13356008203472103,488,194,0.13180701030163886,4187,1570,0.13377670363740762,846,0.8,0.1,5880,591,5289
5000,5812,1380,0.16796239232879934,609,136,0.1797451266611455,5203,1244,0.166674247739411,847,0.8,0.3,4617,440,4177
5000,2314,1633,0.1441011967388326,232,140,0.1697350351497881,2082,1493,0.14169748784564185,848,0.8,0.5,8133,770,7363
747,1940,0,0.0,191,0,0.0,1749,0,0.0,849,0.8,0.7,26,4,22
5000,10331,17,0.1675274299914012,994,0,0.0,9337,17,0.1675274299914012,850,0.8,0.9,88,1,87
5000,2388,2866,0.09999999999999992,242,277,0.10000000000000003,2146,2589,0.09999999999999999,851,0.0,0.1,8038,758,7280
5000,947,1048,0.30000000000000027,100,120,0.2999999999999999,847,928,0.3000000000000005,852,0.0,0.3,9392,948,8444
5000,1592,488,0.5,158,57,0.5,1434,431,0.5,853,0.0,0.5,8999,937,8062
1552,3414,0,0.0,387,0,0.0,3027,0,0.0,854,0.0,0.7,137,10,127
857,2124,0,0.0,218,0,0.0,1906,0,0.0,855,0.0,0.9,75,4,71
5000,3000,2173,0.1340188019859938,272,228,0.12273182755134836,2728,1945,0.13534190233103205,856,0.8,0.1,7489,762,6727
5000,4521,1592,0.14272637254599072,491,136,0.15145778093675932,4030,1456,0.14191080143256726,857,0.8,0.3,5933,543,5390
5000,2402,1587,0.11366394071133791,227,164,0.1323211705958898,2175,1423,0.11151370480053925,858,0.8,0.5,8052,797,7255
5000,7984,659,0.2294548319068,896,50,0.2174331629219671,7088,609,0.230441832644471,859,0.8,0.7,2457,211,2246
5000,10392,6,0.04422273489733386,1054,0,0.0,9338,6,0.04422273489733386,860,0.8,0.9,185,14,171
5000,2211,3088,0.09999999999999996,213,307,0.10000000000000003,1998,2781,0.09999999999999996,861,0.0,0.1,8488,843,7645
5000,991,992,0.3000000000000005,105,124,0.29999999999999977,886,868,0.3000000000000004,862,0.0,0.3,9612,974,8638
5000,1420,408,0.5,139,48,0.5,1281,360,0.5,863,0.0,0.5,9035,912,8123
3539,7018,0,0.0,665,0,0.0,6353,0,0.0,864,0.0,0.7,557,40,517
1929,4092,0,0.0,404,0,0.0,3688,0,0.0,865,0.0,0.9,281,24,257
5000,2521,2004,0.1131861307394949,238,202,0.12433644689318941,2283,1802,0.11193620628719399,866,0.8,0.1,8069,823,7246
5000,3241,1988,0.1340249013956979,339,190,0.13751710911864085,2902,1798,0.13365586943387409,867,0.8,0.3,7163,717,6446
5000,9866,196,0.13902557399770588,993,16,0.14535327357018615,8873,180,0.13846311181348542,868,0.8,0.5,718,51,667
1644,3629,0,0.0,349,0,0.0,3280,0,0.0,869,0.8,0.7,70,3,67
5000,5816,1268,0.2000422862155848,566,142,0.20299003883835973,5250,1126,0.199670544765821,870,0.8,0.9,4770,508,4262
5000,1964,2740,0.09999999999999994,228,300,0.10000000000000007,1736,2440,0.10000000000000005,871,0.0,0.1,8494,865,7629
5000,1024,1163,0.30000000000000016,92,119,0.2999999999999999,932,1044,0.3000000000000002,872,0.0,0.3,9290,929,8361
5000,5724,447,0.5,616,37,0.5,5108,410,0.5,873,0.0,0.5,4886,434,4452
1289,2861,0,0.0,283,0,0.0,2578,0,0.0,874,0.0,0.7,107,6,101
1907,4058,0,0.0,392,0,0.0,3666,0,0.0,875,0.0,0.9,238,26,212
5000,2289,1857,0.11837918567205123,232,190,0.11265092073204483,2057,1667,0.119032077296887,876,0.8,0.1,8154,844,7310
5000,1976,1624,0.1344715263891313,153,155,0.15103290436207237,1823,1469,0.1327240698977726,877,0.8,0.3,8453,897,7556
5000,10286,5,0.07027760235973114,1019,0,0.0,9267,5,0.07027760235973114,878,0.8,0.5,98,3,95
5000,10330,9,0.14628564433927121,1018,0,0.0,9312,9,0.14628564433927121,879,0.8,0.7,94,9,85
5000,4899,1856,0.1534655688060668,514,168,0.16328652954310918,4385,1688,0.15248812721612412,880,0.8,0.9,5622,543,5079
5000,1742,2774,0.09999999999999999,180,283,0.10000000000000006,1562,2491,0.10000000000000007,881,0.0,0.1,8795,868,7927
5000,880,705,0.30000000000000043,76,61,0.30000000000000004,804,644,0.3000000000000002,882,0.0,0.3,9591,966,8625
3874,8175,0,0.0,829,0,0.0,7346,0,0.0,883,0.0,0.5,200,13,187
3573,6805,0,0.0,716,0,0.0,6089,0,0.0,884,0.0,0.7,785,84,701
337,1092,0,0.0,100,0,0.0,992,0,0.0,885,0.0,0.9,6,1,5
5000,3128,2017,0.12975291527650576,350,178,0.13508553105316767,2778,1839,0.12923676214532248,886,0.8,0.1,7417,693,6724
5000,10304,1,0.027770894755467956,1068,0,0.0,9236,1,0.027770894755467956,887,0.8,0.3,128,1,127
5000,2281,1794,0.14170595185114945,210,195,0.13615184185130472,2071,1599,0.1423832823389354,888,0.8,0.5,8165,835,7330
5000,10418,14,0.06516704840356465,1067,0,0.0,9351,14,0.06516704840356465,889,0.8,0.7,248,12,236
5000,4115,1523,0.1369292205485772,460,140,0.11189570946439854,3655,1383,0.13946334314567413,890,0.8,0.9,6398,602,5796
5000,3172,3208,0.09999999999999996,300,322,0.1,2872,2886,0.09999999999999995,891,0.0,0.1,7201,715,6486
5000,1114,666,0.3000000000000004,105,74,0.30000000000000004,1009,592,0.3000000000000004,892,0.0,0.3,9450,947,8503
3275,6811,0,0.0,707,0,0.0,6104,0,0.0,893,0.0,0.5,135,8,127
1472,3458,0,0.0,371,0,0.0,3087,0,0.0,894,0.0,0.7,58,2,56
907,2132,0,0.0,220,0,0.0,1912,0,0.0,895,0.0,0.9,45,3,42
5000,2286,1770,0.11624170714445986,228,160,0.11572032259788098,2058,1610,0.11629352175778447,896,0.8,0.1,8081,811,7270
5000,10040,67,0.1674603944647552,1018,0,0.0,9022,67,0.1674603944647552,897,0.8,0.3,351,3,348
5000,8606,411,0.16973864545724382,909,29,0.15469167836733566,7697,382,0.1708809544771583,898,0.8,0.5,1800,106,1694
5000,10166,6,0.04456213409329904,993,0,0.0,9173,6,0.04456213409329904,899,0.8,0.7,237,16,221
534,1481,0,0.0,166,0,0.0,1315,0,0.0,900,0.8,0.9,27,0,27
5000,2106,3139,0.09999999999999988,194,299,0.10000000000000006,1912,2840,0.09999999999999998,901,0.0,0.1,8522,822,7700
5000,946,662,0.30000000000000027,94,80,0.3000000000000001,852,582,0.3000000000000002,902,0.0,0.3,9547,983,8564
5000,10061,22,0.5,1007,0,0.0,9054,22,0.5,903,0.0,0.5,535,31,504
1852,3894,0,0.0,350,0,0.0,3544,0,0.0,904,0.0,0.7,245,17,228
1390,3196,0,0.0,308,0,0.0,2888,0,0.0,905,0.0,0.9,61,2,59
5000,4570,1712,0.127329032342853,500,158,0.13008386872523398,4070,1554,0.1270489395832544,906,0.8,0.1,5908,533,5375
5000,2871,2004,0.11996351368748227,258,203,0.11802167854627754,2613,1801,0.1201823879427097,907,0.8,0.3,7601,791,6810
5000,2343,1877,0.12418254010826042,224,192,0.12984924227458086,2119,1685,0.12353683873381915,908,0.8,0.5,8233,849,7384
5000,3311,1885,0.14817916067595704,288,188,0.14390382574568084,3023,1697,0.14865279825220437,909,0.8,0.7,7045,690,6355
5000,10362,3,0.034917514939876805,1046,0,0.0,9316,3,0.034917514939876805,910,0.8,0.9,110,2,108
5000,4012,2837,0.09999999999999998,418,317,0.10000000000000007,3594,2520,0.10000000000000006,911,0.0,0.1,6217,658,5559
5000,844,769,0.3000000000000005,76,82,0.30000000000000004,768,687,0.30000000000000043,912,0.0,0.3,9484,933,8551
5000,1888,453,0.5,226,40,0.5,1662,413,0.5,913,0.0,0.5,8555,822,7733
5000,8069,43,0.6999999999999997,793,0,0.0,7276,43,0.6999999999999997,914,0.0,0.7,2411,233,2178
1572,3403,0,0.0,354,0,0.0,3049,0,0.0,915,0.0,0.9,260,32,228
5000,2338,1896,0.11412426276828057,220,194,0.1063324892008188,2118,1702,0.1150123967706822,916,0.8,0.1,8064,835,7229
5000,2400,1977,0.13327957844458993,234,189,0.13697355754575,2166,1788,0.13288910749933303,917,0.8,0.3,8046,826,7220
5000,2629,1927,0.13171383843300194,233,190,0.13036136517600008,2396,1737,0.13186177736151686,918,0.8,0.5,7981,813,7168
5000,1840,1765,0.12005551172276112,175,151,0.11668352406063567,1665,1614,0.12037098268743332,919,0.8,0.7,8736,884,7852
677,1732,0,0.0,164,0,0.0,1568,0,0.0,920,0.8,0.9,51,2,49
5000,1782,2938,0.09999999999999991,168,310,0.10000000000000005,1614,2628,0.09999999999999992,921,0.0,0.1,8708,893,7815
5000,996,676,0.3000000000000002,99,68,0.3,897,608,0.30000000000000043,922,0.0,0.3,9493,938,8555
5000,1535,566,0.5,147,45,0.5,1388,521,0.5,923,0.0,0.5,8905,897,8008
5000,6743,100,0.7,674,6,0.7000000000000001,6069,94,0.7000000000000003,924,0.0,0.7,3709,364,3345
847,2119,0,0.0,192,0,0.0,1927,0,0.0,925,0.0,0.9,59,3,56
5000,2550,2199,0.11691374482775352,251,218,0.11724201162665071,2299,1981,0.11687762056618886,926,0.8,0.1,7962,834,7128
5000,3738,1778,0.15438777917445837,390,156,0.13645458275707326,3348,1622,0.15611255022323275,927,0.8,0.3,6681,648,6033
5000,6045,1230,0.16631993720718902,683,131,0.15881949410088717,5362,1099,0.16721398456562897,928,0.8,0.5,4419,434,3985
5000,10250,11,0.051710221857428657,1009,0,0.0,9241,11,0.051710221857428657,929,0.8,0.7,115,12,103
1412,3100,0,0.0,336,0,0.0,2764,0,0.0,930,0.8,0.9,100,7,93
5000,1686,2576,0.10000000000000003,171,247,0.10000000000000005,1515,2329,0.10000000000000005,931,0.0,0.1,8803,849,7954
5000,985,785,0.3000000000000005,93,77,0.30000000000000004,892,708,0.30000000000000027,932,0.0,0.3,9351,922,8429
3968,8041,0,0.0,856,0,0.0,7185,0,0.0,933,0.0,0.5,415,27,388
1237,2901,0,0.0,300,0,0.0,2601,0,0.0,934,0.0,0.7,103,8,95
1197,2661,0,0.0,258,0,0.0,2403,0,0.0,935,0.0,0.9,238,39,199
5000,4675,1792,0.15364970860603291,494,182,0.13059588226311147,4181,1610,0.15625579332305872,936,0.8,0.1,5925,574,5351
5000,4555,1624,0.18107442628207482,472,148,0.21601204001308694,4083,1476,0.17757119672097058,937,0.8,0.3,5962,559,5403
5000,2756,1791,0.11532136630091583,274,170,0.11273172350496122,2482,1621,0.11559295129493945,938,0.8,0.5,7643,746,6897
5000,10371,3,0.06165975381986729,1062,0,0.0,9309,3,0.06165975381986729,939,0.8,0.7,154,14,140
625,1679,0,0.0,173,0,0.0,1506,0,0.0,940,0.8,0.9,43,2,41
5000,1614,2793,0.09999999999999994,146,257,0.10000000000000009,1468,2536,0.10000000000000007,941,0.0,0.1,8762,868,7894
5000,931,648,0.30000000000000027,97,65,0.3000000000000001,834,583,0.3000000000000002,942,0.0,0.3,9522,963,8559
1195,2778,0,0.0,313,0,0.0,2465,0,0.0,943,0.0,0.5,47,0,47
1222,2724,0,0.0,285,0,0.0,2439,0,0.0,944,0.0,0.7,170,17,153
1327,2952,0,0.0,301,0,0.0,2651,0,0.0,945,0.0,0.9,230,25,205
5000,2523,1842,0.10757472132457278,263,215,0.09811563101256525,2260,1627,0.10882469330802802,946,0.8,0.1,8131,847,7284
5000,8548,572,0.13533786540111667,921,53,0.12820681857872768,7627,519,0.13606608405542617,947,0.8,0.3,1895,149,1746
5000,3921,1716,0.15368792136802192,411,165,0.15369811343931242,3510,1551,0.1536868371051186,948,0.8,0.5,6419,640,5779
5000,10321,3,0.040053252902085064,992,0,0.0,9329,3,0.040053252902085064,949,0.8,0.7,118,11,107
5000,10385,6,0.07103894410838081,1021,0,0.0,9364,6,0.07103894410838081,950,0.8,0.9,43,2,41
5000,1544,2842,0.09999999999999998,136,300,0.10000000000000007,1408,2542,0.10000000000000009,951,0.0,0.1,8826,880,7946
5000,968,606,0.3000000000000004,103,60,0.30000000000000004,865,546,0.3000000000000001,952,0.0,0.3,9487,893,8594
5000,3013,606,0.5,302,60,0.5,2711,546,0.5,953,0.0,0.5,7519,760,6759
1353,2992,0,0.0,316,0,0.0,2676,0,0.0,954,0.0,0.7,176,10,166
867,2139,0,0.0,211,0,0.0,1928,0,0.0,955,0.0,0.9,108,14,94
5000,2523,2071,0.10872899470664234,245,209,0.11762985999613884,2278,1862,0.10772991799047436,956,0.8,0.1,8022,772,7250
5000,1860,1518,0.11168271292494998,182,149,0.1188752512460297,1678,1369,0.11089988735165496,957,0.8,0.3,8437,869,7568
5000,5735,1123,0.15576270403740997,613,100,0.17220098721508134,5122,1023,0.15415583373656244,958,0.8,0.5,4665,411,4254
5000,10327,15,0.08454991275139682,1024,0,0.0,9303,15,0.08454991275139682,959,0.8,0.7,136,3,133
5000,10131,128,0.12908009030495182,1068,9,0.06535796050757647,9063,119,0.13389941104592978,960,0.8,0.9,436,40,396
5000,1840,2929,0.09999999999999991,167,268,0.10000000000000007,1673,2661,0.09999999999999996,961,0.0,0.1,8734,857,7877
5000,1002,1277,0.3000000000000004,80,109,0.29999999999999993,922,1168,0.3000000000000002,962,0.0,0.3,9598,937,8661
5000,6136,437,0.5,668,37,0.5,5468,400,0.5,963,0.0,0.5,4340,405,3935
758,1904,0,0.0,183,0,0.0,1721,0,0.0,964,0.0,0.7,47,4,43
1524,3506,0,0.0,354,0,0.0,3152,0,0.0,965,0.0,0.9,39,2,37
5000,2895,2042,0.12513155040657448,257,199,0.12396609547324007,2638,1843,0.12525739171516564,966,0.8,0.1,7662,808,6854
5000,3764,1567,0.15086569713281475,360,138,0.15382614021131005,3404,1429,0.15057980409934218,967,0.8,0.3,6829,651,6178
5000,10008,32,0.12722995588004193,1032,0,0.0,8976,32,0.12722995588004193,968,0.8,0.5,329,10,319
5000,10133,119,0.13830327864524677,1011,10,0.09311421375567433,9122,109,0.14244906441493235,969,0.8,0.7,389,32,357
5000,2532,1844,0.12753891739675377,258,203,0.12777014019472974,2274,1641,0.12751031396714435,970,0.8,0.9,7861,827,7034
5000,2262,3017,0.09999999999999998,242,299,0.10000000000000006,2020,2718,0.09999999999999998,971,0.0,0.1,8275,808,7467
5000,1119,596,0.3000000000000002,125,60,0.30000000000000004,994,536,0.30000000000000016,972,0.0,0.3,9380,931,8449
1824,4114,0,0.0,405,0,0.0,3709,0,0.0,973,0.0,0.5,71,1,70
616,1643,0,0.0,160,0,0.0,1483,0,0.0,974,0.0,0.7,46,2,44
514,1474,0,0.0,151,0,0.0,1323,0,0.0,975,0.0,0.9,20,0,20
5000,4676,1771,0.17442634073267071,479,201,0.18818185255134534,4197,1570,0.1726652847609805,976,0.8,0.1,5924,611,5313
5000,2849,1652,0.13205007711551242,266,158,0.13553337543082933,2583,1494,0.1316816961691804,977,0.8,0.3,7824,776,7048
5000,2573,1900,0.12450532168561096,244,179,0.12662209679182246,2329,1721,0.1242851573950753,978,0.8,0.5,8092,796,7296
5000,4573,1184,0.17824088439955305,445,102,0.1854622914904708,4128,1082,0.17756012328747023,979,0.8,0.7,5890,572,5318
5000,9406,249,0.23080654636356707,945,20,0.16256590439986865,8461,229,0.23676642775777657,980,0.8,0.9,1250,103,1147
5000,1980,3031,0.09999999999999996,178,316,0.10000000000000007,1802,2715,0.1,981,0.0,0.1,8670,892,7778
5000,1044,1156,0.3000000000000001,99,108,0.3,945,1048,0.30000000000000027,982,0.0,0.3,9425,908,8517
5000,1973,577,0.5,214,64,0.5,1759,513,0.5,983,0.0,0.5,8394,839,7555
5000,9237,3,0.6999999999999998,952,0,0.0,8285,3,0.6999999999999998,984,0.0,0.7,1338,135,1203
1885,3972,0,0.0,391,0,0.0,3581,0,0.0,985,0.0,0.9,266,33,233
5000,3815,1896,0.1365263147875805,429,183,0.15099158202388124,3386,1713,0.13498098851540127,986,0.8,0.1,6693,626,6067
5000,4824,1731,0.18285232493945416,470,160,0.18624206676963223,4354,1571,0.18250709343542584,987,0.8,0.3,5569,527,5042
5000,2549,1761,0.12707504176982817,282,171,0.14250094070462957,2267,1590,0.12541602999759482,988,0.8,0.5,7881,783,7098
5000,10327,25,0.13437667835695608,1018,2,0.0248783859372414,9309,23,0.14389826900214867,989,0.8,0.7,170,5,165
5000,2448,1702,0.1413011275082907,223,166,0.16420312446305044,2225,1536,0.1388260418998987,990,0.8,0.9,7932,833,7099
5000,1387,2402,0.10000000000000006,129,217,0.10000000000000005,1258,2185,0.10000000000000003,991,0.0,0.1,9107,904,8203
5000,957,680,0.30000000000000027,83,65,0.3000000000000001,874,615,0.3000000000000002,992,0.0,0.3,9553,892,8661
5000,3244,894,0.5,341,95,0.5,2903,799,0.5,993,0.0,0.5,7221,752,6469
2283,4563,0,0.0,440,0,0.0,4123,0,0.0,994,0.0,0.7,423,45,378
1178,2865,0,0.0,293,0,0.0,2572,0,0.0,995,0.0,0.9,77,4,73
5000,3086,1944,0.12453648392578684,332,197,0.11661999613550433,2754,1747,0.12542918460963665,996,0.8,0.1,7346,727,6619
5000,2410,1680,0.122097137882756,259,141,0.11885539195563957,2151,1539,0.122394139946254,997,0.8,0.3,8091,788,7303
5000,10167,62,0.13180616145099647,1015,0,0.0,9152,62,0.13180616145099647,998,0.8,0.5,403,15,388
5000,1999,1745,0.11583127987639168,160,186,0.10249263854438691,1839,1559,0.1174226764689208,999,0.8,0.7,8450,923,7527
728,1944,0,0.0,192,0,0.0,1752,0,0.0,1000,0.8,0.9,26,1,25
