step,susceptible_status,infected_status,filtermeanvirulence_pathogen,susceptible_status_is_minority,infected_status_is_minority,filtermeanvirulence_pathogen_is_minority,susceptible_status_#84_f=is_minority,infected_status_#84_f=is_minority,filtermeanvirulence_pathogen_#84_f=is_minority,ensemble,mutation_rate,virulence_init,total_infected,total_minority_infected,total_majority_infected
5000,3450,3138,0.09999999999999988,372,311,0.10000000000000005,3078,2827,0.10000000000000002,1,0.0,0.1,6992,671,6321
5000,836,699,0.3000000000000003,65,79,0.3000000000000001,771,620,0.3000000000000003,2,0.0,0.3,9707,941,8766
5000,1350,485,0.5,113,34,0.5,1237,451,0.5,3,0.0,0.5,9382,927,8455
5000,9088,38,0.6999999999999998,867,4,0.7,8221,34,0.7,4,0.0,0.7,1104,110,994
586,1599,0,0.0,158,0,0.0,1441,0,0.0,5,0.0,0.9,54,8,46
5000,2771,2000,0.12307616732747678,282,214,0.1097963299284023,2489,1786,0.12466736844920238,6,0.8,0.1,7728,786,6942
5000,2617,1916,0.12948774787701936,222,187,0.13067166779100428,2395,1729,0.1293597010152986,7,0.8,0.3,7824,849,6975
5000,8741,456,0.18305018915052926,905,24,0.1149283592667737,7836,432,0.18683473525518235,8,0.8,0.5,1844,131,1713
5000,2816,1800,0.13633188783259245,274,168,0.12259405296147265,2542,1632,0.13774607671638417,9,0.8,0.7,7542,737,6805
5000,4979,1609,0.16775734189635513,484,180,0.18617469357619645,4495,1429,0.16543745155179845,10,0.8,0.9,5301,536,4765
5000,2106,3069,0.09999999999999988,225,320,0.10000000000000009,1881,2749,0.09999999999999991,11,0.0,0.1,8436,841,7595
5000,919,678,0.30000000000000027,88,62,0.3000000000000001,831,616,0.30000000000000027,12,0.0,0.3,9480,938,8542
5000,1409,527,0.5,112,56,0.5,1297,471,0.5,13,0.0,0.5,9056,965,8091
1727,3666,0,0.0,334,0,0.0,3332,0,0.0,14,0.0,0.7,157,13,144
1621,3599,0,0.0,369,0,0.0,3230,0,0.0,15,0.0,0.9,173,15,158
5000,3267,2000,0.1278220867272915,337,184,0.1472148631897145,2930,1816,0.12585717986105482,16,0.8,0.1,7299,713,6586
5000,3635,2082,0.14767409726151254,327,242,0.13645336448017215,3308,1840,0.14914986755123233,17,0.8,0.3,6981,792,6189
5000,4246,1702,0.17859208661009707,467,169,0.20601655856044224,3779,1533,0.17556877561230944,18,0.8,0.5,6304,612,5692
5000,9174,423,0.229823843857688,911,39,0.2971065356546298,8263,384,0.22299044547206118,19,0.8,0.7,1294,118,1176
3526,7196,0,0.0,714,0,0.0,6482,0,0.0,20,0.8,0.9,320,29,291
5000,1604,2853,0.09999999999999995,150,280,0.10000000000000005,1454,2573,0.10000000000000003,21,0.0,0.1,8803,864,7939
5000,1135,1204,0.3000000000000003,108,127,0.2999999999999997,1027,1077,0.3000000000000002,22,0.0,0.3,9272,983,8289
5000,1274,555,0.5,121,60,0.5,1153,495,0.5,23,0.0,0.5,9089,917,8172
5000,9126,68,0.7000000000000002,911,2,0.7,8215,66,0.7000000000000001,24,0.0,0.7,1275,135,1140
1800,3921,0,0.0,411,0,0.0,3510,0,0.0,25,0.0,0.9,166,10,156
5000,2210,1918,0.1219647528449076,197,188,0.12752539377388583,2013,1730,0.12136047510233657,26,0.8,0.1,8230,827,7403
5000,2699,1930,0.12677412159403864,264,195,0.11764934378657471,2435,1735,0.12779967299026657,27,0.8,0.3,7967,816,7151
5000,4348,1777,0.14232821219702005,437,162,0.134739495533248,3911,1615,0.1430894333112807,28,0.8,0.5,6183,587,5596
5000,4322,1964,0.17187383077727728,377,222,0.16206503100330613,3945,1742,0.17312386151770298,29,0.8,0.7,6194,692,5502
5000,8997,408,0.21741387930287828,912,36,0.23296747200260765,8085,372,0.2159086929125819,30,0.8,0.9,1495,151,1344
5000,1485,2492,0.10000000000000007,114,233,0.10000000000000005,1371,2259,0.10000000000000006,31,0.0,0.1,9171,897,8274
5000,902,618,0.30000000000000027,111,54,0.3,791,564,0.30000000000000016,32,0.0,0.3,9525,985,8540
5000,2292,455,0.5,282,48,0.5,2010,407,0.5,33,0.0,0.5,8241,821,7420
871,2262,0,0.0,234,0,0.0,2028,0,0.0,34,0.0,0.7,33,1,32
1993,4201,0,0.0,475,0,0.0,3726,0,0.0,35,0.0,0.9,229,24,205
5000,2514,1935,0.12760494380678788,224,179,0.1246108753761528,2290,1756,0.12791014782107243,36,0.8,0.1,8105,844,7261
5000,2814,1772,0.12935009602190028,296,153,0.13105852956492303,2518,1619,0.1291886443035047,37,0.8,0.3,7615,686,6929
5000,5774,1265,0.17962300533149106,625,111,0.18770997363713554,5149,1154,0.1788451426955062,38,0.8,0.5,4609,418,4191
1511,3447,0,0.0,329,0,0.0,3118,0,0.0,39,0.8,0.7,59,0,59
5000,8606,630,0.22016510325572636,799,74,0.20831871700439913,7807,556,0.2217417805625576,40,0.8,0.9,1808,191,1617
5000,1412,2620,0.09999999999999994,134,248,0.10000000000000005,1278,2372,0.10000000000000007,41,0.0,0.1,9020,883,8137
5000,944,715,0.3000000000000004,115,75,0.30000000000000004,829,640,0.3000000000000004,42,0.0,0.3,9576,1000,8576
5000,3912,723,0.5,375,105,0.5,3537,618,0.5,43,0.0,0.5,6692,707,5985
3113,6083,0,0.0,592,0,0.0,5491,0,0.0,44,0.0,0.7,642,54,588
2125,4559,0,0.0,464,0,0.0,4095,0,0.0,45,0.0,0.9,218,26,192
5000,2598,1813,0.12468332829895744,248,164,0.11126937981565521,2350,1649,0.1260174020110627,46,0.8,0.1,7941,760,7181
5000,2641,1523,0.13773930023876046,250,135,0.1513046223443206,2391,1388,0.13641990651811886,47,0.8,0.3,7837,747,7090
5000,3403,1735,0.16637996427306737,338,183,0.1758604763572389,3065,1552,0.1652620946136579,48,0.8,0.5,7038,726,6312
5000,7687,824,0.20094110491458525,783,70,0.20645022817012795,6904,754,0.2004296478484208,49,0.8,0.7,2736,222,2514
1049,2392,0,0.0,234,0,0.0,2158,0,0.0,50,0.8,0.9,110,15,95
5000,1803,2810,0.09999999999999992,181,267,0.10000000000000006,1622,2543,0.10000000000000009,51,0.0,0.1,8658,828,7830
5000,933,670,0.30000000000000043,94,64,0.3000000000000001,839,606,0.3000000000000004,52,0.0,0.3,9474,995,8479
5000,1290,477,0.5,135,43,0.5,1155,434,0.5,53,0.0,0.5,9143,948,8195
5000,8134,116,0.7000000000000002,806,9,0.7000000000000001,7328,107,0.7000000000000002,54,0.0,0.7,2306,244,2062
1108,2545,0,0.0,259,0,0.0,2286,0,0.0,55,0.0,0.9,60,3,57
5000,2818,1751,0.12730613975850585,275,151,0.13663812495708547,2543,1600,0.12642543365538988,56,0.8,0.1,7709,705,7004
5000,3218,1788,0.12626564652273656,325,178,0.12138426762566344,2893,1610,0.1268053269225372,57,0.8,0.3,7330,705,6625
5000,3981,1571,0.15788711661362992,384,142,0.17497454736948803,3597,1429,0.15618913539086446,58,0.8,0.5,6584,622,5962
5000,9750,210,0.2363397185803458,979,17,0.22639221680404334,8771,193,0.23721592340002007,59,0.8,0.7,703,61,642
328,1127,0,0.0,103,0,0.0,1024,0,0.0,60,0.8,0.9,20,2,18
5000,1684,2637,0.10000000000000002,179,252,0.10000000000000006,1505,2385,0.10000000000000006,61,0.0,0.1,8793,852,7941
5000,841,740,0.30000000000000027,87,95,0.3000000000000001,754,645,0.3000000000000002,62,0.0,0.3,9835,1028,8807
5000,1860,507,0.5,184,56,0.5,1676,451,0.5,63,0.0,0.5,8632,908,7724
959,2365,0,0.0,239,0,0.0,2126,0,0.0,64,0.0,0.7,64,1,63
1122,2596,0,0.0,253,0,0.0,2343,0,0.0,65,0.0,0.9,89,7,82
5000,2738,1950,0.1254615189815535,269,176,0.13238433123101367,2469,1774,0.1247747010808179,66,0.8,0.1,7592,825,6767
5000,3853,1773,0.15176826150040107,382,186,0.16273878840431205,3471,1587,0.1504824908613794,67,0.8,0.3,6535,669,5866
5000,7401,916,0.18816874509127932,744,80,0.13749666264054747,6657,836,0.1930177481966125,68,0.8,0.5,3156,302,2854
5000,6340,1218,0.19218935616845292,646,131,0.24031536446199409,5694,1087,0.18638944164549626,69,0.8,0.7,4242,432,3810
5000,6839,1157,0.20478925820588303,706,152,0.20864950680729794,6133,1005,0.20420541961144026,70,0.8,0.9,3649,430,3219
5000,2405,3190,0.0999999999999999,218,281,0.10000000000000006,2187,2909,0.09999999999999995,71,0.0,0.1,8139,766,7373
5000,927,894,0.30000000000000043,94,78,0.3000000000000001,833,816,0.3000000000000005,72,0.0,0.3,9757,930,8827
5000,2689,597,0.5,304,48,0.5,2385,549,0.5,73,0.0,0.5,7717,733,6984
2767,5592,0,0.0,571,0,0.0,5021,0,0.0,74,0.0,0.7,381,28,353
784,1950,0,0.0,185,0,0.0,1765,0,0.0,75,0.0,0.9,51,4,47
5000,4376,1780,0.1787888916013485,434,200,0.24985911045107634,3942,1580,0.16979266136720575,76,0.8,0.1,6164,667,5497
5000,2630,1791,0.13381913462968453,259,190,0.12146449920719353,2371,1601,0.13528533121324057,77,0.8,0.3,7898,775,7123
5000,3758,1829,0.14620430158793996,346,194,0.13859332835831334,3412,1635,0.147107377310599,78,0.8,0.5,6606,638,5968
5000,4020,1831,0.15581785111485305,380,187,0.1579527391591393,3640,1644,0.155575014092784,79,0.8,0.7,6436,682,5754
5000,8922,405,0.19806737356157444,928,36,0.20751361604697874,7994,369,0.19714578892885207,80,0.8,0.9,1549,121,1428
5000,2369,3020,0.09999999999999998,231,317,0.10000000000000007,2138,2703,0.10000000000000002,81,0.0,0.1,7911,815,7096
5000,891,704,0.30000000000000043,70,69,0.3,821,635,0.3000000000000003,82,0.0,0.3,9627,1001,8626
5000,1577,569,0.5,172,52,0.5,1405,517,0.5,83,0.0,0.5,8826,917,7909
2918,6054,0,0.0,619,0,0.0,5435,0,0.0,84,0.0,0.7,375,33,342
1099,2664,0,0.0,255,0,0.0,2409,0,0.0,85,0.0,0.9,68,4,64
5000,3085,1609,0.1496159574231886,314,150,0.1520551736239054,2771,1459,0.14936518125450626,86,0.8,0.1,7350,743,6607
5000,3240,1837,0.12342671045818782,336,205,0.11440521604318235,2904,1632,0.12455992513654326,87,0.8,0.3,7377,751,6626
5000,6218,1191,0.19912337014156722,669,106,0.22290891561746376,5549,1085,0.19679962099829987,88,0.8,0.5,4475,404,4071
5000,7575,796,0.16922075112756343,756,79,0.14944886755902295,6819,717,0.17139924318044295,89,0.8,0.7,2876,202,2674
5000,9182,324,0.1668067779597885,925,28,0.12766474557441648,8257,296,0.17050940264489123,90,0.8,0.9,1304,118,1186
5000,1710,2821,0.09999999999999992,169,289,0.10000000000000009,1541,2532,0.10000000000000007,91,0.0,0.1,8703,864,7839
5000,967,634,0.3000000000000003,108,73,0.30000000000000004,859,561,0.3000000000000004,92,0.0,0.3,9439,982,8457
5000,7181,381,0.5,811,31,0.5,6370,350,0.5,93,0.0,0.5,3232,284,2948
2353,5156,0,0.0,528,0,0.0,4628,0,0.0,94,0.0,0.7,134,15,119
2315,4783,0,0.0,483,0,0.0,4300,0,0.0,95,0.0,0.9,193,21,172
5000,5918,1402,0.1918233410097611,649,115,0.2351094472852795,5269,1287,0.18795550711567816,96,0.8,0.1,4606,404,4202
5000,2467,1978,0.12855182006898228,243,219,0.11127686708460721,2224,1759,0.1307025959095611,97,0.8,0.3,7991,816,7175
5000,4955,1685,0.15889431149490443,492,170,0.15020003094063505,4463,1515,0.15986990733267717,98,0.8,0.5,5392,547,4845
5000,8501,493,0.18750332478983617,897,31,0.1996120211332709,7604,462,0.18669083650705157,99,0.8,0.7,2001,155,1846
5000,7777,892,0.20501186520229323,764,75,0.18912729704235443,7013,817,0.20647005689384207,100,0.8,0.9,2717,241,2476
5000,2072,3051,0.09999999999999994,195,301,0.10000000000000007,1877,2750,0.09999999999999992,101,0.0,0.1,8624,865,7759
5000,820,902,0.3000000000000004,62,99,0.3,758,803,0.30000000000000027,102,0.0,0.3,9545,949,8596
5000,2182,678,0.5,197,83,0.5,1985,595,0.5,103,0.0,0.5,8219,822,7397
1812,3861,0,0.0,432,0,0.0,3429,0,0.0,104,0.0,0.7,203,5,198
2742,5589,0,0.0,536,0,0.0,5053,0,0.0,105,0.0,0.9,393,48,345
5000,3885,1971,0.13784163312414138,422,187,0.13473393132604963,3463,1784,0.13816738437764084,106,0.8,0.1,6521,590,5931
5000,3408,1840,0.1334175172077334,355,182,0.12494949341148658,3053,1658,0.1343470590237267,107,0.8,0.3,7029,694,6335
5000,6550,861,0.19627749657934274,652,68,0.19585800185245356,5898,793,0.19631346838442276,108,0.8,0.5,4030,351,3679
5000,9360,304,0.22999558207057588,979,21,0.23724652565833487,8381,283,0.22945752618597187,109,0.8,0.7,1259,82,1177
5000,9105,308,0.16779472677739993,960,21,0.12641000666817906,8145,287,0.1708228770292941,110,0.8,0.9,1323,91,1232
5000,2290,2948,0.0999999999999999,219,270,0.10000000000000007,2071,2678,0.09999999999999994,111,0.0,0.1,8442,841,7601
5000,895,765,0.30000000000000043,81,79,0.3000000000000001,814,686,0.3000000000000004,112,0.0,0.3,9711,979,8732
5000,1832,477,0.5,198,59,0.5,1634,418,0.5,113,0.0,0.5,8667,922,7745
2418,5205,0,0.0,550,0,0.0,4655,0,0.0,114,0.0,0.7,129,8,121
1618,3528,0,0.0,361,0,0.0,3167,0,0.0,115,0.0,0.9,176,13,163
5000,2891,1741,0.14899165287095517,315,166,0.15838040177392448,2576,1575,0.14800210854213428,116,0.8,0.1,7711,795,6916
5000,2264,1879,0.11701284955785166,208,194,0.10813008619331403,2056,1685,0.1180355534704453,117,0.8,0.3,8174,867,7307
5000,4853,1661,0.16639346833813062,500,166,0.1818252307867928,4353,1495,0.16467997498262696,118,0.8,0.5,5677,571,5106
5000,9532,203,0.1918166800434717,978,11,0.23868202247386633,8554,192,0.18913168646673026,119,0.8,0.7,818,51,767
5000,6728,1054,0.17951855715578582,697,118,0.1903997311316018,6031,936,0.17814678522293742,120,0.8,0.9,3814,395,3419
5000,1999,2867,0.09999999999999994,200,285,0.10000000000000007,1799,2582,0.10000000000000002,121,0.0,0.1,8407,831,7576
5000,827,846,0.30000000000000043,63,93,0.3000000000000001,764,753,0.30000000000000043,122,0.0,0.3,9755,945,8810
5000,1228,468,0.5,102,40,0.5,1126,428,0.5,123,0.0,0.5,9299,920,8379
1447,3218,0,0.0,348,0,0.0,2870,0,0.0,124,0.0,0.7,98,2,96
2121,4539,0,0.0,466,0,0.0,4073,0,0.0,125,0.0,0.9,216,31,185
5000,4785,1761,0.1548822486527397,478,194,0.17686174079231287,4307,1567,0.1521611117828754,126,0.8,0.1,5565,544,5021
5000,8594,582,0.18379024254820245,903,53,0.18885291111157518,7691,529,0.1832830186656717,127,0.8,0.3,1861,151,1710
5000,2626,1618,0.1304044274094272,248,136,0.14324821265000418,2378,1482,0.12922578045077782,128,0.8,0.5,7862,765,7097
5000,3682,1840,0.15025534540740573,391,186,0.15512410719659342,3291,1654,0.14970783047827096,129,0.8,0.7,6712,666,6046
5000,7705,941,0.23130636013212533,701,120,0.20191582626037288,7004,821,0.2356021750707492,130,0.8,0.9,2701,284,2417
5000,1849,2887,0.09999999999999998,184,302,0.10000000000000007,1665,2585,0.1,131,0.0,0.1,8608,873,7735
5000,872,621,0.3000000000000003,80,65,0.3000000000000001,792,556,0.30000000000000027,132,0.0,0.3,9565,958,8607
5000,3351,738,0.5,297,67,0.5,3054,671,0.5,133,0.0,0.5,7358,740,6618
5000,9163,9,0.7000000000000001,939,0,0.0,8224,9,0.7000000000000001,134,0.0,0.7,1420,136,1284
1241,2738,0,0.0,291,0,0.0,2447,0,0.0,135,0.0,0.9,221,38,183
5000,2871,1901,0.13687851512385182,285,169,0.14688843737731694,2586,1732,0.13590179638202984,136,0.8,0.1,7466,706,6760
5000,4338,1520,0.13582700752047813,432,150,0.13778984037431855,3906,1370,0.1356120988138533,137,0.8,0.3,6067,539,5528
5000,9357,346,0.19281244329815897,954,26,0.16960958701117662,8403,320,0.19469767537147634,138,0.8,0.5,1107,96,1011
5000,7281,1034,0.1805325195381326,773,82,0.21711385299617045,6508,952,0.1773816063621252,139,0.8,0.7,3416,268,3148
618,1702,0,0.0,174,0,0.0,1528,0,0.0,140,0.8,0.9,30,2,28
5000,1708,2704,0.10000000000000002,156,248,0.10000000000000005,1552,2456,0.10000000000000006,141,0.0,0.1,8800,874,7926
5000,944,678,0.30000000000000027,96,85,0.30000000000000004,848,593,0.3000000000000004,142,0.0,0.3,9497,958,8539
5000,2059,365,0.5,235,36,0.5,1824,329,0.5,143,0.0,0.5,8443,804,7639
1958,4143,0,0.0,410,0,0.0,3733,0,0.0,144,0.0,0.7,174,22,152
560,1587,0,0.0,164,0,0.0,1423,0,0.0,145,0.0,0.9,37,4,33
5000,2530,2048,0.12177083934823744,272,174,0.1020191397934486,2258,1874,0.12360477516602467,146,0.8,0.1,7913,766,7147
5000,3448,1934,0.16334409681284964,336,171,0.16617410042185604,3112,1763,0.16306960412020075,147,0.8,0.3,6984,718,6266
5000,2918,1679,0.15447350343698016,291,180,0.17463386564063774,2627,1499,0.15205264606762828,148,0.8,0.5,7551,779,6772
5000,10179,30,0.10853037081079007,969,1,0.1456440358583409,9210,29,0.10725058925742624,149,0.8,0.7,267,18,249
1439,3219,0,0.0,341,0,0.0,2878,0,0.0,150,0.8,0.9,89,3,86
5000,1618,2726,0.09999999999999996,145,280,0.10000000000000005,1473,2446,0.10000000000000006,151,0.0,0.1,8909,876,8033
5000,849,687,0.30000000000000043,72,72,0.30000000000000004,777,615,0.3000000000000002,152,0.0,0.3,9652,968,8684
5000,2322,589,0.5,247,64,0.5,2075,525,0.5,153,0.0,0.5,8070,792,7278
513,1478,0,0.0,145,0,0.0,1333,0,0.0,154,0.0,0.7,23,0,23
366,1199,0,0.0,127,0,0.0,1072,0,0.0,155,0.0,0.9,15,3,12
5000,2844,1829,0.13027528446666595,303,187,0.1217307756719578,2541,1642,0.13124838016983914,156,0.8,0.1,7731,782,6949
5000,2822,1723,0.13171809806942789,296,166,0.12542679556302902,2526,1557,0.13238884708423984,157,0.8,0.3,7642,776,6866
5000,2989,1686,0.12012694160944776,298,193,0.1231010170041618,2691,1493,0.11974248310229452,158,0.8,0.5,7291,786,6505
5000,8531,561,0.2083152966765587,785,59,0.25454859660802664,7746,502,0.20288150246150566,159,0.8,0.7,1908,188,1720
5000,3484,1871,0.14397449903625853,360,210,0.1612520491405789,3124,1661,0.14179010076900542,160,0.8,0.9,7205,749,6456
5000,1556,2516,0.10000000000000006,137,209,0.10000000000000009,1419,2307,0.10000000000000009,161,0.0,0.1,8975,881,8094
5000,986,885,0.3000000000000003,97,92,0.3000000000000001,889,793,0.3000000000000004,162,0.0,0.3,9598,1002,8596
5000,1794,474,0.5,186,50,0.5,1608,424,0.5,163,0.0,0.5,8785,899,7886
5000,8029,83,0.7000000000000001,751,7,0.7000000000000001,7278,76,0.7000000000000004,164,0.0,0.7,2579,265,2314
1303,2961,0,0.0,298,0,0.0,2663,0,0.0,165,0.0,0.9,164,18,146
5000,3831,1903,0.14763256477321302,350,185,0.1389054760606184,3481,1718,0.14857232694540737,166,0.8,0.1,6400,631,5769
5000,2505,1905,0.1308568744952069,205,195,0.1352920497305073,2300,1710,0.1303511088981989,167,0.8,0.3,7962,786,7176
5000,4786,1591,0.1686210087120316,473,163,0.14471591395095143,4313,1428,0.17134967148938174,168,0.8,0.5,5717,550,5167
5000,2571,1934,0.15081423454608314,245,197,0.14576650631777524,2326,1737,0.15138671725246003,169,0.8,0.7,7975,816,7159
1464,3135,0,0.0,326,0,0.0,2809,0,0.0,170,0.8,0.9,222,29,193
5000,2632,3100,0.09999999999999995,284,302,0.10000000000000007,2348,2798,0.09999999999999995,171,0.0,0.1,7919,761,7158
5000,1046,634,0.3000000000000003,103,76,0.30000000000000004,943,558,0.3000000000000003,172,0.0,0.3,9563,934,8629
5000,1833,458,0.5,207,44,0.5,1626,414,0.5,173,0.0,0.5,8572,855,7717
5000,5979,253,0.6999999999999994,563,35,0.6999999999999998,5416,218,0.6999999999999996,174,0.0,0.7,4557,538,4019
1246,2846,0,0.0,275,0,0.0,2571,0,0.0,175,0.0,0.9,143,14,129
5000,5383,1701,0.18466132793866705,480,179,0.16666532606927814,4903,1522,0.18677780910464648,176,0.8,0.1,5111,543,4568
5000,2642,1703,0.11976481268750862,278,183,0.13126582142674653,2364,1520,0.11838015176692934,177,0.8,0.3,7871,791,7080
5000,2652,1364,0.12791270876338698,272,124,0.13869773842533412,2380,1240,0.12683420579719226,178,0.8,0.5,7751,776,6975
3701,7838,0,0.0,790,0,0.0,7048,0,0.0,179,0.8,0.7,67,6,61
5000,9791,149,0.19866544306966824,958,15,0.15412919877922776,8833,134,0.20365084354994148,180,0.8,0.9,515,41,474
5000,1594,2572,0.10000000000000003,141,254,0.10000000000000007,1453,2318,0.10000000000000005,181,0.0,0.1,8842,882,7960
5000,1017,700,0.3000000000000004,98,73,0.30000000000000004,919,627,0.30000000000000016,182,0.0,0.3,9267,908,8359
5000,8552,378,0.5,819,43,0.5,7733,335,0.5,183,0.0,0.5,1928,191,1737
5000,9738,3,0.6999999999999998,999,0,0.0,8739,3,0.6999999999999998,184,0.0,0.7,795,71,724
770,1957,0,0.0,204,0,0.0,1753,0,0.0,185,0.0,0.9,15,1,14
5000,2587,1818,0.12861298519778105,287,166,0.1326135760941394,2300,1652,0.12821098877599202,186,0.8,0.1,7994,774,7220
5000,2646,1797,0.1214202666138369,261,167,0.11925542403791081,2385,1630,0.12164206336854833,187,0.8,0.3,7973,794,7179
5000,5778,1466,0.17339465373282434,611,167,0.18628252050613,5167,1299,0.17173778402447787,188,0.8,0.5,4668,465,4203
5000,9922,136,0.1932619354388144,1030,10,0.1451100001240721,8892,126,0.19708351760665113,189,0.8,0.7,477,24,453
5000,10349,47,0.19377916803330722,1050,2,0.19277771088449389,9299,45,0.19382367723992114,190,0.8,0.9,240,7,233
5000,1678,2878,0.09999999999999991,172,298,0.10000000000000006,1506,2580,0.10000000000000002,191,0.0,0.1,8885,872,8013
5000,813,689,0.30000000000000043,75,72,0.30000000000000004,738,617,0.30000000000000027,192,0.0,0.3,9844,1008,8836
5000,2206,491,0.5,218,39,0.5,1988,452,0.5,193,0.0,0.5,8498,773,7725
2889,5768,0,0.0,566,0,0.0,5202,0,0.0,194,0.0,0.7,539,54,485
1287,2989,0,0.0,314,0,0.0,2675,0,0.0,195,0.0,0.9,95,11,84
5000,2965,1871,0.13874202483019785,278,179,0.12838881815541553,2687,1692,0.13983731087912576,196,0.8,0.1,7648,779,6869
5000,3596,1738,0.16788540711559977,373,151,0.15119521704598965,3223,1587,0.16947344662442848,197,0.8,0.3,6891,644,6247
5000,2529,1793,0.12342693197285601,243,197,0.10478688697476385,2286,1596,0.12572773953214436,198,0.8,0.5,7915,827,7088
5000,9050,385,0.18865871272609241,905,31,0.23738071353724932,8145,354,0.1843920968358499,199,0.8,0.7,1398,113,1285
1122,2640,0,0.0,269,0,0.0,2371,0,0.0,200,0.8,0.9,81,5,76
5000,1967,2981,0.09999999999999994,205,274,0.10000000000000002,1762,2707,0.10000000000000002,201,0.0,0.1,8495,843,7652
5000,991,696,0.3000000000000003,92,76,0.30000000000000004,899,620,0.3000000000000003,202,0.0,0.3,9583,949,8634
5000,3850,752,0.5,385,75,0.5,3465,677,0.5,203,0.0,0.5,6636,617,6019
5000,9855,1,0.7,1027,0,0.0,8828,1,0.7,204,0.0,0.7,564,43,521
1530,3318,0,0.0,334,0,0.0,2984,0,0.0,205,0.0,0.9,171,21,150
5000,2885,1860,0.11873907891144043,304,160,0.10266276821494309,2581,1700,0.1202521434475814,206,0.8,0.1,7627,716,6911
5000,2332,1740,0.11759088499537065,254,172,0.10797943930209399,2078,1568,0.11864520174233721,207,0.8,0.3,8068,831,7237
5000,4579,1346,0.17677261571869646,443,113,0.20060105376188933,4136,1233,0.17458882537086132,208,0.8,0.5,5921,571,5350
5000,5415,1431,0.1657765295037219,585,145,0.15519350864940726,4830,1286,0.1669697939079798,209,0.8,0.7,5066,482,4584
468,1396,0,0.0,137,0,0.0,1259,0,0.0,210,0.8,0.9,16,1,15
5000,1576,2553,0.10000000000000009,127,221,0.10000000000000007,1449,2332,0.10000000000000006,211,0.0,0.1,8875,870,8005
5000,1043,615,0.3000000000000002,129,70,0.3,914,545,0.3000000000000004,212,0.0,0.3,9437,995,8442
5000,2038,478,0.5,196,49,0.5,1842,429,0.5,213,0.0,0.5,8444,821,7623
2376,5122,0,0.0,508,0,0.0,4614,0,0.0,214,0.0,0.7,161,16,145
1024,2452,0,0.0,236,0,0.0,2216,0,0.0,215,0.0,0.9,47,0,47
5000,4855,1615,0.14104749605842484,525,177,0.13107410481727216,4330,1438,0.14227509706655003,216,0.8,0.1,5569,519,5050
5000,3245,1846,0.1439203483857871,325,181,0.13747654759632436,2920,1665,0.1446208456487857,217,0.8,0.3,7178,658,6520
5000,2390,1550,0.12289163578989482,232,149,0.11376369485545673,2158,1401,0.12386241608913198,218,0.8,0.5,8095,841,7254
5000,9773,210,0.19138613860886686,989,23,0.18274175832501396,8784,187,0.19244935115714826,219,0.8,0.7,597,45,552
509,1443,0,0.0,132,0,0.0,1311,0,0.0,220,0.8,0.9,36,2,34
5000,1671,2851,0.09999999999999996,156,298,0.10000000000000006,1515,2553,0.10000000000000009,221,0.0,0.1,8807,940,7867
5000,867,630,0.3000000000000002,92,66,0.29999999999999993,775,564,0.30000000000000016,222,0.0,0.3,9493,927,8566
5000,2198,844,0.5,197,93,0.5,2001,751,0.5,223,0.0,0.5,8375,867,7508
2477,5120,0,0.0,501,0,0.0,4619,0,0.0,224,0.0,0.7,300,34,266
1350,3103,0,0.0,320,0,0.0,2783,0,0.0,225,0.0,0.9,128,14,114
5000,3384,1967,0.14857251586829529,328,175,0.13656152249382378,3056,1792,0.1497454644400211,226,0.8,0.1,7012,699,6313
5000,2141,1626,0.13490438934326104,200,158,0.16378182974411387,1941,1468,0.13179632695679325,227,0.8,0.3,8304,820,7484
5000,4254,1646,0.16238346134862416,415,172,0.15097081406735802,3839,1474,0.16371519495267955,228,0.8,0.5,6203,622,5581
5000,5291,1199,0.15653740375199438,593,99,0.15744682652481098,4698,1100,0.1564555557024409,229,0.8,0.7,5199,521,4678
5000,9720,254,0.20966031603542598,997,27,0.1773620731437422,8723,227,0.21350195726042806,230,0.8,0.9,829,65,764
5000,1714,2767,0.10000000000000002,193,252,0.10000000000000006,1521,2515,0.10000000000000006,231,0.0,0.1,8682,845,7837
5000,849,631,0.30000000000000027,75,65,0.3000000000000001,774,566,0.30000000000000016,232,0.0,0.3,9592,922,8670
5000,1488,421,0.5,134,45,0.5,1354,376,0.5,233,0.0,0.5,8871,924,7947
5000,8016,56,0.7000000000000002,835,7,0.7000000000000001,7181,49,0.7,234,0.0,0.7,2383,222,2161
3487,6480,0,0.0,609,0,0.0,5871,0,0.0,235,0.0,0.9,770,123,647
5000,2349,1966,0.11897818876378405,233,199,0.11120108062649331,2116,1767,0.11985404870680662,236,0.8,0.1,8077,813,7264
5000,5437,1405,0.14528934345224578,568,145,0.13511680305855403,4869,1260,0.14645999294199602,237,0.8,0.3,4985,482,4503
5000,6928,1165,0.2035709978207336,653,132,0.2080465757708806,6275,1033,0.202999094345981,238,0.8,0.5,3647,399,3248
5000,2502,1711,0.11781144440803985,257,182,0.13348493249868076,2245,1529,0.11594579703557638,239,0.8,0.7,7845,822,7023
5000,10429,16,0.10803101416088078,1053,0,0.0,9376,16,0.10803101416088078,240,0.8,0.9,156,5,151
5000,3427,3016,0.09999999999999999,359,272,0.10000000000000009,3068,2744,0.09999999999999994,241,0.0,0.1,6958,685,6273
5000,995,658,0.3000000000000002,87,62,0.3000000000000001,908,596,0.3000000000000002,242,0.0,0.3,9445,946,8499
5000,1580,473,0.5,143,52,0.5,1437,421,0.5,243,0.0,0.5,8722,876,7846
2998,6147,0,0.0,656,0,0.0,5491,0,0.0,244,0.0,0.7,288,22,266
524,1480,0,0.0,162,0,0.0,1318,0,0.0,245,0.0,0.9,24,1,23
5000,2202,1911,0.11095883757380635,230,198,0.1050318657029067,1972,1713,0.11164391663419058,246,0.8,0.1,8255,820,7435
5000,3122,1641,0.14172159885186228,333,182,0.1205948892481124,2789,1459,0.144357007452193,247,0.8,0.3,7173,745,6428
5000,3273,1838,0.13591806473849313,353,196,0.13791535161875315,2920,1642,0.13567965534231108,248,0.8,0.5,7185,655,6530
5000,9808,153,0.16058814403799937,988,10,0.09922522956122518,8820,143,0.1648792569384731,249,0.8,0.7,773,41,732
5000,4644,1718,0.15318529096675665,431,190,0.16052337317903864,4213,1528,0.1522728331000461,250,0.8,0.9,5850,628,5222
5000,3212,3021,0.09999999999999996,341,299,0.10000000000000006,2871,2722,0.09999999999999998,251,0.0,0.1,7241,677,6564
5000,873,651,0.3000000000000003,101,69,0.3,772,582,0.3000000000000002,252,0.0,0.3,9738,958,8780
5000,1287,449,0.5,112,51,0.5,1175,398,0.5,253,0.0,0.5,9263,962,8301
5000,10198,6,0.7000000000000001,1028,0,0.0,9170,6,0.7000000000000001,254,0.0,0.7,517,29,488
767,1916,0,0.0,197,0,0.0,1719,0,0.0,255,0.0,0.9,61,4,57
5000,5677,1488,0.17278983798155828,619,122,0.16848612278625683,5058,1366,0.17317421078816642,256,0.8,0.1,4834,424,4410
5000,2995,1901,0.12934157870718196,295,217,0.1249559774524935,2700,1684,0.12990670665983484,257,0.8,0.3,7587,742,6845
5000,8325,609,0.22250140598022813,826,88,0.19415884785913243,7499,521,0.22728863268782204,258,0.8,0.5,1838,205,1633
5000,9819,156,0.27397234196560316,1033,13,0.22387001447704996,8786,143,0.27852709901001704,259,0.8,0.7,597,46,551
5000,10105,125,0.28550251056776715,998,10,0.30270779093494704,9107,115,0.2840063992314907,260,0.8,0.9,506,51,455
5000,2089,3090,0.09999999999999996,193,302,0.10000000000000007,1896,2788,0.09999999999999996,261,0.0,0.1,8446,840,7606
5000,993,625,0.30000000000000043,104,50,0.3,889,575,0.3000000000000003,262,0.0,0.3,9375,924,8451
5000,4483,621,0.5,490,74,0.5,3993,547,0.5,263,0.0,0.5,6098,579,5519
2969,5931,0,0.0,585,0,0.0,5346,0,0.0,264,0.0,0.7,527,52,475
1395,3142,0,0.0,320,0,0.0,2822,0,0.0,265,0.0,0.9,101,8,93
5000,3029,1978,0.12943454993247572,288,221,0.145976569991039,2741,1757,0.12735385190575818,266,0.8,0.1,7385,716,6669
5000,2813,1799,0.14376645082083453,275,186,0.1511525759353775,2538,1613,0.14291473397563612,267,0.8,0.3,7539,782,6757
5000,5850,1373,0.17580161467007943,625,142,0.17914330916112886,5225,1231,0.1754161389448731,268,0.8,0.5,4550,449,4101
5000,2479,1807,0.13028726410857636,234,155,0.12240227674174194,2245,1652,0.13102707829856386,269,0.8,0.7,8072,802,7270
1050,2535,0,0.0,264,0,0.0,2271,0,0.0,270,0.8,0.9,54,4,50
5000,1749,2821,0.09999999999999992,168,278,0.10000000000000005,1581,2543,0.10000000000000009,271,0.0,0.1,8774,876,7898
5000,928,633,0.30000000000000027,105,62,0.3000000000000001,823,571,0.30000000000000027,272,0.0,0.3,9594,969,8625
5000,3977,729,0.5,416,72,0.5,3561,657,0.5,273,0.0,0.5,6470,622,5848
1760,3819,0,0.0,390,0,0.0,3429,0,0.0,274,0.0,0.7,117,3,114
990,2390,0,0.0,241,0,0.0,2149,0,0.0,275,0.0,0.9,35,3,32
5000,2242,1928,0.1151129378910001,239,200,0.10908814262711164,2003,1728,0.11581025215765381,276,0.8,0.1,8191,809,7382
5000,3922,1743,0.15513926096965044,410,159,0.13947892441942758,3512,1584,0.15671122657033565,277,0.8,0.3,6441,637,5804
5000,5014,1453,0.16397953136138568,528,153,0.17509557424113945,4486,1300,0.1626712586224608,278,0.8,0.5,5411,510,4901
5000,4589,1483,0.165794035468094,464,119,0.17884979621732677,4125,1364,0.16465500648777237,279,0.8,0.7,5835,564,5271
5000,7047,953,0.23989402730691484,673,106,0.23504939331988892,6374,847,0.24050032152488973,280,0.8,0.9,3285,369,2916
5000,1739,2732,0.09999999999999995,204,233,0.10000000000000005,1535,2499,0.10000000000000009,281,0.0,0.1,8821,823,7998
5000,918,728,0.3000000000000004,84,67,0.3,834,661,0.30000000000000027,282,0.0,0.3,9582,920,8662
5000,1469,500,0.5,127,51,0.5,1342,449,0.5,283,0.0,0.5,9088,893,8195
2206,4760,0,0.0,468,0,0.0,4292,0,0.0,284,0.0,0.7,84,3,81
607,1701,0,0.0,169,0,0.0,1532,0,0.0,285,0.0,0.9,45,6,39
5000,2432,1791,0.11029878881143661,256,173,0.12561368732355502,2176,1618,0.10866128730179724,286,0.8,0.1,8203,827,7376
5000,2998,1910,0.13325763292940354,308,173,0.13547294306727017,2690,1737,0.1330369946715734,287,0.8,0.3,7447,704,6743
5000,2737,1724,0.14193246614064317,253,187,0.13880297682226875,2484,1537,0.14231321728087482,288,0.8,0.5,7797,787,7010
5000,4142,1977,0.16353681111371315,385,192,0.14603190037523808,3757,1785,0.16541969226877598,289,0.8,0.7,6578,657,5921
1305,3066,0,0.0,297,0,0.0,2769,0,0.0,290,0.8,0.9,73,0,73
5000,1746,2651,0.1,166,270,0.10000000000000007,1580,2381,0.10000000000000006,291,0.0,0.1,8670,857,7813
5000,1021,574,0.3000000000000003,96,65,0.3000000000000001,925,509,0.30000000000000027,292,0.0,0.3,9277,976,8301
5000,4408,735,0.5,430,96,0.5,3978,639,0.5,293,0.0,0.5,6037,626,5411
5000,10115,2,0.7,1025,0,0.0,9090,2,0.7,294,0.0,0.7,473,42,431
1218,2773,0,0.0,262,0,0.0,2511,0,0.0,295,0.0,0.9,132,9,123
5000,2702,1814,0.12235902064300594,288,170,0.11117183928769546,2414,1644,0.12351584596563538,296,0.8,0.1,7743,804,6939
5000,2840,1588,0.15638453088507273,288,153,0.18303348732767477,2552,1435,0.1535432135779521,297,0.8,0.3,7648,765,6883
5000,3029,1740,0.13114482319144716,298,176,0.12907882595693956,2731,1564,0.13137731392883423,298,0.8,0.5,7543,735,6808
5000,4225,1664,0.15876698009875548,456,167,0.14064820138232187,3769,1497,0.16078824666231215,299,0.8,0.7,6236,613,5623
5000,10481,11,0.1726889028276809,1046,1,0.11878220144186752,9435,10,0.17807957296626226,300,0.8,0.9,80,5,75
5000,2004,2919,0.09999999999999995,222,356,0.10000000000000002,1782,2563,0.10000000000000007,301,0.0,0.1,8477,883,7594
5000,847,727,0.3000000000000003,78,76,0.30000000000000004,769,651,0.3000000000000003,302,0.0,0.3,9595,997,8598
5000,1727,487,0.5,181,61,0.5,1546,426,0.5,303,0.0,0.5,8763,854,7909
1140,2690,0,0.0,268,0,0.0,2422,0,0.0,304,0.0,0.7,50,4,46
959,2296,0,0.0,235,0,0.0,2061,0,0.0,305,0.0,0.9,91,19,72
5000,2702,2054,0.12821841986003799,266,203,0.12785898900110318,2436,1851,0.1282578388035084,306,0.8,0.1,7788,782,7006
5000,2170,1795,0.11208965897683255,207,156,0.09421407605692975,1963,1639,0.113791056741021,307,0.8,0.3,8400,821,7579
5000,4570,1763,0.1570273137745632,465,162,0.14894606789551415,4105,1601,0.15784502884789603,308,0.8,0.5,6000,560,5440
5000,4022,1585,0.15663511216322076,400,152,0.17228538619169223,3622,1433,0.15497506913996348,309,0.8,0.7,6442,678,5764
601,1690,0,0.0,176,0,0.0,1514,0,0.0,310,0.8,0.9,25,0,25
5000,1889,2915,0.09999999999999996,204,294,0.10000000000000005,1685,2621,0.09999999999999992,311,0.0,0.1,8540,869,7671
5000,853,721,0.30000000000000043,79,92,0.3000000000000001,774,629,0.3000000000000002,312,0.0,0.3,9610,1019,8591
5000,1786,562,0.5,167,59,0.5,1619,503,0.5,313,0.0,0.5,8663,864,7799
5000,8711,110,0.7000000000000003,847,8,0.7000000000000001,7864,102,0.7000000000000001,314,0.0,0.7,1714,196,1518
881,2241,0,0.0,236,0,0.0,2005,0,0.0,315,0.0,0.9,38,2,36
5000,4207,1615,0.15408014090000663,410,139,0.16864103030181302,3797,1476,0.15270889183032427,316,0.8,0.1,6096,586,5510
5000,2294,1724,0.12505335497004513,235,166,0.12269594168331624,2059,1558,0.12530452994154512,317,0.8,0.3,8035,779,7256
5000,4676,1751,0.16175199271344284,467,176,0.14192806015636483,4209,1575,0.16396723851029718,318,0.8,0.5,5985,600,5385
5000,2302,1649,0.13224300032515496,232,170,0.12942655701491285,2070,1479,0.13256672944127476,319,0.8,0.7,8183,833,7350
5000,9161,497,0.1557985686190991,954,26,0.10391076760293363,8207,471,0.15866286336733756,320,0.8,0.9,1482,93,1389
5000,1885,2800,0.09999999999999994,221,273,0.10000000000000009,1664,2527,0.10000000000000007,321,0.0,0.1,8737,840,7897
5000,890,698,0.3000000000000003,102,80,0.3000000000000001,788,618,0.30000000000000027,322,0.0,0.3,9531,983,8548
1499,3406,0,0.0,347,0,0.0,3059,0,0.0,323,0.0,0.5,70,1,69
2947,6111,0,0.0,627,0,0.0,5484,0,0.0,324,0.0,0.7,255,17,238
2338,4894,0,0.0,504,0,0.0,4390,0,0.0,325,0.0,0.9,204,24,180
5000,3299,1895,0.13887746156562483,318,208,0.1643058479796982,2981,1687,0.1357422485400603,326,0.8,0.1,7317,758,6559
5000,3146,1710,0.13873454559577977,341,203,0.1421991561318675,2805,1507,0.13826784623358615,327,0.8,0.3,7399,724,6675
5000,3109,1870,0.1341445008256997,314,180,0.12521241906943567,2795,1690,0.13509584681157397,328,0.8,0.5,7322,682,6640
5000,7628,923,0.22141293742770662,793,106,0.2743393075064174,6835,817,0.21454611340280655,329,0.8,0.7,2967,269,2698
5000,9480,260,0.2308431550896336,978,28,0.1953897477799715,8502,232,0.23512201459252383,330,0.8,0.9,822,70,752
5000,1710,2892,0.09999999999999999,174,313,0.10000000000000006,1536,2579,0.10000000000000003,331,0.0,0.1,8894,893,8001
5000,1015,603,0.3000000000000003,127,54,0.3,888,549,0.30000000000000016,332,0.0,0.3,9290,906,8384
5000,5431,525,0.5,539,50,0.5,4892,475,0.5,333,0.0,0.5,5015,483,4532
2101,4387,0,0.0,423,0,0.0,3964,0,0.0,334,0.0,0.7,230,16,214
1025,2504,0,0.0,235,0,0.0,2269,0,0.0,335,0.0,0.9,31,3,28
5000,2771,1984,0.12776351864848845,276,188,0.09932303126615666,2495,1796,0.13074058525643853,336,0.8,0.1,7612,733,6879
5000,3141,1949,0.13653250037505862,292,198,0.13022266632087512,2849,1751,0.1372460053109399,337,0.8,0.3,7235,728,6507
5000,3014,1830,0.12876494008554557,298,178,0.12248997295068975,2716,1652,0.12944105639910752,338,0.8,0.5,7324,706,6618
5000,4268,1803,0.14649611749125482,396,176,0.1311605671654681,3872,1627,0.14815503381414258,339,0.8,0.7,6378,607,5771
5000,7275,919,0.16675907609396953,685,88,0.15118414391311602,6590,831,0.16840840705896964,340,0.8,0.9,3190,287,2903
5000,3387,3112,0.09999999999999992,359,334,0.10000000000000006,3028,2778,0.09999999999999998,341,0.0,0.1,7182,703,6479
5000,839,718,0.3000000000000004,58,84,0.30000000000000004,781,634,0.3000000000000003,342,0.0,0.3,9708,1013,8695
5000,5996,637,0.5,632,65,0.5,5364,572,0.5,343,0.0,0.5,4509,388,4121
1737,3800,0,0.0,393,0,0.0,3407,0,0.0,344,0.0,0.7,186,21,165
581,1566,0,0.0,168,0,0.0,1398,0,0.0,345,0.0,0.9,39,2,37
5000,2198,1997,0.11914543338232705,218,184,0.10675115843842997,1980,1813,0.12040331898060454,346,0.8,0.1,8331,795,7536
5000,3558,1887,0.15392549221444948,366,215,0.14609611042574558,3192,1672,0.15493226080570024,347,0.8,0.3,7083,735,6348
5000,3773,1743,0.13967788658329938,415,167,0.12459226693752636,3358,1576,0.14127642622850506,348,0.8,0.5,6482,616,5866
5000,8664,540,0.170244666723208,904,36,0.18753908279759457,7760,504,0.16900935128932326,349,0.8,0.7,1827,133,1694
1382,3129,0,0.0,295,0,0.0,2834,0,0.0,350,0.8,0.9,102,8,94
5000,1690,2889,0.09999999999999999,159,255,0.10000000000000009,1531,2634,0.10000000000000003,351,0.0,0.1,8889,863,8026
5000,912,665,0.3000000000000003,101,52,0.3,811,613,0.3000000000000002,352,0.0,0.3,9729,925,8804
5000,1969,488,0.5,201,47,0.5,1768,441,0.5,353,0.0,0.5,8557,829,7728
2510,5117,0,0.0,536,0,0.0,4581,0,0.0,354,0.0,0.7,257,17,240
677,1767,0,0.0,165,0,0.0,1602,0,0.0,355,0.0,0.9,59,4,55
5000,3821,1830,0.12876172028979083,476,168,0.12437229432823042,3345,1662,0.12920541677687997,356,0.8,0.1,6700,632,6068
5000,2616,1820,0.11546909219447192,292,196,0.10735017357074544,2324,1624,0.11644896168354238,357,0.8,0.3,7591,726,6865
5000,2450,1724,0.1077202227279635,256,180,0.10874608708978695,2194,1544,0.10760062714174064,358,0.8,0.5,8019,767,7252
5000,3074,1690,0.1319301460225831,319,167,0.12913774409580192,2755,1523,0.13223633848599245,359,0.8,0.7,7306,712,6594
1658,3754,0,0.0,378,0,0.0,3376,0,0.0,360,0.8,0.9,132,10,122
5000,2171,2963,0.09999999999999998,228,260,0.10000000000000003,1943,2703,0.10000000000000002,361,0.0,0.1,8390,768,7622
5000,926,614,0.3000000000000002,75,59,0.30000000000000004,851,555,0.30000000000000027,362,0.0,0.3,9380,915,8465
5000,3611,713,0.5,357,94,0.5,3254,619,0.5,363,0.0,0.5,6933,702,6231
5000,8598,80,0.7000000000000005,860,4,0.7,7738,76,0.7000000000000004,364,0.0,0.7,2016,230,1786
1283,2946,0,0.0,278,0,0.0,2668,0,0.0,365,0.0,0.9,99,11,88
5000,5292,1647,0.1520400519065399,535,172,0.11773572377743029,4757,1475,0.15604028542396828,366,0.8,0.1,5135,519,4616
5000,3291,1627,0.14707844252237917,343,159,0.1644726484754004,2948,1468,0.1451944651746064,367,0.8,0.3,7144,712,6432
5000,3650,1888,0.16133902682210666,407,181,0.18340867078601064,3243,1707,0.15899889468533646,368,0.8,0.5,6689,643,6046
5000,5676,1244,0.16007052122753967,538,144,0.1800700018178309,5138,1100,0.15745240740481067,369,0.8,0.7,4753,486,4267
2486,5499,0,0.0,534,0,0.0,4965,0,0.0,370,0.8,0.9,46,1,45
5000,1594,2675,0.09999999999999996,141,264,0.10000000000000005,1453,2411,0.10000000000000007,371,0.0,0.1,8890,911,7979
5000,1065,637,0.3000000000000003,115,59,0.30000000000000004,950,578,0.3000000000000001,372,0.0,0.3,9590,901,8689
5000,1859,559,0.5,192,56,0.5,1667,503,0.5,373,0.0,0.5,8637,869,7768
5000,10078,10,0.7000000000000001,1049,2,0.7,9029,8,0.7000000000000001,374,0.0,0.7,457,49,408
1323,2900,0,0.0,285,0,0.0,2615,0,0.0,375,0.0,0.9,116,22,94
5000,4000,1865,0.1694606159386545,414,178,0.17245952332952513,3586,1687,0.16914419298929176,376,0.8,0.1,6648,640,6008
5000,8438,707,0.2378148116794072,794,83,0.2682869815135243,7644,624,0.23376162242262571,377,0.8,0.3,1932,195,1737
5000,2181,1731,0.1232922606328758,228,156,0.11771946340411517,1953,1575,0.1238442329298197,378,0.8,0.5,8223,827,7396
5000,5798,1442,0.20438790652829925,565,147,0.19415981843273153,5233,1295,0.20554893274455283,379,0.8,0.7,4670,481,4189
1033,2432,0,0.0,253,0,0.0,2179,0,0.0,380,0.8,0.9,51,0,51
5000,1820,2811,0.09999999999999992,163,261,0.10000000000000003,1657,2550,0.10000000000000009,381,0.0,0.1,8504,826,7678
5000,852,687,0.30000000000000043,79,74,0.30000000000000004,773,613,0.3000000000000002,382,0.0,0.3,9608,947,8661
5000,1717,532,0.5,185,64,0.5,1532,468,0.5,383,0.0,0.5,8695,848,7847
816,2043,0,0.0,213,0,0.0,1830,0,0.0,384,0.0,0.7,68,5,63
1584,3432,0,0.0,343,0,0.0,3089,0,0.0,385,0.0,0.9,137,15,122
5000,2589,1969,0.13620973731982827,269,168,0.1293081234692484,2320,1801,0.136853530283125,386,0.8,0.1,8053,781,7272
5000,3533,1826,0.16012901282590095,337,172,0.18931220383799297,3196,1654,0.15709424326478855,387,0.8,0.3,6954,711,6243
5000,4262,1649,0.16176031041251013,413,165,0.16111216029900094,3849,1484,0.16183237562054847,388,0.8,0.5,6072,609,5463
5000,10487,5,0.05266827100156731,1056,0,0.0,9431,5,0.05266827100156731,389,0.8,0.7,93,3,90
1252,2792,0,0.0,270,0,0.0,2522,0,0.0,390,0.8,0.9,124,19,105
5000,1782,2662,0.09999999999999998,194,282,0.10000000000000006,1588,2380,0.10000000000000006,391,0.0,0.1,8702,866,7836
5000,822,662,0.30000000000000027,88,53,0.3,734,609,0.30000000000000043,392,0.0,0.3,9647,1037,8610
5000,1973,504,0.5,217,53,0.5,1756,451,0.5,393,0.0,0.5,8545,806,7739
1323,3028,0,0.0,314,0,0.0,2714,0,0.0,394,0.0,0.7,123,7,116
1112,2615,0,0.0,252,0,0.0,2363,0,0.0,395,0.0,0.9,121,17,104
5000,4619,1769,0.1499030400380378,460,189,0.1751436212660411,4159,1580,0.14688375532152348,396,0.8,0.1,5774,572,5202
5000,2557,1832,0.12089255904786583,278,208,0.13258342114603125,2279,1624,0.1193952072520417,397,0.8,0.3,7916,793,7123
5000,3831,1779,0.15966363432029654,385,172,0.12775455129777266,3446,1607,0.16307891887528975,398,0.8,0.5,6525,666,5859
5000,6416,1120,0.20217949656959605,684,113,0.21266111668956528,5732,1007,0.20100330682425707,399,0.8,0.7,3996,405,3591
5000,3272,1590,0.13225578215149222,344,142,0.12287977735792469,2928,1448,0.13317525223483934,400,0.8,0.9,7030,698,6332
5000,2704,3035,0.09999999999999996,237,311,0.10000000000000005,2467,2724,0.09999999999999996,401,0.0,0.1,7829,801,7028
5000,959,696,0.3000000000000003,103,73,0.30000000000000004,856,623,0.3000000000000004,402,0.0,0.3,9454,953,8501
5000,1677,428,0.5,167,38,0.5,1510,390,0.5,403,0.0,0.5,8764,877,7887
4067,7603,0,0.0,728,0,0.0,6875,0,0.0,404,0.0,0.7,947,91,856
1683,3650,0,0.0,351,0,0.0,3299,0,0.0,405,0.0,0.9,174,13,161
5000,3336,2028,0.13524407565200083,300,221,0.1271722917061349,3036,1807,0.13623127224969667,406,0.8,0.1,7187,755,6432
5000,3076,1782,0.1277532442526888,287,168,0.11440760402872233,2789,1614,0.12914238152507196,407,0.8,0.3,7281,688,6593
5000,5433,1535,0.15496358371402338,578,145,0.14510614967918567,4855,1390,0.15599187719247773,408,0.8,0.5,5184,457,4727
5000,3415,1634,0.14754797771155198,345,167,0.1623158211612064,3070,1467,0.14586683943200715,409,0.8,0.7,7081,692,6389
5000,10218,138,0.21161205308398098,1006,21,0.17968819756166723,9212,117,0.21734197587003729,410,0.8,0.9,332,37,295
5000,1895,2938,0.09999999999999991,184,271,0.10000000000000009,1711,2667,0.09999999999999998,411,0.0,0.1,8697,859,7838
5000,1013,622,0.3000000000000004,105,59,0.30000000000000004,908,563,0.3000000000000001,412,0.0,0.3,9379,954,8425
5000,3662,603,0.5,425,54,0.5,3237,549,0.5,413,0.0,0.5,6785,621,6164
4543,8769,0,0.0,918,0,0.0,7851,0,0.0,414,0.0,0.7,627,57,570
726,1919,0,0.0,180,0,0.0,1739,0,0.0,415,0.0,0.9,51,4,47
5000,3287,1957,0.14132524871576788,316,181,0.16051022503852616,2971,1776,0.13937002308827953,416,0.8,0.1,7435,704,6731
5000,2906,1799,0.13055354117605533,304,181,0.1317558765784443,2602,1618,0.13041904012053468,417,0.8,0.3,7496,748,6748
5000,2912,1766,0.12881576897150826,297,194,0.12185007196962871,2615,1572,0.12967540333433564,418,0.8,0.5,7562,769,6793
5000,10097,71,0.12801337510316144,1053,4,0.07824066470705884,9044,67,0.1309848802014362,419,0.8,0.7,392,22,370
5000,10205,24,0.22142855338872178,1039,0,0.0,9166,24,0.22142855338872178,420,0.8,0.9,186,10,176
5000,1986,2879,0.09999999999999991,221,285,0.10000000000000007,1765,2594,0.09999999999999999,421,0.0,0.1,8330,813,7517
5000,809,698,0.3000000000000003,75,58,0.30000000000000004,734,640,0.3000000000000004,422,0.0,0.3,9662,961,8701
5000,3131,684,0.5,348,70,0.5,2783,614,0.5,423,0.0,0.5,7185,731,6454
1752,3862,0,0.0,368,0,0.0,3494,0,0.0,424,0.0,0.7,84,8,76
951,2254,0,0.0,248,0,0.0,2006,0,0.0,425,0.0,0.9,81,6,75
5000,2215,1576,0.1225550843884924,246,156,0.12350994968720436,1969,1420,0.12245018369370435,426,0.8,0.1,8050,809,7241
5000,2585,1602,0.11651618495661623,270,129,0.11121188314830237,2315,1473,0.11698071647954392,427,0.8,0.3,7817,783,7034
5000,5120,1381,0.15077361639433678,581,148,0.1380412923971963,4539,1233,0.15230190832586704,428,0.8,0.5,5291,528,4763
5000,9963,148,0.23451578616239638,992,23,0.22577237719318188,8971,125,0.23612457341273183,429,0.8,0.7,508,52,456
5000,9118,461,0.1493469935850971,894,39,0.1549903431307415,8224,422,0.14882545180244272,430,0.8,0.9,1424,139,1285
5000,1837,3021,0.09999999999999996,188,303,0.10000000000000009,1649,2718,0.09999999999999998,431,0.0,0.1,8667,909,7758
5000,940,681,0.3000000000000003,112,59,0.30000000000000004,828,622,0.3000000000000004,432,0.0,0.3,9477,936,8541
5000,1893,434,0.5,201,40,0.5,1692,394,0.5,433,0.0,0.5,8447,818,7629
2780,5551,0,0.0,554,0,0.0,4997,0,0.0,434,0.0,0.7,396,34,362
1406,3200,0,0.0,310,0,0.0,2890,0,0.0,435,0.0,0.9,110,7,103
5000,2633,2060,0.11296634987385767,253,200,0.11533513749379934,2380,1860,0.11271164152762737,436,0.8,0.1,7855,789,7066
5000,2492,1656,0.1477716683883442,237,146,0.1531606784455049,2255,1510,0.14725061178679094,437,0.8,0.3,7768,776,6992
5000,5399,1410,0.1612010363669063,596,138,0.16432436824758948,4803,1272,0.16086218432324728,438,0.8,0.5,5162,496,4666
5000,4376,1757,0.1633718258009409,429,181,0.149427814565206,3947,1576,0.16497326363956263,439,0.8,0.7,6195,582,5613
5000,8456,674,0.15824834649997027,852,75,0.1626249038296489,7604,599,0.1577003635288085,440,0.8,0.9,1953,197,1756
5000,2941,2948,0.0999999999999999,324,348,0.10000000000000007,2617,2600,0.09999999999999998,441,0.0,0.1,7278,784,6494
5000,970,650,0.3000000000000003,75,70,0.3,895,580,0.30000000000000016,442,0.0,0.3,9661,984,8677
5000,1811,575,0.5,217,59,0.5,1594,516,0.5,443,0.0,0.5,8629,813,7816
5000,9387,33,0.6999999999999997,957,4,0.7,8430,29,0.6999999999999997,444,0.0,0.7,1183,122,1061
2122,4396,0,0.0,439,0,0.0,3957,0,0.0,445,0.0,0.9,269,36,233
5000,2453,1722,0.10957501190518622,266,179,0.11331338297421346,2187,1543,0.10914133178765166,446,0.8,0.1,8038,736,7302
5000,2047,1634,0.12233305140798846,175,158,0.1260349678576592,1872,1476,0.12193677579887739,447,0.8,0.3,8429,851,7578
5000,3465,1781,0.12680724453991304,361,177,0.12691592048788014,3104,1604,0.12679525224390917,448,0.8,0.5,6982,669,6313
5000,6495,1241,0.1810416506839981,695,133,0.15360251964231397,5800,1108,0.1843353369913483,449,0.8,0.7,4109,408,3701
5000,8502,476,0.18428331135284834,918,59,0.14949931953510806,7584,417,0.1892047874133919,450,0.8,0.9,1892,148,1744
5000,3056,3076,0.09999999999999988,340,330,0.10000000000000005,2716,2746,0.09999999999999992,451,0.0,0.1,7234,723,6511
5000,957,653,0.3000000000000004,95,66,0.29999999999999993,862,587,0.30000000000000027,452,0.0,0.3,9646,970,8676
5000,3277,556,0.5,345,52,0.5,2932,504,0.5,453,0.0,0.5,7319,660,6659
5000,9371,75,0.7000000000000004,948,8,0.7000000000000001,8423,67,0.7000000000000001,454,0.0,0.7,1057,111,946
2420,5027,0,0.0,508,0,0.0,4519,0,0.0,455,0.0,0.9,395,51,344
5000,2201,1795,0.12353261657384791,200,161,0.13723266710338866,2001,1634,0.12218273399413182,456,0.8,0.1,8244,799,7445
5000,2340,1855,0.12939660071257164,203,166,0.13145255888630714,2137,1689,0.12919453495955802,457,0.8,0.3,8003,821,7182
5000,4318,1641,0.16488075815516393,446,159,0.1819553716262534,3872,1482,0.16304886642648425,458,0.8,0.5,6335,622,5713
5000,6968,1328,0.19733210174952875,675,140,0.21087462314642139,6293,1188,0.19573618171959192,459,0.8,0.7,3650,344,3306
5000,4559,1415,0.18248261707423122,472,139,0.21207281329944166,4087,1276,0.17925923362963542,460,0.8,0.9,5764,549,5215
5000,2681,3188,0.0999999999999999,243,331,0.10000000000000005,2438,2857,0.09999999999999994,461,0.0,0.1,7843,794,7049
5000,878,707,0.3000000000000002,80,72,0.30000000000000004,798,635,0.3000000000000003,462,0.0,0.3,9661,969,8692
5000,2521,797,0.5,241,95,0.5,2280,702,0.5,463,0.0,0.5,7943,777,7166
1096,2556,0,0.0,251,0,0.0,2305,0,0.0,464,0.0,0.7,49,5,44
3337,6647,0,0.0,640,0,0.0,6007,0,0.0,465,0.0,0.9,580,77,503
5000,3480,1824,0.14020400879667827,349,200,0.134914356054607,3131,1624,0.14085544386343582,466,0.8,0.1,7042,701,6341
5000,3887,1885,0.14372738818190553,405,200,0.1340906173539169,3482,1685,0.14487121854724533,467,0.8,0.3,6743,664,6079
5000,2222,1882,0.12859391828500014,209,192,0.12444353549832021,2013,1690,0.12906544106313178,468,0.8,0.5,8332,867,7465
5000,8409,581,0.1841053360316039,893,49,0.17948904304647623,7516,532,0.18453052091181305,469,0.8,0.7,2098,190,1908
1558,3543,0,0.0,373,0,0.0,3170,0,0.0,470,0.8,0.9,73,3,70
5000,1657,2775,0.1,161,289,0.10000000000000009,1496,2486,0.10000000000000007,471,0.0,0.1,8603,877,7726
5000,1122,732,0.30000000000000043,116,77,0.30000000000000004,1006,655,0.3000000000000004,472,0.0,0.3,9441,969,8472
5000,1503,541,0.5,154,60,0.5,1349,481,0.5,473,0.0,0.5,9140,967,8173
1442,3283,0,0.0,336,0,0.0,2947,0,0.0,474,0.0,0.7,113,2,111
1864,4161,0,0.0,428,0,0.0,3733,0,0.0,475,0.0,0.9,79,8,71
5000,2569,1851,0.1220611397561427,237,181,0.10967336892568767,2332,1670,0.12340376641501238,476,0.8,0.1,7761,725,7036
5000,2226,1791,0.11644426780573883,214,157,0.11696508559653798,2012,1634,0.11639422594946254,477,0.8,0.3,8290,835,7455
5000,7389,864,0.19755969648767266,736,73,0.23456785580798112,6653,791,0.19414427849730279,478,0.8,0.5,3218,297,2921
5000,9991,62,0.13573679241926948,1026,1,0.1145975931278923,8965,61,0.13608333666994776,479,0.8,0.7,257,5,252
5000,7965,705,0.1944714212369635,769,81,0.18188336284145853,7196,624,0.19610544804791835,480,0.8,0.9,2627,290,2337
5000,1839,2868,0.09999999999999992,166,314,0.10000000000000006,1673,2554,0.10000000000000007,481,0.0,0.1,8592,888,7704
5000,908,701,0.3000000000000004,93,85,0.30000000000000004,815,616,0.30000000000000027,482,0.0,0.3,9531,949,8582
5000,1341,519,0.5,110,56,0.5,1231,463,0.5,483,0.0,0.5,9201,889,8312
4623,8586,0,0.0,960,0,0.0,7626,0,0.0,484,0.0,0.7,1152,87,1065
464,1402,0,0.0,129,0,0.0,1273,0,0.0,485,0.0,0.9,14,0,14
5000,2485,1896,0.11925434694592364,215,203,0.12517663117501007,2270,1693,0.11854423253452104,486,0.8,0.1,7995,811,7184
5000,2456,2023,0.12441423646978433,218,208,0.11319468592245145,2238,1815,0.12570000314407923,487,0.8,0.3,8114,840,7274
5000,7395,1086,0.17618259380495863,749,103,0.1601648173300231,6646,983,0.17786095695543516,488,0.8,0.5,3071,282,2789
5000,9662,222,0.21212529556451326,1009,30,0.2510653385330311,8653,192,0.20604091385068235,489,0.8,0.7,676,51,625
1126,2676,0,0.0,276,0,0.0,2400,0,0.0,490,0.8,0.9,60,5,55
5000,2278,2999,0.09999999999999992,240,303,0.10000000000000009,2038,2696,0.10000000000000003,491,0.0,0.1,8133,801,7332
5000,955,668,0.3000000000000004,100,69,0.3,855,599,0.30000000000000027,492,0.0,0.3,9598,943,8655
5000,1913,745,0.5,170,71,0.5,1743,674,0.5,493,0.0,0.5,8553,880,7673
2454,5285,0,0.0,558,0,0.0,4727,0,0.0,494,0.0,0.7,130,5,125
2054,4456,0,0.0,448,0,0.0,4008,0,0.0,495,0.0,0.9,135,6,129
5000,2344,1995,0.11787984117438381,224,228,0.11177507707000238,2120,1767,0.11866755267172335,496,0.8,0.1,8151,843,7308
5000,4122,1979,0.1506921338991137,376,217,0.1399268543627829,3746,1762,0.1520179373380375,497,0.8,0.3,6399,700,5699
2024,4544,0,0.0,460,0,0.0,4084,0,0.0,498,0.8,0.5,26,0,26
5000,4201,1761,0.1427746857925394,426,183,0.13041845377929215,3775,1578,0.1442076328511099,499,0.8,0.7,6321,659,5662
5000,3525,1704,0.15733970975105946,336,183,0.14588888957903678,3189,1521,0.15871742184276239,500,0.8,0.9,6932,726,6206
5000,1925,2997,0.0999999999999999,223,323,0.10000000000000002,1702,2674,0.09999999999999995,501,0.0,0.1,8591,870,7721
5000,869,614,0.3000000000000002,94,50,0.3,775,564,0.30000000000000016,502,0.0,0.3,9463,930,8533
5000,1188,410,0.5,144,39,0.5,1044,371,0.5,503,0.0,0.5,9129,918,8211
5000,8052,18,0.7,840,0,0.0,7212,18,0.7,504,0.0,0.7,2322,270,2052
1612,3430,0,0.0,357,0,0.0,3073,0,0.0,505,0.0,0.9,219,20,199
5000,2698,1929,0.15212697935383235,242,212,0.16024276796027692,2456,1717,0.1511249134338753,506,0.8,0.1,7861,785,7076
5000,2654,1945,0.10986004891245045,259,219,0.1057131366405229,2395,1726,0.11038622144289781,507,0.8,0.3,7927,857,7070
5000,5293,1673,0.1490195468789642,547,169,0.13439614704942487,4746,1504,0.1506627347587462,508,0.8,0.5,5165,489,4676
5000,7578,870,0.21073407168420144,735,100,0.19490271317269336,6843,770,0.21279009227011156,509,0.8,0.7,2643,269,2374
5000,4798,1605,0.1604951581328889,479,162,0.1548181238466424,4319,1443,0.16113249670140722,510,0.8,0.9,5688,541,5147
5000,2050,3055,0.09999999999999992,197,281,0.10000000000000006,1853,2774,0.09999999999999999,511,0.0,0.1,8407,850,7557
5000,935,638,0.3000000000000004,96,62,0.3000000000000001,839,576,0.3000000000000004,512,0.0,0.3,9751,967,8784
5000,1727,326,0.5,174,33,0.5,1553,293,0.5,513,0.0,0.5,8665,880,7785
2362,4881,0,0.0,522,0,0.0,4359,0,0.0,514,0.0,0.7,282,24,258
2586,5504,0,0.0,568,0,0.0,4936,0,0.0,515,0.0,0.9,101,10,91
5000,6342,1320,0.18175930321905323,659,156,0.1769298539050248,5683,1164,0.18240654900340758,516,0.8,0.1,3964,378,3586
5000,2598,1732,0.13329091205086205,229,197,0.15995076067241895,2369,1535,0.12986942007793262,517,0.8,0.3,7847,808,7039
5000,3299,1726,0.15892336131871718,312,175,0.1618734831242391,2987,1551,0.15859049780100837,518,0.8,0.5,7256,760,6496
5000,10652,1,0.025192262210202432,1057,0,0.0,9595,1,0.025192262210202432,519,0.8,0.7,75,3,72
5000,5374,1533,0.1708278991708674,520,179,0.1443879969475527,4854,1354,0.17432327767749461,520,0.8,0.9,5131,538,4593
5000,1455,2599,0.09999999999999999,137,257,0.10000000000000009,1318,2342,0.10000000000000006,521,0.0,0.1,8939,920,8019
5000,923,561,0.3000000000000004,117,51,0.3,806,510,0.30000000000000027,522,0.0,0.3,9734,964,8770
5000,8700,207,0.5,865,22,0.5,7835,185,0.5,523,0.0,0.5,1678,121,1557
1270,2938,0,0.0,307,0,0.0,2631,0,0.0,524,0.0,0.7,52,6,46
1207,2693,0,0.0,256,0,0.0,2437,0,0.0,525,0.0,0.9,145,14,131
5000,4777,1730,0.16253976409670598,538,171,0.1400137372404403,4239,1559,0.16501054702962542,526,0.8,0.1,5741,544,5197
5000,2742,1742,0.1361643912241285,255,190,0.14711644762415765,2487,1552,0.13482361112360947,527,0.8,0.3,7806,787,7019
5000,2165,1832,0.11827363680017598,193,181,0.10911647389213519,1972,1651,0.11927754139518226,528,0.8,0.5,8276,874,7402
5000,3833,1641,0.1678332807725317,372,175,0.19111433994627058,3461,1466,0.16505416388617128,529,0.8,0.7,6544,667,5877
5000,7820,628,0.20326418826903528,785,49,0.16109003611958284,7035,579,0.2068333306789199,530,0.8,0.9,2658,258,2400
5000,1570,2729,0.09999999999999995,123,282,0.10000000000000006,1447,2447,0.10000000000000005,531,0.0,0.1,8880,939,7941
5000,1069,596,0.3000000000000002,132,61,0.30000000000000004,937,535,0.30000000000000016,532,0.0,0.3,9422,930,8492
5000,1737,606,0.5,150,73,0.5,1587,533,0.5,533,0.0,0.5,8725,876,7849
2832,5813,0,0.0,611,0,0.0,5202,0,0.0,534,0.0,0.7,307,16,291
1729,3868,0,0.0,382,0,0.0,3486,0,0.0,535,0.0,0.9,91,7,84
5000,3828,1898,0.15193826507678188,346,199,0.15894767573698976,3482,1699,0.15111726877226075,536,0.8,0.1,6704,713,5991
5000,4744,1592,0.1859388864708001,464,157,0.2005723060680271,4280,1435,0.184337878194309,537,0.8,0.3,5909,562,5347
5000,2369,1774,0.11494385862163593,238,150,0.08944177020667131,2131,1624,0.11729934708360927,538,0.8,0.5,8195,768,7427
5000,5232,1313,0.2089030654625847,519,121,0.24632197967530872,4713,1192,0.20510466896951446,539,0.8,0.7,4973,497,4476
5000,10612,5,0.045862959351285634,1060,0,0.0,9552,5,0.045862959351285634,540,0.8,0.9,90,9,81
5000,1500,2511,0.10000000000000006,147,248,0.10000000000000005,1353,2263,0.10000000000000006,541,0.0,0.1,8827,918,7909
5000,959,634,0.3000000000000003,87,67,0.3,872,567,0.3000000000000002,542,0.0,0.3,9333,958,8375
5000,5403,732,0.5,535,78,0.5,4868,654,0.5,543,0.0,0.5,4993,512,4481
5000,8747,48,0.6999999999999998,880,3,0.6999999999999998,7867,45,0.6999999999999997,544,0.0,0.7,1798,201,1597
1233,2916,0,0.0,270,0,0.0,2646,0,0.0,545,0.0,0.9,111,12,99
5000,3001,1942,0.15313356320232271,299,195,0.16219535417406372,2702,1747,0.1521220868202451,546,0.8,0.1,7397,759,6638
5000,2521,2145,0.12097835196462829,261,231,0.11183926675136883,2260,1914,0.12208134500760787,547,0.8,0.3,7890,810,7080
5000,2991,1860,0.13001418128740463,322,173,0.15829587144637317,2669,1687,0.12711392497590399,548,0.8,0.5,7426,771,6655
5000,6335,1365,0.1803881751344517,596,122,0.19823626298218758,5739,1243,0.17863639177369242,549,0.8,0.7,4050,399,3651
5000,3606,1694,0.1528367163895945,307,171,0.16226418096283457,3299,1523,0.15177821577106262,550,0.8,0.9,6776,684,6092
5000,2782,3064,0.0999999999999999,298,323,0.10000000000000002,2484,2741,0.09999999999999992,551,0.0,0.1,7766,776,6990
5000,963,670,0.30000000000000043,88,75,0.30000000000000004,875,595,0.3000000000000002,552,0.0,0.3,9460,981,8479
5000,1803,464,0.5,175,58,0.5,1628,406,0.5,553,0.0,0.5,8589,891,7698
5000,9172,28,0.6999999999999998,901,0,0.0,8271,28,0.6999999999999998,554,0.0,0.7,1353,127,1226
757,1895,0,0.0,191,0,0.0,1704,0,0.0,555,0.0,0.9,99,11,88
5000,2688,1863,0.12925599218883715,285,174,0.12950317570288866,2403,1689,0.1292305274573718,556,0.8,0.1,7762,745,7017
5000,8308,722,0.2133721934364609,841,74,0.25288229477298263,7467,648,0.2088602374196359,557,0.8,0.3,2059,184,1875
5000,4913,1631,0.16462932331360838,508,169,0.16050799430979748,4405,1462,0.16510572864989015,558,0.8,0.5,5551,545,5006
5000,7584,916,0.18186898350299358,751,94,0.23179228839685437,6833,822,0.1761599924324061,559,0.8,0.7,3034,264,2770
450,1434,0,0.0,153,0,0.0,1281,0,0.0,560,0.8,0.9,26,0,26
5000,1447,2588,0.1,134,241,0.10000000000000009,1313,2347,0.10000000000000006,561,0.0,0.1,9072,898,8174
5000,846,666,0.3000000000000004,84,60,0.30000000000000004,762,606,0.3000000000000004,562,0.0,0.3,9691,974,8717
5000,1575,437,0.5,163,38,0.5,1412,399,0.5,563,0.0,0.5,8877,862,8015
5000,7606,66,0.7000000000000001,764,5,0.7,6842,61,0.7000000000000004,564,0.0,0.7,2764,250,2514
1527,3478,0,0.0,351,0,0.0,3127,0,0.0,565,0.0,0.9,127,11,116
5000,2131,1607,0.11919393711959117,212,152,0.1577332018032939,1919,1455,0.11516784211483322,566,0.8,0.1,8240,789,7451
5000,3587,1784,0.14567473643704051,330,190,0.14611511652895626,3257,1594,0.14562224445619737,567,0.8,0.3,6848,704,6144
5000,4981,1713,0.1463095312687037,496,192,0.13366027358131036,4485,1521,0.14790628174600778,568,0.8,0.5,5417,547,4870
5000,9260,222,0.1958241684876379,967,10,0.08816928321667536,8293,212,0.2009022291136267,569,0.8,0.7,1204,82,1122
5000,5480,1399,0.18672717975997266,576,125,0.19775527288434214,4904,1274,0.18564514550522673,570,0.8,0.9,4894,474,4420
5000,2171,3121,0.0999999999999999,199,315,0.10000000000000006,1972,2806,0.09999999999999992,571,0.0,0.1,8389,832,7557
5000,948,695,0.30000000000000027,101,68,0.3,847,627,0.30000000000000016,572,0.0,0.3,9763,986,8777
5000,2822,714,0.5,288,71,0.5,2534,643,0.5,573,0.0,0.5,7697,782,6915
1877,4102,0,0.0,388,0,0.0,3714,0,0.0,574,0.0,0.7,183,11,172
1081,2615,0,0.0,263,0,0.0,2352,0,0.0,575,0.0,0.9,49,2,47
5000,4268,1687,0.16143484159494265,444,153,0.17218100739844922,3824,1534,0.1603630271438757,576,0.8,0.1,6111,619,5492
5000,2168,1762,0.11156127811498295,214,143,0.11653477566055208,1954,1619,0.11112198833794998,577,0.8,0.3,8442,831,7611
5000,6445,1261,0.1842166473237091,622,109,0.1454781535214879,5823,1152,0.18788200828242618,578,0.8,0.5,3930,342,3588
5000,3202,1744,0.14158945500629208,333,178,0.12583714343541827,2869,1566,0.1433799476369533,579,0.8,0.7,7182,706,6476
5000,8923,511,0.19705820390083084,868,65,0.17741844736857934,8055,446,0.19992050025642805,580,0.8,0.9,1578,166,1412
5000,1473,2467,0.10000000000000006,157,243,0.10000000000000002,1316,2224,0.10000000000000006,581,0.0,0.1,8858,888,7970
5000,906,681,0.3000000000000003,83,65,0.3000000000000001,823,616,0.30000000000000027,582,0.0,0.3,9543,961,8582
5000,1710,371,0.5,164,30,0.5,1546,341,0.5,583,0.0,0.5,8700,888,7812
2605,5500,0,0.0,531,0,0.0,4969,0,0.0,584,0.0,0.7,308,18,290
930,2320,0,0.0,217,0,0.0,2103,0,0.0,585,0.0,0.9,22,1,21
5000,3918,1968,0.1339872625001199,394,191,0.13032654980876354,3524,1777,0.13438073246300625,586,0.8,0.1,6749,622,6127
5000,3697,1790,0.15808918862949434,350,179,0.1432589770129903,3347,1611,0.15973698992021695,587,0.8,0.3,6734,678,6056
5000,2719,1733,0.11350375728660045,304,166,0.1260734314713655,2415,1567,0.11217219001495338,588,0.8,0.5,7739,784,6955
5000,2693,1606,0.148855089917044,221,174,0.14034746171733564,2472,1432,0.14988883803628228,589,0.8,0.7,7552,772,6780
5000,3821,1677,0.14832719884143825,363,157,0.1270320508485813,3458,1520,0.1505267634696478,590,0.8,0.9,6517,626,5891
5000,1762,2658,0.09999999999999998,187,241,0.10000000000000009,1575,2417,0.10000000000000007,591,0.0,0.1,8563,796,7767
5000,898,673,0.3000000000000005,94,59,0.30000000000000004,804,614,0.3000000000000002,592,0.0,0.3,9690,991,8699
5000,1661,394,0.5,190,21,0.5,1471,373,0.5,593,0.0,0.5,8856,808,8048
2598,5332,0,0.0,584,0,0.0,4748,0,0.0,594,0.0,0.7,392,18,374
925,2320,0,0.0,236,0,0.0,2084,0,0.0,595,0.0,0.9,49,3,46
5000,3523,1773,0.14614788252502725,344,192,0.14845832190185612,3179,1581,0.14586729785687338,596,0.8,0.1,7116,743,6373
5000,2026,1701,0.12393447369169167,200,162,0.11724800157104859,1826,1539,0.12463831286228565,597,0.8,0.3,8611,900,7711
5000,3892,1500,0.14514593854775545,436,144,0.16399360505130212,3456,1356,0.1431444164411841,598,0.8,0.5,6644,630,6014
5000,7156,920,0.19988694398373658,764,97,0.1968812023557193,6392,823,0.20024120514767052,599,0.8,0.7,3495,354,3141
5000,8764,513,0.25483000070565276,873,49,0.30704115051265796,7891,464,0.24931632324758546,600,0.8,0.9,1726,191,1535
5000,1676,2709,0.09999999999999999,211,266,0.10000000000000006,1465,2443,0.10000000000000005,601,0.0,0.1,8722,877,7845
5000,958,690,0.3000000000000002,90,69,0.3,868,621,0.3000000000000003,602,0.0,0.3,9557,975,8582
5000,2830,511,0.5,312,39,0.5,2518,472,0.5,603,0.0,0.5,7404,712,6692
1778,3827,0,0.0,361,0,0.0,3466,0,0.0,604,0.0,0.7,136,6,130
544,1495,0,0.0,135,0,0.0,1360,0,0.0,605,0.0,0.9,32,2,30
5000,2202,1738,0.10534414663091939,215,146,0.11675196215210086,1987,1592,0.1042979524939266,606,0.8,0.1,8312,784,7528
5000,2790,1797,0.1299840157778098,295,166,0.1530545031952726,2495,1631,0.12763594654954563,607,0.8,0.3,7854,706,7148
5000,2473,1673,0.13473292430078396,230,129,0.14036529174511517,2243,1544,0.13426234437829776,608,0.8,0.5,7745,718,7027
5000,2156,1954,0.12328313352170148,162,188,0.1196882313891817,1994,1766,0.12366582978495952,609,0.8,0.7,8319,823,7496
5000,4892,1658,0.1523245397162472,473,154,0.1352401698325944,4419,1504,0.15407387014316376,610,0.8,0.9,5548,561,4987
5000,2329,3207,0.09999999999999995,230,317,0.10000000000000007,2099,2890,0.1,611,0.0,0.1,8278,845,7433
5000,933,674,0.3000000000000002,121,65,0.3000000000000001,812,609,0.30000000000000043,612,0.0,0.3,9570,979,8591
5000,2177,708,0.5,232,72,0.5,1945,636,0.5,613,0.0,0.5,8223,836,7387
3033,5944,0,0.0,559,0,0.0,5385,0,0.0,614,0.0,0.7,677,44,633
1162,2734,0,0.0,284,0,0.0,2450,0,0.0,615,0.0,0.9,75,6,69
5000,3363,1956,0.14033682096901523,329,202,0.12102175286007846,3034,1754,0.1425612472848677,616,0.8,0.1,7032,747,6285
5000,5733,1227,0.16751333168765237,581,116,0.13730306808892104,5152,1111,0.17066759863405453,617,0.8,0.3,4751,431,4320
5000,2587,1711,0.1280988844715766,273,163,0.12217459011379714,2314,1548,0.1287226958283712,618,0.8,0.5,8022,815,7207
5000,4781,1590,0.14077366274049322,501,135,0.14068460537359517,4280,1455,0.14078192579515392,619,0.8,0.7,5681,520,5161
5000,9058,436,0.20041341367097956,910,37,0.16441795257341568,8148,399,0.20375133863491401,620,0.8,0.9,1589,143,1446
5000,1863,2799,0.09999999999999995,197,300,0.10000000000000007,1666,2499,0.10000000000000009,621,0.0,0.1,8609,849,7760
5000,865,689,0.30000000000000043,76,70,0.3,789,619,0.3000000000000003,622,0.0,0.3,9576,964,8612
5000,1243,456,0.5,106,50,0.5,1137,406,0.5,623,0.0,0.5,9268,899,8369
1324,3049,0,0.0,346,0,0.0,2703,0,0.0,624,0.0,0.7,116,5,111
772,1925,0,0.0,218,0,0.0,1707,0,0.0,625,0.0,0.9,53,1,52
5000,2726,1899,0.13263892579241657,282,192,0.13225712840720827,2444,1707,0.13268186961078793,626,0.8,0.1,7702,744,6958
5000,2403,1866,0.10551970778376311,236,187,0.10011779011682852,2167,1679,0.10612135078776358,627,0.8,0.3,7990,785,7205
5000,2982,1669,0.13699442499467918,343,147,0.1267457290116551,2639,1522,0.13798427933732343,628,0.8,0.5,7351,693,6658
5000,9527,237,0.24640790971642232,931,13,0.4002615238560079,8596,224,0.2374789053243928,629,0.8,0.7,994,69,925
1662,3614,0,0.0,413,0,0.0,3201,0,0.0,630,0.8,0.9,165,11,154
5000,1855,2872,0.09999999999999992,181,290,0.10000000000000002,1674,2582,0.10000000000000002,631,0.0,0.1,8587,897,7690
5000,938,1020,0.30000000000000043,73,116,0.3,865,904,0.30000000000000043,632,0.0,0.3,9621,951,8670
5000,9536,200,0.5,919,27,0.5,8617,173,0.5,633,0.0,0.5,928,90,838
5000,5915,234,0.6999999999999995,536,25,0.6999999999999998,5379,209,0.6999999999999993,634,0.0,0.7,4408,530,3878
2166,4558,0,0.0,451,0,0.0,4107,0,0.0,635,0.0,0.9,274,27,247
5000,2778,1959,0.11304374996317695,294,182,0.11296611010895675,2484,1777,0.11305170182219106,636,0.8,0.1,7854,796,7058
5000,3527,1734,0.14088112881524875,378,151,0.1300931350397219,3149,1583,0.14191017939017264,637,0.8,0.3,6958,685,6273
5000,3312,1552,0.13797171235160965,293,151,0.13577797462990504,3019,1401,0.13820815374773918,638,0.8,0.5,7336,712,6624
5000,7300,915,0.2082941142208503,786,89,0.2266392385286578,6514,826,0.2063174603910745,639,0.8,0.7,3103,246,2857
5000,10256,70,0.13977038714901946,1054,9,0.15252064239317734,9202,61,0.13788920194906168,640,0.8,0.9,251,26,225
5000,2686,3173,0.09999999999999991,245,331,0.10000000000000005,2441,2842,0.09999999999999998,641,0.0,0.1,7843,767,7076
5000,899,698,0.3000000000000003,92,73,0.30000000000000004,807,625,0.30000000000000043,642,0.0,0.3,9548,929,8619
5000,2016,689,0.5,172,61,0.5,1844,628,0.5,643,0.0,0.5,8368,838,7530
2427,5023,0,0.0,504,0,0.0,4519,0,0.0,644,0.0,0.7,355,35,320
1779,3889,0,0.0,386,0,0.0,3503,0,0.0,645,0.0,0.9,78,5,73
5000,3961,1901,0.14768517057925507,352,215,0.1349335878465377,3609,1686,0.1493112620902481,646,0.8,0.1,6617,697,5920
5000,8369,706,0.19013392943067256,816,85,0.16196992064235738,7553,621,0.19398890647899264,647,0.8,0.3,2018,201,1817
5000,2977,1815,0.11949492998446891,278,197,0.10878783792735625,2699,1618,0.12079857469105186,648,0.8,0.5,7458,771,6687
5000,5770,1244,0.1798016207129895,529,136,0.16660529723882678,5241,1108,0.1814213860491683,649,0.8,0.7,4736,494,4242
5000,9720,158,0.11636356039764471,1022,21,0.055178406318168005,8698,137,0.1257423066434039,650,0.8,0.9,765,79,686
5000,2858,3045,0.09999999999999992,312,300,0.10000000000000007,2546,2745,0.09999999999999992,651,0.0,0.1,7805,744,7061
5000,884,696,0.3000000000000003,75,77,0.30000000000000004,809,619,0.3000000000000003,652,0.0,0.3,9483,979,8504
5000,3027,605,0.5,339,67,0.5,2688,538,0.5,653,0.0,0.5,7363,701,6662
5000,9266,27,0.6999999999999998,872,5,0.7,8394,22,0.6999999999999998,654,0.0,0.7,1251,120,1131
2134,4618,0,0.0,474,0,0.0,4144,0,0.0,655,0.0,0.9,144,14,130
5000,2687,1870,0.1319986553215788,235,186,0.13821723592867824,2452,1684,0.13131180496948824,656,0.8,0.1,7740,810,6930
5000,3536,1678,0.15562865529989492,383,157,0.14538689402819455,3153,1521,0.15668582592425842,657,0.8,0.3,6897,683,6214
5000,5669,1496,0.19342189284360123,586,147,0.22284399860872972,5083,1349,0.1902157775378385,658,0.8,0.5,4678,447,4231
5000,8072,626,0.2572980470829489,834,54,0.2795896838814762,7238,572,0.2551935918607103,659,0.8,0.7,2419,225,2194
757,2050,0,0.0,208,0,0.0,1842,0,0.0,660,0.8,0.9,53,4,49
5000,1810,2821,0.09999999999999992,183,289,0.10000000000000009,1627,2532,0.10000000000000007,661,0.0,0.1,8767,874,7893
5000,900,636,0.3000000000000003,80,54,0.3,820,582,0.3000000000000002,662,0.0,0.3,9563,979,8584
5000,2141,592,0.5,231,60,0.5,1910,532,0.5,663,0.0,0.5,8442,837,7605
2538,5324,0,0.0,521,0,0.0,4803,0,0.0,664,0.0,0.7,268,9,259
921,2185,0,0.0,226,0,0.0,1959,0,0.0,665,0.0,0.9,90,5,85
5000,3779,1725,0.14068603799542959,412,156,0.12621078577263353,3367,1569,0.1421252600137573,666,0.8,0.1,6694,635,6059
5000,3813,1867,0.14947955481637776,371,198,0.13119002186295084,3442,1669,0.15164931366885134,667,0.8,0.3,6534,669,5865
5000,5586,1476,0.1954864900763521,573,141,0.19152653836813918,5013,1335,0.19590473216688245,668,0.8,0.5,4909,435,4474
830,2093,0,0.0,223,0,0.0,1870,0,0.0,669,0.8,0.7,23,2,21
5000,8552,453,0.21394763413299367,836,49,0.21320355907162084,7716,404,0.21403788086073441,670,0.8,0.9,1803,204,1599
5000,2170,3084,0.09999999999999998,230,338,0.10000000000000003,1940,2746,0.09999999999999992,671,0.0,0.1,8264,811,7453
5000,894,695,0.30000000000000027,82,73,0.30000000000000004,812,622,0.3000000000000004,672,0.0,0.3,9439,932,8507
5000,1440,474,0.5,160,37,0.5,1280,437,0.5,673,0.0,0.5,9150,879,8271
5000,9138,87,0.7000000000000002,912,11,0.7000000000000001,8226,76,0.7000000000000004,674,0.0,0.7,1304,155,1149
1650,3699,0,0.0,351,0,0.0,3348,0,0.0,675,0.0,0.9,102,12,90
5000,3404,1682,0.14810377885319742,349,141,0.14668753117559674,3055,1541,0.148233364137131,676,0.8,0.1,6878,655,6223
5000,2311,1883,0.10817192981733242,245,174,0.09420339707796256,2066,1709,0.10959412097979608,677,0.8,0.3,7966,760,7206
5000,2538,1653,0.12460551195829168,243,152,0.13405574122716885,2295,1501,0.12364852671587374,678,0.8,0.5,7879,769,7110
5000,3852,1795,0.14705962245975404,379,168,0.15793407916801167,3473,1627,0.14593675292872316,679,0.8,0.7,6733,635,6098
5000,10304,21,0.11451587009775986,1009,2,0.05,9295,19,0.12130701431857668,680,0.8,0.9,91,8,83
5000,2040,2890,0.1,191,309,0.10000000000000005,1849,2581,0.1,681,0.0,0.1,8400,849,7551
5000,978,634,0.3000000000000003,109,65,0.3000000000000001,869,569,0.3000000000000002,682,0.0,0.3,9523,927,8596
5000,3042,918,0.5,251,102,0.5,2791,816,0.5,683,0.0,0.5,7541,814,6727
2358,4944,0,0.0,532,0,0.0,4412,0,0.0,684,0.0,0.7,220,11,209
977,2361,0,0.0,245,0,0.0,2116,0,0.0,685,0.0,0.9,57,2,55
5000,3222,1801,0.12018205100636353,368,164,0.11773557789164754,2854,1637,0.12042714666354952,686,0.8,0.1,7258,687,6571
5000,2811,1847,0.12380813280993352,297,201,0.1125583327714951,2514,1646,0.12518189332495547,687,0.8,0.3,7709,759,6950
5000,2600,1771,0.1282002739632011,255,191,0.12599895359718274,2345,1580,0.12846638294415652,688,0.8,0.5,7735,782,6953
5000,8323,570,0.18983985181020394,844,49,0.14522698949389282,7479,521,0.19403568722958828,689,0.8,0.7,2146,202,1944
4941,10291,0,0.0,1037,0,0.0,9254,0,0.0,690,0.8,0.9,37,1,36
5000,1670,2832,0.09999999999999999,148,263,0.10000000000000005,1522,2569,0.10000000000000003,691,0.0,0.1,8920,890,8030
5000,961,662,0.30000000000000027,104,73,0.30000000000000004,857,589,0.3000000000000003,692,0.0,0.3,9434,987,8447
5000,1248,465,0.5,139,47,0.5,1109,418,0.5,693,0.0,0.5,9135,865,8270
1231,2971,0,0.0,295,0,0.0,2676,0,0.0,694,0.0,0.7,57,2,55
1174,2694,0,0.0,275,0,0.0,2419,0,0.0,695,0.0,0.9,118,18,100
5000,2212,1726,0.11508806204109959,244,202,0.11906697204588293,1968,1524,0.11456067370713224,696,0.8,0.1,8321,880,7441
5000,2431,1653,0.11491451164072021,245,165,0.11474271706819442,2186,1488,0.11493356144210917,697,0.8,0.3,7997,815,7182
5000,5344,1553,0.1704591648686352,568,172,0.18149733766729734,4776,1381,0.16908438882129997,698,0.8,0.5,5210,523,4687
5000,4053,1754,0.14862553996301137,413,146,0.1635663017004601,3640,1608,0.14726897826296936,699,0.8,0.7,6484,684,5800
1333,3112,0,0.0,299,0,0.0,2813,0,0.0,700,0.8,0.9,70,3,67
5000,1598,2820,0.0999999999999999,127,286,0.10000000000000007,1471,2534,0.10000000000000007,701,0.0,0.1,9023,916,8107
5000,948,610,0.30000000000000016,104,65,0.3000000000000001,844,545,0.3000000000000004,702,0.0,0.3,9628,987,8641
5000,2165,687,0.5,229,68,0.5,1936,619,0.5,703,0.0,0.5,8265,800,7465
5000,8691,39,0.6999999999999998,874,4,0.7,7817,35,0.6999999999999998,704,0.0,0.7,1865,214,1651
1139,2609,0,0.0,257,0,0.0,2352,0,0.0,705,0.0,0.9,123,11,112
5000,3426,1963,0.14563715015527479,353,214,0.13049799013456462,3073,1749,0.14748951164437255,706,0.8,0.1,7168,746,6422
5000,2268,1700,0.12150945672785336,237,201,0.12398193543912887,2031,1499,0.12117792355842945,707,0.8,0.3,8235,814,7421
5000,2278,1623,0.11772753735732898,241,165,0.10569013507938699,2037,1458,0.11908979481676689,708,0.8,0.5,8272,842,7430
1697,3970,0,0.0,368,0,0.0,3602,0,0.0,709,0.8,0.7,61,4,57
5000,8447,519,0.1927547094874773,904,46,0.22455345723620962,7543,473,0.18966223084806572,710,0.8,0.9,1840,150,1690
5000,2114,2934,0.09999999999999991,208,259,0.10000000000000002,1906,2675,0.09999999999999996,711,0.0,0.1,8302,820,7482
5000,932,685,0.3000000000000004,77,69,0.3,855,616,0.30000000000000027,712,0.0,0.3,9248,922,8326
5000,1605,586,0.5,160,68,0.5,1445,518,0.5,713,0.0,0.5,8953,916,8037
4459,8402,0,0.0,843,0,0.0,7559,0,0.0,714,0.0,0.7,665,60,605
982,2303,0,0.0,234,0,0.0,2069,0,0.0,715,0.0,0.9,99,8,91
5000,4600,1713,0.14847821583374293,432,205,0.15534097236384517,4168,1508,0.14754528142480988,716,0.8,0.1,5890,596,5294
5000,2500,1824,0.11841673418532149,241,201,0.12608197687701855,2259,1623,0.11746743425862334,717,0.8,0.3,7978,808,7170
5000,3983,1913,0.1457094947239466,409,195,0.15806165807175598,3574,1718,0.14430747385501586,718,0.8,0.5,6676,636,6040
5000,3305,1741,0.13998690566669322,335,172,0.13836287901334057,2970,1569,0.14016493790657636,719,0.8,0.7,7145,724,6421
5000,6617,1050,0.17763954785573358,791,90,0.16430828714260493,5826,960,0.17888935354758942,720,0.8,0.9,3801,289,3512
5000,1746,2837,0.09999999999999998,193,267,0.10000000000000006,1553,2570,0.10000000000000005,721,0.0,0.1,8529,830,7699
5000,879,759,0.3000000000000003,97,68,0.3,782,691,0.3000000000000002,722,0.0,0.3,9507,992,8515
5000,8311,349,0.5,854,35,0.5,7457,314,0.5,723,0.0,0.5,2086,180,1906
2180,4387,0,0.0,438,0,0.0,3949,0,0.0,724,0.0,0.7,322,31,291
781,1970,0,0.0,222,0,0.0,1748,0,0.0,725,0.0,0.9,58,4,54
5000,2900,1977,0.13137321333777563,279,157,0.10050081905624655,2621,1820,0.1340363814159075,726,0.8,0.1,7648,738,6910
5000,3595,1685,0.13856543698798365,393,163,0.12380996213397139,3202,1522,0.14014568823713217,727,0.8,0.3,6923,648,6275
5000,2821,1836,0.1356660374906616,269,192,0.1330645598909707,2552,1644,0.1359698596920854,728,0.8,0.5,7463,738,6725
5000,5199,1494,0.16564660713400867,524,148,0.16701006987808809,4675,1346,0.16549668701058834,729,0.8,0.7,5392,545,4847
5000,5410,1703,0.15596538955868788,520,178,0.1432672186574198,4890,1525,0.15744753671962275,730,0.8,0.9,5145,478,4667
5000,1874,2917,0.09999999999999994,190,280,0.10000000000000005,1684,2637,0.10000000000000002,731,0.0,0.1,8553,854,7699
5000,989,681,0.3000000000000003,101,75,0.30000000000000004,888,606,0.3000000000000004,732,0.0,0.3,9632,901,8731
5000,1600,462,0.5,152,46,0.5,1448,416,0.5,733,0.0,0.5,8903,945,7958
2186,4607,0,0.0,454,0,0.0,4153,0,0.0,734,0.0,0.7,285,22,263
2410,5071,0,0.0,523,0,0.0,4548,0,0.0,735,0.0,0.9,237,26,211
5000,2841,1978,0.12242065678006495,285,216,0.10451123135294253,2556,1762,0.12461613685512649,736,0.8,0.1,7731,811,6920
5000,2807,1799,0.13558306600666456,298,181,0.12297149585987532,2509,1618,0.136993878241874,737,0.8,0.3,7517,767,6750
5000,8934,594,0.19666438876100256,852,58,0.1715634006953041,8082,536,0.19938054045467885,738,0.8,0.5,1620,161,1459
5000,4347,1639,0.15237052127866152,441,156,0.14677059388201016,3906,1483,0.1529595898382553,739,0.8,0.7,6132,589,5543
5000,10270,6,0.03515629573756271,1102,0,0.0,9168,6,0.03515629573756271,740,0.8,0.9,288,20,268
5000,2158,3154,0.09999999999999995,218,292,0.10000000000000003,1940,2862,0.09999999999999994,741,0.0,0.1,8351,803,7548
5000,966,755,0.30000000000000027,104,59,0.30000000000000004,862,696,0.3000000000000003,742,0.0,0.3,9614,953,8661
5000,1516,568,0.5,164,55,0.5,1352,513,0.5,743,0.0,0.5,8815,859,7956
677,1802,0,0.0,179,0,0.0,1623,0,0.0,744,0.0,0.7,47,1,46
1424,3159,0,0.0,332,0,0.0,2827,0,0.0,745,0.0,0.9,110,9,101
5000,2654,1730,0.12062071108282163,279,156,0.1332492223193178,2375,1574,0.11936909243422358,746,0.8,0.1,7707,740,6967
5000,2828,1875,0.1352589049285206,252,209,0.1296122701701405,2576,1666,0.13596727627576038,747,0.8,0.3,7723,802,6921
5000,2888,1786,0.1459115371624935,299,174,0.13548434779733343,2589,1612,0.14703705263987424,748,0.8,0.5,7620,749,6871
5000,5663,1464,0.17580149653261634,510,166,0.1403156150189379,5153,1298,0.18033975256595272,749,0.8,0.7,4601,529,4072
5000,9281,285,0.1880925093938497,942,27,0.15712813524014602,8339,258,0.19133296715412104,750,0.8,0.9,1087,88,999
5000,1747,2876,0.09999999999999991,208,266,0.10000000000000006,1539,2610,0.09999999999999995,751,0.0,0.1,8723,843,7880
5000,862,735,0.3000000000000005,85,70,0.3,777,665,0.3000000000000003,752,0.0,0.3,9642,953,8689
5000,4651,792,0.5,485,96,0.5,4166,696,0.5,753,0.0,0.5,5775,538,5237
4450,8590,0,0.0,922,0,0.0,7668,0,0.0,754,0.0,0.7,805,77,728
2186,4677,0,0.0,490,0,0.0,4187,0,0.0,755,0.0,0.9,261,49,212
5000,2274,1755,0.11314300077992355,247,145,0.11057440069181657,2027,1610,0.11337433432823134,756,0.8,0.1,8221,780,7441
5000,2183,1926,0.1124746070381033,193,190,0.10558129002831115,1990,1736,0.1132290599366405,757,0.8,0.3,8322,846,7476
5000,7395,1030,0.1647792947012489,735,102,0.16425105530577067,6660,928,0.16483735549687267,758,0.8,0.5,3038,258,2780
5000,3340,1740,0.13610155949365338,323,162,0.11709714327624363,3017,1578,0.13805258321179048,759,0.8,0.7,7098,689,6409
592,1602,0,0.0,185,0,0.0,1417,0,0.0,760,0.8,0.9,24,0,24
5000,1632,2845,0.09999999999999996,161,271,0.10000000000000009,1471,2574,0.10000000000000003,761,0.0,0.1,8987,917,8070
5000,1043,722,0.30000000000000027,103,70,0.3,940,652,0.3000000000000003,762,0.0,0.3,9447,980,8467
5000,3031,780,0.5,299,85,0.5,2732,695,0.5,763,0.0,0.5,7472,731,6741
5000,9761,24,0.6999999999999998,1003,1,0.7,8758,23,0.7,764,0.0,0.7,913,64,849
897,2172,0,0.0,210,0,0.0,1962,0,0.0,765,0.0,0.9,97,4,93
5000,2754,1729,0.12383935606384612,259,132,0.13055565688539272,2495,1597,0.12328422036663628,766,0.8,0.1,7741,747,6994
5000,2725,1750,0.12210058994032777,287,156,0.11719108905570497,2438,1594,0.12258106806956316,767,0.8,0.3,7682,780,6902
5000,5904,1422,0.18399016125178694,650,134,0.20790759497255143,5254,1288,0.18150185681189374,768,0.8,0.5,4532,377,4155
5000,9989,80,0.20545823987063988,989,13,0.31281488793701057,9000,67,0.18462784546970226,769,0.8,0.7,457,43,414
5000,10321,26,0.2719259822255243,1035,4,0.39332391251541005,9286,22,0.24985363126372678,770,0.8,0.9,187,10,177
5000,1966,3068,0.0999999999999999,177,327,0.10000000000000003,1789,2741,0.09999999999999992,771,0.0,0.1,8563,928,7635
5000,935,630,0.3000000000000002,96,67,0.3,839,563,0.3000000000000001,772,0.0,0.3,9384,937,8447
5000,2054,568,0.5,215,76,0.5,1839,492,0.5,773,0.0,0.5,8526,862,7664
5000,9924,3,0.6999999999999998,937,0,0.0,8987,3,0.6999999999999998,774,0.0,0.7,526,36,490
603,1622,0,0.0,170,0,0.0,1452,0,0.0,775,0.0,0.9,28,4,24
5000,2791,1874,0.12486731126645352,297,190,0.14742069317045164,2494,1684,0.12232268979272452,776,0.8,0.1,7688,814,6874
5000,5172,1310,0.16205539457541837,606,112,0.17643632044484261,4566,1198,0.16071093406007989,777,0.8,0.3,5213,461,4752
5000,2674,1600,0.13039903344346337,265,149,0.12405750772749091,2409,1451,0.13105023077749506,778,0.8,0.5,7810,811,6999
5000,3215,1726,0.14364974991723717,308,203,0.1304771171989474,2907,1523,0.14540552433733755,779,0.8,0.7,7236,746,6490
5000,8994,424,0.16110934142065295,958,26,0.12092184688781764,8036,398,0.16373465513385327,780,0.8,0.9,1507,120,1387
5000,1583,2973,0.09999999999999995,141,275,0.10000000000000002,1442,2698,0.10000000000000002,781,0.0,0.1,8967,910,8057
5000,948,655,0.3000000000000004,122,63,0.3000000000000001,826,592,0.3000000000000004,782,0.0,0.3,9560,988,8572
5000,3148,803,0.5,316,72,0.5,2832,731,0.5,783,0.0,0.5,7278,682,6596
1006,2422,0,0.0,227,0,0.0,2195,0,0.0,784,0.0,0.7,66,1,65
793,2072,0,0.0,197,0,0.0,1875,0,0.0,785,0.0,0.9,19,1,18
5000,2867,1974,0.12265604737635741,329,195,0.12235824077998565,2538,1779,0.12268869059518399,786,0.8,0.1,7596,708,6888
5000,3024,1713,0.14020386579655464,341,143,0.13497943572036059,2683,1570,0.14067972152960925,787,0.8,0.3,7428,726,6702
5000,7738,1013,0.17862627897104727,814,117,0.18466571878822727,6924,896,0.17783764676277716,788,0.8,0.5,2802,278,2524
5000,10338,2,0.07147399375273976,1013,0,0.0,9325,2,0.07147399375273976,789,0.8,0.7,64,3,61
5000,2497,1580,0.16085532435892136,241,130,0.21287754332195952,2256,1450,0.15619126334844208,790,0.8,0.9,7915,788,7127
5000,1664,2827,0.10000000000000002,156,282,0.10000000000000006,1508,2545,0.10000000000000007,791,0.0,0.1,8846,849,7997
5000,985,626,0.30000000000000016,92,66,0.29999999999999993,893,560,0.3000000000000004,792,0.0,0.3,9299,937,8362
4148,8542,0,0.0,870,0,0.0,7672,0,0.0,793,0.0,0.5,330,10,320
3717,7751,0,0.0,817,0,0.0,6934,0,0.0,794,0.0,0.7,320,25,295
2849,5669,0,0.0,543,0,0.0,5126,0,0.0,795,0.0,0.9,378,31,347
5000,4608,1792,0.16953379395103335,473,189,0.1795846976628974,4135,1603,0.16834875290203627,796,0.8,0.1,5679,596,5083
5000,5246,1553,0.17585278393239356,548,172,0.1549060267687857,4698,1381,0.17846164869136574,797,0.8,0.3,5333,517,4816
5000,10374,1,0.008472789438322692,1047,0,0.0,9327,1,0.008472789438322692,798,0.8,0.5,41,1,40
5000,7300,859,0.22853813534515058,739,91,0.24644979003337544,6561,768,0.22641579084433225,799,0.8,0.7,3162,346,2816
5000,3373,1538,0.15095253874318926,308,136,0.1308587396031965,3065,1402,0.15290172325320278,800,0.8,0.9,7179,711,6468
5000,2264,2930,0.09999999999999992,234,316,0.10000000000000007,2030,2614,0.09999999999999995,801,0.0,0.1,8177,832,7345
5000,855,694,0.30000000000000027,82,79,0.3000000000000001,773,615,0.3000000000000002,802,0.0,0.3,9641,998,8643
5000,6797,648,0.5,657,78,0.5,6140,570,0.5,803,0.0,0.5,3722,375,3347
5000,9191,37,0.6999999999999998,963,6,0.7000000000000001,8228,31,0.6999999999999997,804,0.0,0.7,1226,128,1098
832,2018,0,0.0,196,0,0.0,1822,0,0.0,805,0.0,0.9,46,1,45
5000,4890,1654,0.1654795482884195,490,181,0.1713407531757462,4400,1473,0.16475933234503437,806,0.8,0.1,5398,542,4856
5000,2256,1816,0.1167443451551628,206,200,0.10675057641709873,2050,1616,0.11798119772175492,807,0.8,0.3,8249,834,7415
5000,4473,1552,0.1541799694988136,435,134,0.15507426704674207,4038,1418,0.15409545901120963,808,0.8,0.5,6119,592,5527
5000,10499,3,0.05000000000000001,1061,0,0.0,9438,3,0.05000000000000001,809,0.8,0.7,71,4,67
5000,10463,9,0.06494925702970893,1101,0,0.0,9362,9,0.06494925702970893,810,0.8,0.9,53,0,53
5000,1540,2699,0.10000000000000003,136,277,0.10000000000000003,1404,2422,0.10000000000000009,811,0.0,0.1,8869,919,7950
5000,888,643,0.3000000000000002,88,73,0.30000000000000004,800,570,0.30000000000000027,812,0.0,0.3,9619,1004,8615
5000,2415,675,0.5,241,84,0.5,2174,591,0.5,813,0.0,0.5,8294,861,7433
1563,3473,0,0.0,336,0,0.0,3137,0,0.0,814,0.0,0.7,152,10,142
1465,3345,0,0.0,346,0,0.0,2999,0,0.0,815,0.0,0.9,104,9,95
5000,3215,1840,0.14667196494533885,314,166,0.1423096439392919,2901,1674,0.14710454874880585,816,0.8,0.1,7289,731,6558
5000,2829,1838,0.1314351051373943,293,191,0.12962274621129172,2536,1647,0.13164528155201818,817,0.8,0.3,7608,776,6832
5000,5739,1432,0.17936539979300525,644,116,0.17206338587688663,5095,1316,0.18000904235704002,818,0.8,0.5,4738,439,4299
5000,4287,1790,0.1524200064228487,435,196,0.15840657979754,3852,1594,0.1516838907506783,819,0.8,0.7,6227,654,5573
5000,10428,23,0.15909145393823823,1073,2,0.11389395813888568,9355,21,0.16339597734770037,820,0.8,0.9,127,5,122
5000,3897,2960,0.09999999999999998,448,289,0.10000000000000009,3449,2671,0.09999999999999996,821,0.0,0.1,6438,645,5793
5000,966,659,0.30000000000000027,89,68,0.3,877,591,0.3000000000000004,822,0.0,0.3,9320,953,8367
5000,6695,716,0.5,624,77,0.5,6071,639,0.5,823,0.0,0.5,3805,421,3384
5000,9270,3,0.6999999999999998,947,0,0.0,8323,3,0.6999999999999998,824,0.0,0.7,1113,119,994
1974,4265,0,0.0,428,0,0.0,3837,0,0.0,825,0.0,0.9,277,27,250
5000,2322,1821,0.10852060784612666,237,166,0.10431231258534016,2085,1655,0.10894270876050165,826,0.8,0.1,8091,818,7273
5000,2370,1712,0.1287009937276047,243,150,0.13581364142220778,2127,1562,0.12801796097844306,827,0.8,0.3,8266,809,7457
5000,7916,937,0.15231647918102648,818,71,0.09864850369226051,7098,866,0.15671650950400842,828,0.8,0.5,2560,216,2344
5000,2665,1636,0.14342559118342169,264,125,0.1585996749094721,2401,1511,0.14217028975009519,829,0.8,0.7,7745,776,6969
5000,3975,1775,0.1904093684236205,394,172,0.20369803658579722,3581,1603,0.18898351008057968,830,0.8,0.9,6315,592,5723
5000,2030,2955,0.1,203,288,0.10000000000000009,1827,2667,0.09999999999999998,831,0.0,0.1,8447,829,7618
5000,943,717,0.3000000000000004,95,68,0.3,848,649,0.30000000000000027,832,0.0,0.3,9600,909,8691
5000,4469,1001,0.5,420,102,0.5,4049,899,0.5,833,0.0,0.5,6029,618,5411
1725,3776,0,0.0,396,0,0.0,3380,0,0.0,834,0.0,0.7,98,4,94
1483,3396,0,0.0,381,0,0.0,3015,0,0.0,835,0.0,0.9,89,5,84
5000,2490,1941,0.11769629510623966,236,204,0.11997170582098443,2254,1737,0.11742906206892938,836,0.8,0.1,8155,866,7289
5000,3318,1755,0.1316714798548307,339,165,0.1350516163281251,2979,1590,0.13132071097552653,837,0.8,0.3,6883,674,6209
5000,3583,1885,0.17294586310797308,314,179,0.19837339753710392,3269,1706,0.17027790961277112,838,0.8,0.5,6805,689,6116
5000,4626,1656,0.1627486048000887,464,167,0.17443694310157726,4162,1489,0.16143768975888742,839,0.8,0.7,5825,585,5240
5000,7301,874,0.18619774481952178,700,70,0.1864267398349697,6601,804,0.18617780744255497,840,0.8,0.9,3072,268,2804
5000,3592,2935,0.09999999999999992,382,333,0.10000000000000006,3210,2602,0.09999999999999998,841,0.0,0.1,6892,678,6214
5000,1053,725,0.3000000000000003,119,67,0.3,934,658,0.3000000000000002,842,0.0,0.3,9469,932,8537
5000,1170,543,0.5,99,64,0.5,1071,479,0.5,843,0.0,0.5,9277,938,8339
5000,7035,80,0.7000000000000005,677,8,0.7000000000000001,6358,72,0.7000000000000003,844,0.0,0.7,3337,372,2965
1704,3578,0,0.0,369,0,0.0,3209,0,0.0,845,0.0,0.9,283,30,253
5000,3405,2022,0.13419522987353516,351,216,0.12076473776743359,3054,1806,0.13580153457725494,846,0.8,0.1,6945,671,6274
5000,2527,1875,0.11652972385239882,294,180,0.12747770324326574,2233,1695,0.11536710657195276,847,0.8,0.3,7957,827,7130
5000,2507,1900,0.13362187726424637,214,192,0.12783945418879272,2293,1708,0.1342718920361943,848,0.8,0.5,8052,833,7219
5000,2730,1940,0.12209711979536318,262,184,0.10963542616978877,2468,1756,0.1234029009041933,849,0.8,0.7,7828,799,7029
1707,3862,0,0.0,389,0,0.0,3473,0,0.0,850,0.8,0.9,58,2,56
5000,1537,2659,0.09999999999999999,149,268,0.10000000000000007,1388,2391,0.10000000000000007,851,0.0,0.1,8845,913,7932
5000,1141,632,0.30000000000000027,160,59,0.30000000000000004,981,573,0.3000000000000003,852,0.0,0.3,9363,896,8467
3262,6744,0,0.0,688,0,0.0,6056,0,0.0,853,0.0,0.5,204,17,187
2808,5754,0,0.0,585,0,0.0,5169,0,0.0,854,0.0,0.7,392,27,365
1544,3238,0,0.0,319,0,0.0,2919,0,0.0,855,0.0,0.9,250,26,224
5000,4000,1876,0.1392594534550909,392,189,0.12526161841578132,3608,1687,0.14082767563791806,856,0.8,0.1,6544,658,5886
5000,2326,1703,0.11684648274430777,245,151,0.13080045249763164,2081,1552,0.11548884780052433,857,0.8,0.3,8188,775,7413
5000,9935,197,0.14580487251921928,947,18,0.2020196228932316,8988,179,0.14015199259334096,858,0.8,0.5,510,27,483
5000,10458,4,0.07835413325041914,1017,0,0.0,9441,4,0.07835413325041914,859,0.8,0.7,59,2,57
5000,9997,124,0.1811089984354748,1043,15,0.2139682779430963,8954,109,0.17658707923717817,860,0.8,0.9,560,48,512
5000,4034,2985,0.09999999999999992,488,290,0.10000000000000002,3546,2695,0.1,861,0.0,0.1,6500,630,5870
5000,861,594,0.30000000000000016,72,69,0.3,789,525,0.30000000000000027,862,0.0,0.3,9694,963,8731
5000,1724,395,0.5,171,44,0.5,1553,351,0.5,863,0.0,0.5,8808,863,7945
1997,4163,0,0.0,410,0,0.0,3753,0,0.0,864,0.0,0.7,226,19,207
1163,2749,0,0.0,275,0,0.0,2474,0,0.0,865,0.0,0.9,46,4,42
5000,2517,1791,0.139016074770806,234,160,0.14567540936036374,2283,1631,0.1383627985388445,866,0.8,0.1,7758,776,6982
5000,2433,1593,0.1333309411915414,262,156,0.12604367751679824,2171,1437,0.13412204288483295,867,0.8,0.3,7937,775,7162
5000,2933,1727,0.15706738385346242,293,161,0.16866769864302675,2640,1566,0.15587475889744717,868,0.8,0.5,7692,790,6902
5000,9121,327,0.25488058624881954,938,38,0.25004020314235953,8183,289,0.25551703800676245,869,0.8,0.7,1281,129,1152
993,2403,0,0.0,251,0,0.0,2152,0,0.0,870,0.8,0.9,77,3,74
5000,2509,3048,0.09999999999999992,248,302,0.10000000000000007,2261,2746,0.09999999999999992,871,0.0,0.1,7951,789,7162
5000,959,680,0.30000000000000027,83,66,0.29999999999999993,876,614,0.3000000000000002,872,0.0,0.3,9583,954,8629
5000,1340,453,0.5,124,59,0.5,1216,394,0.5,873,0.0,0.5,9142,944,8198
3611,7426,0,0.0,733,0,0.0,6693,0,0.0,874,0.0,0.7,198,6,192
1199,2768,0,0.0,289,0,0.0,2479,0,0.0,875,0.0,0.9,85,2,83
5000,3963,1787,0.13268476982206112,415,150,0.13320362097364305,3548,1637,0.13263722695539204,876,0.8,0.1,6585,605,5980
5000,3351,1720,0.14982621690742381,386,139,0.1579357817343599,2965,1581,0.14911323176451158,877,0.8,0.3,7032,620,6412
5000,4390,1680,0.15898479253847458,474,184,0.18082551867397662,3916,1496,0.1562985000191347,878,0.8,0.5,6329,597,5732
5000,6498,1082,0.18118647810258642,701,97,0.1980340135831581,5797,985,0.17952738069993118,879,0.8,0.7,3746,326,3420
5000,10420,1,0.0020522796145932,1028,0,0.0,9392,1,0.0020522796145932,880,0.8,0.9,160,20,140
5000,1949,2828,0.1,190,315,0.10000000000000006,1759,2513,0.10000000000000006,881,0.0,0.1,8692,872,7820
5000,971,708,0.30000000000000027,107,65,0.3000000000000001,864,643,0.3000000000000002,882,0.0,0.3,9677,952,8725
5000,1372,412,0.5,158,35,0.5,1214,377,0.5,883,0.0,0.5,9025,924,8101
1442,3237,0,0.0,323,0,0.0,2914,0,0.0,884,0.0,0.7,116,9,107
1831,3865,0,0.0,409,0,0.0,3456,0,0.0,885,0.0,0.9,262,25,237
5000,4015,1634,0.1416772378649513,438,145,0.1578151062880815,3577,1489,0.14010571944899838,886,0.8,0.1,6334,616,5718
5000,3074,1763,0.13436987277957638,295,178,0.13616999687078635,2779,1585,0.1341677137333711,887,0.8,0.3,7290,700,6590
5000,2532,1711,0.133348291431214,229,164,0.13885294314324156,2303,1547,0.13276473430078573,888,0.8,0.5,7980,832,7148
5000,9984,135,0.1371591338840029,1039,4,0.10677866025165819,8945,131,0.13808678193384544,889,0.8,0.7,446,18,428
5000,8348,745,0.21517279326719618,870,67,0.17900802367155866,7478,678,0.21874659793225176,890,0.8,0.9,2154,214,1940
5000,1942,2891,0.1,209,289,0.10000000000000009,1733,2602,0.09999999999999998,891,0.0,0.1,8536,863,7673
5000,930,712,0.3000000000000003,76,78,0.3000000000000001,854,634,0.3000000000000003,892,0.0,0.3,9456,955,8501
5000,2038,371,0.5,213,29,0.5,1825,342,0.5,893,0.0,0.5,8425,849,7576
1196,2737,0,0.0,269,0,0.0,2468,0,0.0,894,0.0,0.7,162,15,147
648,1687,0,0.0,163,0,0.0,1524,0,0.0,895,0.0,0.9,64,1,63
5000,3600,1881,0.1328464886373828,370,179,0.12944944608381262,3230,1702,0.13320375692004383,896,0.8,0.1,6941,668,6273
5000,2987,1736,0.126834409078416,331,170,0.138443258735918,2656,1566,0.1255741891283679,897,0.8,0.3,7519,739,6780
5000,8337,638,0.1797373705511399,852,59,0.18484936539688454,7485,579,0.17921645915925918,898,0.8,0.5,2192,188,2004
5000,2820,1591,0.14191489404243815,294,148,0.1500380734188037,2526,1443,0.141081747439734,899,0.8,0.7,7651,745,6906
940,2315,0,0.0,254,0,0.0,2061,0,0.0,900,0.8,0.9,26,0,26
5000,1768,2826,0.1,168,289,0.10000000000000009,1600,2537,0.10000000000000007,901,0.0,0.1,8789,882,7907
5000,805,906,0.30000000000000043,77,80,0.3000000000000001,728,826,0.3000000000000004,902,0.0,0.3,9657,955,8702
5000,2495,650,0.5,272,62,0.5,2223,588,0.5,903,0.0,0.5,7993,820,7173
2339,4939,0,0.0,493,0,0.0,4446,0,0.0,904,0.0,0.7,235,25,210
3423,7074,0,0.0,725,0,0.0,6349,0,0.0,905,0.0,0.9,314,34,280
5000,2874,1739,0.11794356958138175,285,152,0.11842796893517714,2589,1587,0.11789717468423185,906,0.8,0.1,7695,755,6940
5000,2855,1721,0.12482273163750195,268,195,0.1235970256274254,2587,1526,0.12497935855228894,907,0.8,0.3,7703,823,6880
5000,3901,1645,0.1603357957982815,414,155,0.15677961239290222,3487,1490,0.16070573434045182,908,0.8,0.5,6628,646,5982
5000,9861,242,0.13117840941967007,1007,16,0.08101971614996488,8854,226,0.13472946735026867,909,0.8,0.7,627,42,585
5000,10202,44,0.07358257970467136,1008,2,0.05,9194,42,0.07470555969060809,910,0.8,0.9,140,7,133
5000,1834,2929,0.09999999999999991,175,303,0.10000000000000009,1659,2626,0.09999999999999992,911,0.0,0.1,8765,932,7833
5000,951,606,0.3000000000000004,95,51,0.3,856,555,0.30000000000000027,912,0.0,0.3,9673,972,8701
5000,4935,904,0.5,481,95,0.5,4454,809,0.5,913,0.0,0.5,5357,534,4823
4363,8414,0,0.0,791,0,0.0,7623,0,0.0,914,0.0,0.7,702,87,615
1194,2850,0,0.0,257,0,0.0,2593,0,0.0,915,0.0,0.9,63,7,56
5000,3418,1807,0.12760940889426325,374,185,0.11829779362297609,3044,1622,0.12867146119092673,916,0.8,0.1,7031,690,6341
5000,2896,1979,0.13262266618733198,306,188,0.14609843959753713,2590,1791,0.13120812380814792,917,0.8,0.3,7614,755,6859
5000,3983,1852,0.1573811006585875,438,180,0.16433689152503703,3545,1672,0.15663227149832376,918,0.8,0.5,6491,588,5903
5000,5577,1292,0.1632272123721456,612,91,0.14455183510404934,4965,1201,0.16464224928421614,919,0.8,0.7,4856,402,4454
5000,3692,1551,0.14364386419718114,359,141,0.13568077067258655,3333,1410,0.14444017354964056,920,0.8,0.9,6644,652,5992
5000,2278,3002,0.09999999999999991,215,301,0.10000000000000007,2063,2701,0.1,921,0.0,0.1,8012,789,7223
5000,989,629,0.3000000000000002,99,67,0.3,890,562,0.3000000000000001,922,0.0,0.3,9395,939,8456
5000,1650,441,0.5,155,43,0.5,1495,398,0.5,923,0.0,0.5,8976,897,8079
2657,5639,0,0.0,593,0,0.0,5046,0,0.0,924,0.0,0.7,243,16,227
1363,3026,0,0.0,319,0,0.0,2707,0,0.0,925,0.0,0.9,146,18,128
5000,2375,1742,0.12147237956257494,234,171,0.12770517910192522,2141,1571,0.12079395262353683,926,0.8,0.1,8090,777,7313
5000,3676,1888,0.13753454313817587,380,202,0.14442394446819548,3296,1686,0.13670912257550447,927,0.8,0.3,6860,681,6179
5000,6680,1056,0.20252510357774414,710,116,0.25195099779338936,5970,940,0.19642573790857956,928,0.8,0.5,3722,338,3384
5000,3885,1866,0.14987866924309579,403,187,0.1631191948461008,3482,1679,0.14840399486086706,929,0.8,0.7,6402,610,5792
2106,4673,0,0.0,487,0,0.0,4186,0,0.0,930,0.8,0.9,87,2,85
5000,1580,2504,0.10000000000000006,168,257,0.10000000000000009,1412,2247,0.10000000000000006,931,0.0,0.1,8775,836,7939
5000,833,881,0.30000000000000054,86,74,0.30000000000000004,747,807,0.3000000000000003,932,0.0,0.3,9727,985,8742
5000,1754,576,0.5,174,46,0.5,1580,530,0.5,933,0.0,0.5,8770,949,7821
1387,3072,0,0.0,308,0,0.0,2764,0,0.0,934,0.0,0.7,135,13,122
879,2091,0,0.0,201,0,0.0,1890,0,0.0,935,0.0,0.9,87,9,78
5000,3888,1849,0.13415333523721637,444,179,0.13226180207093946,3444,1670,0.1343560804089311,936,0.8,0.1,6606,621,5985
5000,1985,1737,0.11808685437652776,175,205,0.12075276705867008,1810,1532,0.11773012324086249,937,0.8,0.3,8373,865,7508
5000,4644,1575,0.145617867208231,549,139,0.13686466321264787,4095,1436,0.14646514809638286,938,0.8,0.5,5843,510,5333
5000,3452,1749,0.12840009628947743,336,177,0.11654700708074305,3116,1572,0.12973469984542269,939,0.8,0.7,6973,704,6269
5000,9620,248,0.16530112423697813,995,18,0.10809975733914495,8625,230,0.16977775295072162,940,0.8,0.9,827,53,774
5000,2379,3026,0.09999999999999996,246,302,0.10000000000000007,2133,2724,0.09999999999999996,941,0.0,0.1,8096,794,7302
5000,992,679,0.30000000000000027,109,71,0.3,883,608,0.30000000000000043,942,0.0,0.3,9537,959,8578
5000,4923,785,0.5,541,63,0.5,4382,722,0.5,943,0.0,0.5,5571,526,5045
3701,7509,0,0.0,778,0,0.0,6731,0,0.0,944,0.0,0.7,286,21,265
1219,2882,0,0.0,302,0,0.0,2580,0,0.0,945,0.0,0.9,64,7,57
5000,3696,1818,0.14739024276210858,373,188,0.15805470058877596,3323,1630,0.14616023167535178,946,0.8,0.1,6684,662,6022
5000,2601,1901,0.13918688651630362,241,181,0.12935359280840314,2360,1720,0.14022166916812337,947,0.8,0.3,7698,772,6926
5000,2876,1727,0.1519933129757324,290,147,0.14863472911523104,2586,1580,0.15230578881591825,948,0.8,0.5,7690,753,6937
5000,5536,1371,0.16277462420941283,601,120,0.14405552293488838,4935,1251,0.16457022145397154,949,0.8,0.7,4901,487,4414
5000,6418,1286,0.16082215718553822,692,123,0.1641141537812401,5726,1163,0.1604739924552963,950,0.8,0.9,4101,400,3701
5000,1756,2831,0.1,181,290,0.10000000000000002,1575,2541,0.10000000000000007,951,0.0,0.1,8723,919,7804
5000,959,687,0.30000000000000043,100,72,0.30000000000000004,859,615,0.3000000000000002,952,0.0,0.3,9594,946,8648
5000,1542,405,0.5,116,36,0.5,1426,369,0.5,953,0.0,0.5,9153,908,8245
2758,5515,0,0.0,560,0,0.0,4955,0,0.0,954,0.0,0.7,457,38,419
1409,3152,0,0.0,322,0,0.0,2830,0,0.0,955,0.0,0.9,133,14,119
5000,2450,2062,0.11320801202997756,193,216,0.0935824701909938,2257,1846,0.11550439179011866,956,0.8,0.1,7970,792,7178
5000,2879,1701,0.12475568631748395,351,148,0.13312422493971743,2528,1553,0.1239581694365499,957,0.8,0.3,7429,705,6724
5000,6715,1217,0.19244462512667357,643,125,0.17719202503722495,6072,1092,0.19419057293911043,958,0.8,0.5,3726,384,3342
1718,3796,0,0.0,380,0,0.0,3416,0,0.0,959,0.8,0.7,50,6,44
5000,7053,945,0.18534851250969736,758,84,0.2042198763219306,6295,861,0.1835074038450892,960,0.8,0.9,3373,281,3092
5000,1541,2667,0.09999999999999998,165,255,0.10000000000000009,1376,2412,0.10000000000000007,961,0.0,0.1,8987,896,8091
5000,927,636,0.3000000000000003,85,70,0.3,842,566,0.30000000000000016,962,0.0,0.3,9565,940,8625
5000,2854,664,0.5,310,69,0.5,2544,595,0.5,963,0.0,0.5,7642,719,6923
5000,9187,57,0.7000000000000002,935,11,0.7000000000000001,8252,46,0.6999999999999997,964,0.0,0.7,1174,120,1054
1404,3093,0,0.0,293,0,0.0,2800,0,0.0,965,0.0,0.9,178,26,152
5000,3266,1805,0.1350576378349596,316,174,0.11995867165753075,2950,1631,0.13666844109361848,966,0.8,0.1,6977,724,6253
5000,2550,1744,0.1284309903435934,253,181,0.10853889337592368,2297,1563,0.13073455371604908,967,0.8,0.3,7937,801,7136
5000,2978,1772,0.1328256756851157,297,174,0.1269364203944581,2681,1598,0.13346693377058153,968,0.8,0.5,7348,749,6599
5000,5738,1245,0.17916671616135926,599,114,0.17356217433785398,5139,1131,0.17973163019131472,969,0.8,0.7,4670,423,4247
5000,9683,289,0.16856829446370883,980,38,0.09687943607631308,8703,251,0.17942158776538625,970,0.8,0.9,765,83,682
5000,1998,2939,0.09999999999999991,234,270,0.10000000000000007,1764,2669,0.09999999999999995,971,0.0,0.1,8410,780,7630
5000,861,824,0.3000000000000004,95,79,0.3000000000000001,766,745,0.3000000000000003,972,0.0,0.3,9441,942,8499
5000,3281,610,0.5,339,80,0.5,2942,530,0.5,973,0.0,0.5,7275,700,6575
3936,7057,0,0.0,689,0,0.0,6368,0,0.0,974,0.0,0.7,1238,118,1120
2229,4760,0,0.0,468,0,0.0,4292,0,0.0,975,0.0,0.9,172,6,166
5000,2615,1984,0.11823073652526593,254,213,0.12539867867247748,2361,1771,0.1173686407164822,976,0.8,0.1,7926,824,7102
5000,2264,1831,0.1268136476018773,247,176,0.11676998762356484,2017,1655,0.12788173470531114,977,0.8,0.3,8217,797,7420
5000,7576,834,0.22644780023265906,766,69,0.2531956768245068,6810,765,0.22403524665770821,978,0.8,0.5,2856,264,2592
5000,10195,61,0.16440868592485397,1059,9,0.2275515900077851,9136,52,0.15348010637203893,979,0.8,0.7,247,20,227
5000,9932,224,0.2978766032567521,977,28,0.3242580960549724,8955,196,0.2941078185712921,980,0.8,0.9,649,76,573
5000,2612,3089,0.09999999999999995,259,362,0.10000000000000005,2353,2727,0.09999999999999998,981,0.0,0.1,7962,814,7148
5000,1052,598,0.30000000000000027,121,67,0.3,931,531,0.3000000000000001,982,0.0,0.3,9370,925,8445
5000,1870,467,0.5,197,55,0.5,1673,412,0.5,983,0.0,0.5,8593,858,7735
5000,7234,107,0.7000000000000002,715,18,0.7,6519,89,0.7000000000000002,984,0.0,0.7,3081,342,2739
1084,2559,0,0.0,270,0,0.0,2289,0,0.0,985,0.0,0.9,59,5,54
5000,3273,1884,0.1258811710900903,336,204,0.13317125995473136,2937,1680,0.12499594601366962,986,0.8,0.1,6867,688,6179
5000,3049,1739,0.13085380797566867,295,186,0.14902802654190941,2754,1553,0.12867711470244217,987,0.8,0.3,7497,724,6773
5000,2832,1710,0.15762158705889764,282,150,0.15144694750204976,2550,1560,0.1582153024009022,988,0.8,0.5,7605,772,6833
5000,2870,1932,0.14430050687886548,280,202,0.12566585740171363,2590,1730,0.14647634456348085,989,0.8,0.7,7612,768,6844
433,1300,0,0.0,134,0,0.0,1166,0,0.0,990,0.8,0.9,25,1,24
5000,2075,2856,0.09999999999999995,244,293,0.10000000000000003,1831,2563,0.10000000000000007,991,0.0,0.1,8415,802,7613
5000,964,626,0.30000000000000016,110,49,0.3000000000000002,854,577,0.3000000000000004,992,0.0,0.3,9467,893,8574
5000,1335,417,0.5,130,41,0.5,1205,376,0.5,993,0.0,0.5,9142,937,8205
5000,9763,2,0.7,892,0,0.0,8871,2,0.7,994,0.0,0.7,732,85,647
851,2095,0,0.0,219,0,0.0,1876,0,0.0,995,0.0,0.9,42,4,38
5000,2673,1999,0.12589078084542724,286,193,0.1261325258815077,2387,1806,0.12586494651986604,996,0.8,0.1,7845,802,7043
5000,2789,1882,0.12439795184820877,275,194,0.12283227347169486,2514,1688,0.12457789355735786,997,0.8,0.3,7745,811,6934
5000,3216,1924,0.16895158911308006,279,207,0.18153009228007772,2937,1717,0.1674351359065754,998,0.8,0.5,7311,802,6509
5000,6376,1329,0.18094520053297644,640,127,0.21385284144749075,5736,1202,0.17746827008693372,999,0.8,0.7,4139,394,3745
665,1750,0,0.0,167,0,0.0,1583,0,0.0,1000,0.8,0.9,39,4,35
