step,susceptible_status,infected_status,filtermeanvirulence_pathogen,susceptible_status_is_minority,infected_status_is_minority,filtermeanvirulence_pathogen_is_minority,susceptible_status_#84_f=is_minority,infected_status_#84_f=is_minority,filtermeanvirulence_pathogen_#84_f=is_minority,ensemble,mutation_rate,virulence_init,total_infected,total_minority_infected,total_majority_infected
5000,2541,2925,0.09999999999999992,249,292,0.10000000000000003,2292,2633,0.10000000000000002,1,0.0,0.1,7855,772,7083
5000,803,718,0.3000000000000004,62,75,0.30000000000000004,741,643,0.3000000000000002,2,0.0,0.3,9558,960,8598
5000,1506,418,0.5,131,50,0.5,1375,368,0.5,3,0.0,0.5,8936,871,8065
1532,3575,0,0.0,374,0,0.0,3201,0,0.0,4,0.0,0.7,55,2,53
1226,2890,0,0.0,280,0,0.0,2610,0,0.0,5,0.0,0.9,86,6,80
5000,2191,1761,0.11808956842368551,199,179,0.11913220177333671,1992,1582,0.11797159663507138,6,0.8,0.1,8248,840,7408
5000,2458,1806,0.11581896445409018,243,193,0.11905641250363143,2215,1613,0.11543159466266954,7,0.8,0.3,8118,793,7325
5000,5041,1542,0.16521806552038318,500,164,0.1571569905268997,4541,1378,0.16617743874166857,8,0.8,0.5,5376,533,4843
5000,2346,1648,0.12729346511520764,249,173,0.12295204678986031,2097,1475,0.1278026619764179,9,0.8,0.7,7933,790,7143
681,1825,0,0.0,203,0,0.0,1622,0,0.0,10,0.8,0.9,39,3,36
5000,3354,3108,0.09999999999999994,343,286,0.10000000000000007,3011,2822,0.09999999999999995,11,0.0,0.1,7129,681,6448
5000,844,638,0.3000000000000004,79,67,0.3,765,571,0.30000000000000027,12,0.0,0.3,9440,910,8530
5000,1651,615,0.5,173,55,0.5,1478,560,0.5,13,0.0,0.5,8776,843,7933
5000,9885,20,0.7,1037,2,0.7,8848,18,0.7,14,0.0,0.7,676,52,624
541,1478,0,0.0,135,0,0.0,1343,0,0.0,15,0.0,0.9,34,1,33
5000,3138,1773,0.13375907799005232,322,167,0.12850654122646268,2816,1606,0.13430526331976556,16,0.8,0.1,7287,747,6540
5000,2986,1832,0.12610578741749381,266,199,0.138461903155717,2720,1633,0.12460005132936988,17,0.8,0.3,7552,767,6785
5000,7157,1033,0.20742259243733632,713,97,0.21612588263814903,6444,936,0.20652064890156846,18,0.8,0.5,3167,321,2846
5000,7813,899,0.21972154608498523,794,107,0.21109775991052845,7019,792,0.22088662830804948,19,0.8,0.7,2751,301,2450
5000,8586,613,0.19254549648041194,836,64,0.1989493025702224,7750,549,0.1917989689945324,20,0.8,0.9,1870,178,1692
5000,2192,3017,0.09999999999999998,214,274,0.10000000000000002,1978,2743,0.09999999999999994,21,0.0,0.1,8319,785,7534
5000,891,741,0.30000000000000027,78,68,0.3,813,673,0.3000000000000005,22,0.0,0.3,9624,974,8650
5000,1710,711,0.5,172,79,0.5,1538,632,0.5,23,0.0,0.5,8817,884,7933
4984,9476,0,0.0,998,0,0.0,8478,0,0.0,24,0.0,0.7,985,84,901
950,2263,0,0.0,227,0,0.0,2036,0,0.0,25,0.0,0.9,70,3,67
5000,2994,1983,0.12583296554454193,288,203,0.121062147294407,2706,1780,0.12637705324385506,26,0.8,0.1,7559,773,6786
5000,1911,1571,0.11469742329499005,187,150,0.10417060765951298,1724,1421,0.11580862832336555,27,0.8,0.3,8414,841,7573
5000,6021,1228,0.1758410643530461,575,122,0.1586319481471573,5446,1106,0.17773935746074815,28,0.8,0.5,4543,412,4131
5000,10095,216,0.19560475190520218,1028,22,0.17845513396944057,9067,194,0.19754955393915455,29,0.8,0.7,562,63,499
5000,4368,1570,0.15233539781046937,484,137,0.15696752295828043,3884,1433,0.15189254983751047,30,0.8,0.9,6129,624,5505
5000,1993,2957,0.09999999999999998,191,287,0.10000000000000009,1802,2670,0.09999999999999996,31,0.0,0.1,8521,850,7671
5000,961,705,0.30000000000000043,85,69,0.3,876,636,0.3000000000000003,32,0.0,0.3,9605,971,8634
5000,1386,479,0.5,127,46,0.5,1259,433,0.5,33,0.0,0.5,8988,898,8090
2908,6151,0,0.0,617,0,0.0,5534,0,0.0,34,0.0,0.7,88,3,85
535,1448,0,0.0,163,0,0.0,1285,0,0.0,35,0.0,0.9,51,3,48
5000,2989,1931,0.1356149752166079,278,206,0.11703664215099457,2711,1725,0.1378336051363275,36,0.8,0.1,7357,784,6573
5000,2571,1792,0.1212633745424797,259,163,0.11873724718356496,2312,1629,0.12151614235064614,37,0.8,0.3,7968,760,7208
5000,7671,939,0.1809400504301607,762,102,0.16856002694633374,6909,837,0.18244872712711446,38,0.8,0.5,2778,282,2496
5000,10148,38,0.15117678477272428,1070,5,0.23964859730075144,9078,33,0.13777196469272018,39,0.8,0.7,415,41,374
5000,7120,889,0.2282121833683911,733,91,0.21383142864367685,6387,798,0.22985209399489354,40,0.8,0.9,3320,347,2973
5000,1654,2748,0.09999999999999992,169,280,0.10000000000000005,1485,2468,0.10000000000000006,41,0.0,0.1,8679,907,7772
5000,885,694,0.30000000000000027,76,81,0.3000000000000001,809,613,0.3000000000000002,42,0.0,0.3,9514,943,8571
5000,3415,808,0.5,344,76,0.5,3071,732,0.5,43,0.0,0.5,7162,737,6425
2542,5346,0,0.0,548,0,0.0,4798,0,0.0,44,0.0,0.7,332,24,308
676,1765,0,0.0,174,0,0.0,1591,0,0.0,45,0.0,0.9,67,7,60
5000,3671,1723,0.1414071832946991,402,166,0.14459047752299012,3269,1557,0.14106779547074513,46,0.8,0.1,7046,714,6332
5000,2700,1749,0.1354083201224828,252,162,0.1322550797503918,2448,1587,0.13573020099222366,47,0.8,0.3,7861,775,7086
5000,3208,1896,0.12013985390317257,309,195,0.13199740891555703,2899,1701,0.1187805221998128,48,0.8,0.5,7287,703,6584
5000,10346,24,0.05915121995301927,1084,4,0.0671903454193444,9262,20,0.057543394859754224,49,0.8,0.7,191,10,181
400,1234,0,0.0,126,0,0.0,1108,0,0.0,50,0.8,0.9,17,0,17
5000,1899,2924,0.09999999999999994,182,291,0.10000000000000003,1717,2633,0.10000000000000002,51,0.0,0.1,8688,894,7794
5000,965,640,0.3000000000000004,92,64,0.3000000000000001,873,576,0.3000000000000004,52,0.0,0.3,9672,956,8716
5000,4354,846,0.5,419,103,0.5,3935,743,0.5,53,0.0,0.5,6086,618,5468
2539,5292,0,0.0,496,0,0.0,4796,0,0.0,54,0.0,0.7,279,23,256
829,2092,0,0.0,209,0,0.0,1883,0,0.0,55,0.0,0.9,67,6,61
5000,4355,1607,0.16031781360175038,435,137,0.14618709965517596,3920,1470,0.1616347576906488,56,0.8,0.1,6181,584,5597
5000,2203,1778,0.13520768962372623,215,155,0.1594020484462732,1988,1623,0.13289707618103072,57,0.8,0.3,8188,754,7434
5000,2767,1764,0.14176541788781927,248,171,0.15066501401679336,2519,1593,0.1408100940095678,58,0.8,0.5,7687,775,6912
5000,3644,1803,0.16388603422457923,364,173,0.17121859126924785,3280,1630,0.16310779350756838,59,0.8,0.7,6826,674,6152
1277,2997,0,0.0,295,0,0.0,2702,0,0.0,60,0.8,0.9,81,5,76
5000,2050,2936,0.09999999999999991,214,304,0.10000000000000009,1836,2632,0.10000000000000003,61,0.0,0.1,8348,878,7470
5000,836,725,0.3000000000000003,93,77,0.30000000000000004,743,648,0.30000000000000027,62,0.0,0.3,9645,968,8677
5000,1846,360,0.5,187,38,0.5,1659,322,0.5,63,0.0,0.5,8659,873,7786
5000,6876,59,0.7000000000000003,735,3,0.6999999999999998,6141,56,0.7000000000000002,64,0.0,0.7,3685,377,3308
632,1678,0,0.0,160,0,0.0,1518,0,0.0,65,0.0,0.9,30,0,30
5000,2133,1791,0.10793706425140855,186,181,0.10575894194944421,1947,1610,0.10818193390150516,66,0.8,0.1,8367,822,7545
5000,2869,1816,0.13375489768611812,292,185,0.1390815162832513,2577,1631,0.13315071347982158,67,0.8,0.3,7720,801,6919
1758,3952,0,0.0,423,0,0.0,3529,0,0.0,68,0.8,0.5,36,1,35
5000,6524,1160,0.2241802224941847,638,107,0.2495430666874723,5886,1053,0.22160299141281545,69,0.8,0.7,3890,359,3531
5000,3933,1869,0.17752342512396338,358,198,0.20126231357461663,3575,1671,0.17471055862891285,70,0.8,0.9,6782,704,6078
5000,3173,3101,0.09999999999999994,327,291,0.10000000000000003,2846,2810,0.09999999999999992,71,0.0,0.1,7330,731,6599
5000,785,657,0.30000000000000043,74,66,0.29999999999999993,711,591,0.3000000000000004,72,0.0,0.3,9612,981,8631
5000,1423,369,0.5,117,35,0.5,1306,334,0.5,73,0.0,0.5,9128,910,8218
3819,7295,0,0.0,739,0,0.0,6556,0,0.0,74,0.0,0.7,814,79,735
1768,3911,0,0.0,418,0,0.0,3493,0,0.0,75,0.0,0.9,68,5,63
5000,3403,2080,0.1394991741534378,323,205,0.14090810922071895,3080,1875,0.13934513058608178,76,0.8,0.1,7079,709,6370
5000,2863,1677,0.12196550494004374,278,164,0.12260660511324926,2585,1513,0.12189601357956412,77,0.8,0.3,7589,751,6838
5000,3289,1599,0.16480900880445132,326,146,0.15859038893959054,2963,1453,0.16543386668488463,78,0.8,0.5,7061,725,6336
5000,7064,1021,0.1689906225929412,701,121,0.17011837405878796,6363,900,0.16883900267364405,79,0.8,0.7,3306,348,2958
5000,8750,491,0.21503657954672123,902,44,0.22679488538085552,7848,447,0.2138791624176342,80,0.8,0.9,1659,175,1484
5000,2942,3098,0.09999999999999995,289,308,0.10000000000000003,2653,2790,0.09999999999999996,81,0.0,0.1,7492,723,6769
5000,836,733,0.30000000000000043,83,62,0.3000000000000001,753,671,0.30000000000000043,82,0.0,0.3,9696,1006,8690
5000,2425,601,0.5,242,58,0.5,2183,543,0.5,83,0.0,0.5,8136,792,7344
3891,7678,0,0.0,736,0,0.0,6942,0,0.0,84,0.0,0.7,629,56,573
2521,5107,0,0.0,501,0,0.0,4606,0,0.0,85,0.0,0.9,464,48,416
5000,2480,1770,0.1217617629238362,259,170,0.1336642239896322,2221,1600,0.12049712643559538,86,0.8,0.1,7833,786,7047
5000,2405,1992,0.11368396970394931,245,198,0.1145327637135587,2160,1794,0.11359029009753756,87,0.8,0.3,7967,802,7165
5000,6558,1119,0.20530439342300666,654,128,0.20528344256303085,5904,991,0.20530709948766557,88,0.8,0.5,3732,375,3357
613,1655,0,0.0,171,0,0.0,1484,0,0.0,89,0.8,0.7,13,0,13
530,1484,0,0.0,146,0,0.0,1338,0,0.0,90,0.8,0.9,61,7,54
5000,1786,2921,0.09999999999999994,153,284,0.10000000000000007,1633,2637,0.10000000000000002,91,0.0,0.1,8634,836,7798
5000,1015,635,0.3000000000000003,85,61,0.30000000000000004,930,574,0.3000000000000003,92,0.0,0.3,9561,970,8591
5000,2397,603,0.5,228,61,0.5,2169,542,0.5,93,0.0,0.5,8119,782,7337
1109,2634,0,0.0,250,0,0.0,2384,0,0.0,94,0.0,0.7,127,11,116
695,1711,0,0.0,156,0,0.0,1555,0,0.0,95,0.0,0.9,51,4,47
5000,2914,1970,0.12487490127181737,302,190,0.13663090855686633,2612,1780,0.12362004656161554,96,0.8,0.1,7620,731,6889
5000,2216,1729,0.12576996876835472,228,143,0.14911591202145613,1988,1586,0.12366500667176367,97,0.8,0.3,8197,778,7419
5000,2705,1617,0.12866969187828278,257,142,0.13687161736188797,2448,1475,0.12788008278087806,98,0.8,0.5,7785,743,7042
5000,6625,1213,0.1887907496097818,647,127,0.19196821601992767,5978,1086,0.18841916744211282,99,0.8,0.7,3945,424,3521
525,1520,0,0.0,150,0,0.0,1370,0,0.0,100,0.8,0.9,38,5,33
5000,2350,3058,0.09999999999999991,250,324,0.10000000000000002,2100,2734,0.09999999999999995,101,0.0,0.1,8226,861,7365
5000,910,644,0.3000000000000002,95,69,0.3,815,575,0.3000000000000003,102,0.0,0.3,9593,954,8639
5000,1261,476,0.5,116,44,0.5,1145,432,0.5,103,0.0,0.5,9158,892,8266
1187,2702,0,0.0,283,0,0.0,2419,0,0.0,104,0.0,0.7,67,5,62
2662,4888,0,0.0,476,0,0.0,4412,0,0.0,105,0.0,0.9,967,89,878
5000,2673,1818,0.12157410365097321,268,183,0.13115152326043683,2405,1635,0.12050213558459291,106,0.8,0.1,8082,797,7285
5000,2414,1961,0.1257695967198956,255,211,0.13395000896476775,2159,1750,0.12478327272922816,107,0.8,0.3,8189,841,7348
5000,10067,31,0.1342461422759675,1004,5,0.13763175853761728,9063,26,0.1335950622256503,108,0.8,0.5,310,27,283
5000,9793,301,0.20501785446555787,962,32,0.25880713390433935,8831,269,0.19861912977395563,109,0.8,0.7,825,81,744
415,1336,0,0.0,146,0,0.0,1190,0,0.0,110,0.8,0.9,20,2,18
5000,2120,2944,0.0999999999999999,215,312,0.10000000000000006,1905,2632,0.10000000000000003,111,0.0,0.1,8245,858,7387
5000,993,1108,0.3000000000000002,115,98,0.3,878,1010,0.3000000000000003,112,0.0,0.3,9568,979,8589
5000,7298,417,0.5,740,31,0.5,6558,386,0.5,113,0.0,0.5,3145,285,2860
5000,8926,32,0.6999999999999997,903,6,0.7000000000000001,8023,26,0.6999999999999998,114,0.0,0.7,1371,155,1216
428,1281,0,0.0,139,0,0.0,1142,0,0.0,115,0.0,0.9,29,3,26
5000,3532,1916,0.124287275200448,357,184,0.10886598091191467,3175,1732,0.12592556512486497,116,0.8,0.1,7058,652,6406
5000,2657,1747,0.12370270596385698,283,184,0.1273964894719972,2374,1563,0.1232678651669934,117,0.8,0.3,7728,789,6939
5000,7257,1157,0.19851918049257167,757,126,0.20544315368595434,6500,1031,0.19767299172209038,118,0.8,0.5,3250,360,2890
5000,10278,3,0.02385306045818562,1052,0,0.0,9226,3,0.02385306045818562,119,0.8,0.7,138,19,119
411,1269,0,0.0,114,0,0.0,1155,0,0.0,120,0.8,0.9,27,1,26
5000,1627,2739,0.09999999999999995,152,264,0.10000000000000005,1475,2475,0.10000000000000007,121,0.0,0.1,8970,899,8071
5000,930,975,0.30000000000000054,78,88,0.30000000000000004,852,887,0.3000000000000003,122,0.0,0.3,9659,992,8667
5000,4551,646,0.5,447,55,0.5,4104,591,0.5,123,0.0,0.5,5795,560,5235
5000,9280,24,0.6999999999999998,920,1,0.7,8360,23,0.7,124,0.0,0.7,1206,130,1076
1141,2444,0,0.0,249,0,0.0,2195,0,0.0,125,0.0,0.9,281,29,252
5000,7289,1319,0.16098635300091851,710,128,0.18216749723392878,6579,1191,0.15870995798679147,126,0.8,0.1,3234,305,2929
5000,3699,2134,0.143666501534119,362,226,0.14052655080311036,3337,1908,0.1440384244194482,127,0.8,0.3,6866,706,6160
5000,7830,908,0.1949461491792064,699,82,0.18677065878120722,7131,826,0.19575775960612637,128,0.8,0.5,2832,270,2562
5000,4164,1698,0.1367955085906599,415,187,0.12765046717374773,3749,1511,0.13792729068527443,129,0.8,0.7,6142,622,5520
905,2208,0,0.0,218,0,0.0,1990,0,0.0,130,0.8,0.9,45,4,41
5000,2986,3082,0.09999999999999998,292,305,0.10000000000000009,2694,2777,0.09999999999999998,131,0.0,0.1,7414,729,6685
5000,912,621,0.3000000000000003,90,65,0.3000000000000001,822,556,0.30000000000000027,132,0.0,0.3,9630,964,8666
5000,1658,532,0.5,154,52,0.5,1504,480,0.5,133,0.0,0.5,8879,843,8036
1886,4127,0,0.0,393,0,0.0,3734,0,0.0,134,0.0,0.7,271,17,254
937,2328,0,0.0,221,0,0.0,2107,0,0.0,135,0.0,0.9,18,1,17
5000,2479,1889,0.11424114587135403,244,219,0.12089764989053545,2235,1670,0.11336822708081472,136,0.8,0.1,8082,852,7230
5000,2381,1741,0.144324459524249,222,164,0.1540400668825548,2159,1577,0.14331408564551584,137,0.8,0.3,8150,817,7333
5000,2661,1884,0.14696647397744125,242,159,0.14238581374117915,2419,1725,0.14738869135574012,138,0.8,0.5,7692,715,6977
5000,7865,771,0.17830670570202375,794,83,0.15171244344150392,7071,688,0.1815150251317085,139,0.8,0.7,2764,274,2490
5000,8654,560,0.25380571146382175,841,55,0.250799061260164,7813,505,0.25413316841669525,140,0.8,0.9,1775,187,1588
5000,1684,2809,0.09999999999999991,154,268,0.10000000000000007,1530,2541,0.10000000000000007,141,0.0,0.1,8960,917,8043
5000,885,912,0.30000000000000054,90,84,0.30000000000000004,795,828,0.30000000000000043,142,0.0,0.3,9472,972,8500
728,1990,0,0.0,199,0,0.0,1791,0,0.0,143,0.0,0.5,17,0,17
1047,2537,0,0.0,277,0,0.0,2260,0,0.0,144,0.0,0.7,61,5,56
2418,5155,0,0.0,538,0,0.0,4617,0,0.0,145,0.0,0.9,135,16,119
5000,2270,1872,0.11543499802731998,225,201,0.11897153818023744,2045,1671,0.1150095973266998,146,0.8,0.1,8098,841,7257
5000,2122,1672,0.12084206763565984,228,171,0.11313930114260325,1894,1501,0.12171959799562829,147,0.8,0.3,8296,820,7476
5000,5056,1555,0.14097159554420235,527,161,0.13400506039350873,4529,1394,0.1417761953715063,148,0.8,0.5,5539,534,5005
5000,8864,374,0.18739252328117892,939,44,0.1924547595487663,7925,330,0.1867175584455006,149,0.8,0.7,1393,129,1264
5000,8103,662,0.18507306864844153,802,63,0.16951125488440197,7301,599,0.18670978695751414,150,0.8,0.9,2307,218,2089
5000,1797,2711,0.1,172,283,0.10000000000000006,1625,2428,0.10000000000000009,151,0.0,0.1,8583,906,7677
5000,776,730,0.3000000000000004,71,70,0.3,705,660,0.30000000000000027,152,0.0,0.3,9708,1000,8708
5000,1352,389,0.5,138,38,0.5,1214,351,0.5,153,0.0,0.5,9180,885,8295
1794,3738,0,0.0,358,0,0.0,3380,0,0.0,154,0.0,0.7,275,25,250
1452,3149,0,0.0,319,0,0.0,2830,0,0.0,155,0.0,0.9,196,25,171
5000,4318,1912,0.14029871742808248,440,193,0.1282424441470055,3878,1719,0.1416523304258997,156,0.8,0.1,6268,638,5630
5000,2842,1794,0.15394548512164877,282,188,0.15176941772540434,2560,1606,0.1542002177931891,157,0.8,0.3,7698,805,6893
5000,4375,1674,0.16153680118424713,451,143,0.1410766834398943,3924,1531,0.16344783765547008,158,0.8,0.5,6018,581,5437
5000,7864,788,0.2021028613643315,752,79,0.21572897939060245,7112,709,0.2005845774093591,159,0.8,0.7,2644,252,2392
1039,2442,0,0.0,251,0,0.0,2191,0,0.0,160,0.8,0.9,96,10,86
5000,1964,2853,0.09999999999999995,200,286,0.10000000000000007,1764,2567,0.10000000000000006,161,0.0,0.1,8552,837,7715
5000,1034,641,0.30000000000000043,102,66,0.29999999999999993,932,575,0.3000000000000003,162,0.0,0.3,9465,922,8543
5000,5239,719,0.5,499,77,0.5,4740,642,0.5,163,0.0,0.5,5142,510,4632
1757,3885,0,0.0,390,0,0.0,3495,0,0.0,164,0.0,0.7,140,9,131
1283,2988,0,0.0,317,0,0.0,2671,0,0.0,165,0.0,0.9,89,5,84
5000,4914,1470,0.1599254504067276,497,140,0.16576151517900342,4417,1330,0.1593111277991196,166,0.8,0.1,5579,532,5047
5000,7678,820,0.20177001446302156,793,78,0.19179657447343243,6885,742,0.20281843537836922,167,0.8,0.3,2710,266,2444
5000,2553,1760,0.12168748083741435,257,172,0.1236106241699214,2296,1588,0.12147918067797403,168,0.8,0.5,7893,764,7129
5000,10124,15,0.08902223059399475,1027,2,0.03279561760333053,9097,13,0.09767247874640463,169,0.8,0.7,302,27,275
921,2285,0,0.0,224,0,0.0,2061,0,0.0,170,0.8,0.9,47,4,43
5000,6021,2363,0.10000000000000007,605,249,0.10000000000000005,5416,2114,0.10000000000000007,171,0.0,0.1,4642,472,4170
5000,917,671,0.30000000000000043,104,71,0.3,813,600,0.30000000000000027,172,0.0,0.3,9643,978,8665
3232,6714,0,0.0,636,0,0.0,6078,0,0.0,173,0.0,0.5,239,18,221
5000,7888,140,0.7000000000000002,801,9,0.7000000000000001,7087,131,0.7000000000000001,174,0.0,0.7,2537,264,2273
605,1616,0,0.0,172,0,0.0,1444,0,0.0,175,0.0,0.9,52,8,44
5000,3079,1927,0.1374573857028823,303,202,0.1309611505231665,2776,1725,0.13821810425726058,176,0.8,0.1,7357,732,6625
5000,2813,1733,0.12788632887169724,264,178,0.12240132775785335,2549,1555,0.12851419395096683,177,0.8,0.3,7729,775,6954
5000,7506,916,0.23265215826403748,750,97,0.2642229322377609,6756,819,0.22891300676776008,178,0.8,0.5,2948,313,2635
1443,3211,0,0.0,351,0,0.0,2860,0,0.0,179,0.8,0.7,138,14,124
2074,4382,0,0.0,417,0,0.0,3965,0,0.0,180,0.8,0.9,212,26,186
5000,1542,2575,0.10000000000000005,158,209,0.10000000000000009,1384,2366,0.10000000000000007,181,0.0,0.1,8941,803,8138
5000,852,639,0.3000000000000004,74,63,0.3000000000000001,778,576,0.3000000000000004,182,0.0,0.3,9443,933,8510
5000,2391,696,0.5,250,67,0.5,2141,629,0.5,183,0.0,0.5,8209,822,7387
2910,5699,0,0.0,586,0,0.0,5113,0,0.0,184,0.0,0.7,633,67,566
1140,2650,0,0.0,258,0,0.0,2392,0,0.0,185,0.0,0.9,163,18,145
5000,3015,1930,0.14880250055478209,288,184,0.16991194685809843,2727,1746,0.14657790827539474,186,0.8,0.1,7554,798,6756
5000,2697,1779,0.14874199645613964,250,173,0.15121561701918332,2447,1606,0.14847553546149045,187,0.8,0.3,7791,794,6997
5000,6180,1205,0.1831103716502182,656,123,0.19255875099069084,5524,1082,0.18203629525569126,188,0.8,0.5,4273,407,3866
5000,5774,1460,0.16023631746961478,584,137,0.1303556336166213,5190,1323,0.16333053794418778,189,0.8,0.7,4634,450,4184
5000,3302,1646,0.16426021775425043,332,170,0.1406411724421255,2970,1476,0.16698056850158183,190,0.8,0.9,7051,717,6334
5000,1476,2689,0.09999999999999991,135,245,0.10000000000000003,1341,2444,0.10000000000000005,191,0.0,0.1,8954,883,8071
5000,823,704,0.30000000000000043,77,59,0.30000000000000004,746,645,0.3000000000000002,192,0.0,0.3,9463,947,8516
5000,5512,769,0.5,518,83,0.5,4994,686,0.5,193,0.0,0.5,5003,492,4511
1203,2712,0,0.0,257,0,0.0,2455,0,0.0,194,0.0,0.7,113,9,104
1071,2534,0,0.0,253,0,0.0,2281,0,0.0,195,0.0,0.9,87,6,81
5000,2654,1802,0.1216696137677895,273,196,0.13609582059929806,2381,1606,0.11990900571114213,196,0.8,0.1,7952,774,7178
5000,3097,1989,0.1385036337648442,296,205,0.1443866394296176,2801,1784,0.1378276157372217,197,0.8,0.3,7270,770,6500
5000,10218,2,0.05142041873939376,1032,0,0.0,9186,2,0.05142041873939376,198,0.8,0.5,155,9,146
5000,4841,1604,0.17188710368412144,452,181,0.1869340184529103,4389,1423,0.16997319534037525,199,0.8,0.7,5662,554,5108
1575,3577,0,0.0,397,0,0.0,3180,0,0.0,200,0.8,0.9,32,1,31
5000,2353,3028,0.09999999999999996,253,289,0.10000000000000009,2100,2739,0.09999999999999995,201,0.0,0.1,8043,775,7268
5000,850,693,0.30000000000000027,83,73,0.30000000000000004,767,620,0.3000000000000003,202,0.0,0.3,9614,996,8618
5000,9014,216,0.5,901,22,0.5,8113,194,0.5,203,0.0,0.5,1474,139,1335
5000,9597,22,0.6999999999999998,940,2,0.7,8657,20,0.7,204,0.0,0.7,924,96,828
1933,3930,0,0.0,383,0,0.0,3547,0,0.0,205,0.0,0.9,309,29,280
5000,2972,1718,0.13661503105724587,285,167,0.11656949683377817,2687,1551,0.13877338322701963,206,0.8,0.1,7577,762,6815
5000,2824,1802,0.13951195308012576,281,207,0.14057245322801773,2543,1595,0.13937432077253098,207,0.8,0.3,7571,823,6748
5000,5483,1550,0.17604644549155307,557,155,0.1863390194428946,4926,1395,0.17490282616362623,208,0.8,0.5,4834,466,4368
5000,9396,418,0.17459715304138593,913,38,0.19305288556658898,8483,380,0.17275157978886557,209,0.8,0.7,1025,95,930
5000,7767,775,0.18751635579893444,759,82,0.20570276327225395,7008,693,0.1853644287963194,210,0.8,0.9,2638,264,2374
5000,1642,2828,0.1,143,272,0.10000000000000009,1499,2556,0.10000000000000009,211,0.0,0.1,8891,908,7983
5000,994,693,0.30000000000000027,116,67,0.3,878,626,0.30000000000000016,212,0.0,0.3,9471,971,8500
5000,8980,277,0.5,900,25,0.5,8080,252,0.5,213,0.0,0.5,1598,156,1442
2813,5903,0,0.0,552,0,0.0,5351,0,0.0,214,0.0,0.7,281,29,252
1728,3676,0,0.0,347,0,0.0,3329,0,0.0,215,0.0,0.9,212,22,190
5000,2188,1912,0.12154828722995893,216,187,0.12313628466579243,1972,1725,0.12137613910213237,216,0.8,0.1,8180,782,7398
5000,2865,1862,0.121947214455215,295,170,0.10704849996960238,2570,1692,0.12344413021322571,217,0.8,0.3,7723,747,6976
5000,4232,1785,0.16894926895398366,424,168,0.17210068688362196,3808,1617,0.16862184890934592,218,0.8,0.5,6192,599,5593
5000,5587,1407,0.1711833327474878,559,121,0.17995242669348316,5028,1286,0.17035824692519747,219,0.8,0.7,4937,471,4466
5000,8407,680,0.19594171871949004,811,58,0.17445370854216719,7596,622,0.19794542384856512,220,0.8,0.9,2117,203,1914
5000,2372,3082,0.09999999999999998,243,315,0.10000000000000006,2129,2767,0.10000000000000002,221,0.0,0.1,8133,835,7298
5000,1053,698,0.3000000000000003,106,81,0.3000000000000001,947,617,0.30000000000000027,222,0.0,0.3,9550,980,8570
5000,1812,469,0.5,173,47,0.5,1639,422,0.5,223,0.0,0.5,8694,856,7838
2559,5171,0,0.0,508,0,0.0,4663,0,0.0,224,0.0,0.7,381,39,342
1527,3373,0,0.0,349,0,0.0,3024,0,0.0,225,0.0,0.9,230,25,205
5000,2559,2006,0.11490512246954099,269,216,0.11082185280710456,2290,1790,0.11539785221651656,226,0.8,0.1,8007,845,7162
5000,3369,1912,0.14760962710036307,331,197,0.14170830188350644,3038,1715,0.14828750527396115,227,0.8,0.3,7258,752,6506
5000,2138,1626,0.12093182698545314,205,163,0.12807046176007744,1933,1463,0.12013647669955856,228,0.8,0.5,8516,848,7668
5000,10219,2,0.10311254378349108,1001,0,0.0,9218,2,0.10311254378349108,229,0.8,0.7,217,15,202
613,1657,0,0.0,150,0,0.0,1507,0,0.0,230,0.8,0.9,31,5,26
5000,3395,3143,0.09999999999999995,350,299,0.10000000000000006,3045,2844,0.09999999999999998,231,0.0,0.1,7210,694,6516
5000,911,660,0.30000000000000027,97,66,0.29999999999999993,814,594,0.30000000000000016,232,0.0,0.3,9635,988,8647
5000,1641,500,0.5,165,42,0.5,1476,458,0.5,233,0.0,0.5,8776,879,7897
5000,9578,3,0.6999999999999998,978,0,0.0,8600,3,0.6999999999999998,234,0.0,0.7,1010,94,916
1392,3134,0,0.0,316,0,0.0,2818,0,0.0,235,0.0,0.9,161,22,139
5000,2911,1872,0.12572411088894322,299,208,0.13070703618561763,2612,1664,0.12510124522685892,236,0.8,0.1,7707,810,6897
5000,2727,1698,0.1329852239013842,281,182,0.12492906271639542,2446,1516,0.1339523883708222,237,0.8,0.3,7939,834,7105
5000,4313,1645,0.13875717566721416,441,165,0.12111071336869096,3872,1480,0.14072451774779274,238,0.8,0.5,6390,609,5781
5000,6111,1478,0.21183857362865083,625,158,0.2146294355886451,5486,1320,0.211504515909197,239,0.8,0.7,4458,456,4002
5000,6914,960,0.19689937168095517,737,103,0.20500943830908494,6177,857,0.19592464955412042,240,0.8,0.9,3481,371,3110
5000,2528,3017,0.09999999999999998,271,336,0.10000000000000006,2257,2681,0.09999999999999992,241,0.0,0.1,7813,854,6959
5000,875,684,0.3000000000000004,74,64,0.3000000000000001,801,620,0.3000000000000003,242,0.0,0.3,9589,993,8596
5000,1758,511,0.5,183,49,0.5,1575,462,0.5,243,0.0,0.5,8582,866,7716
3980,6781,0,0.0,701,0,0.0,6080,0,0.0,244,0.0,0.7,1689,161,1528
958,2199,0,0.0,204,0,0.0,1995,0,0.0,245,0.0,0.9,92,9,83
5000,6078,1382,0.18456608868901436,606,147,0.1686046226998674,5472,1235,0.1864659554909614,246,0.8,0.1,4542,423,4119
5000,4281,1651,0.17005968534278876,459,169,0.1908811451934397,3822,1482,0.1676853083422759,247,0.8,0.3,6002,632,5370
5000,2184,1770,0.11714612487403127,220,179,0.11889346247601569,1964,1591,0.11694953566551132,248,0.8,0.5,8225,781,7444
5000,2515,1899,0.11508052878197882,236,177,0.0967676559344639,2279,1722,0.11696286240219378,249,0.8,0.7,7849,761,7088
5000,8109,750,0.19456999534120212,793,69,0.19915474850832426,7316,681,0.19410546087933508,250,0.8,0.9,2489,228,2261
5000,2056,2926,0.09999999999999994,215,299,0.10000000000000006,1841,2627,0.09999999999999994,251,0.0,0.1,8555,872,7683
5000,958,645,0.3000000000000002,108,56,0.3,850,589,0.3000000000000003,252,0.0,0.3,9440,939,8501
5000,4719,662,0.5,491,62,0.5,4228,600,0.5,253,0.0,0.5,5803,572,5231
5000,8618,4,0.7,884,0,0.0,7734,4,0.7,254,0.0,0.7,1908,185,1723
943,2259,0,0.0,221,0,0.0,2038,0,0.0,255,0.0,0.9,139,7,132
5000,4180,1696,0.1432029490271291,406,163,0.1192035319768413,3774,1533,0.14575474614336975,256,0.8,0.1,6189,600,5589
5000,2857,1846,0.13733386850341314,269,187,0.12123870410105131,2588,1659,0.13914809137456546,257,0.8,0.3,7648,770,6878
5000,4219,1437,0.15072828758898962,406,164,0.16258204678747354,3813,1273,0.14920117328533575,258,0.8,0.5,6160,655,5505
2774,6080,0,0.0,621,0,0.0,5459,0,0.0,259,0.8,0.7,65,1,64
5000,3421,1784,0.14484030929894015,341,188,0.13552498726762374,3080,1596,0.14593760287155128,260,0.8,0.9,6909,724,6185
5000,2123,3056,0.09999999999999991,215,299,0.10000000000000006,1908,2757,0.09999999999999994,261,0.0,0.1,8421,854,7567
5000,886,846,0.30000000000000043,90,96,0.3000000000000001,796,750,0.30000000000000043,262,0.0,0.3,9560,928,8632
5000,1452,414,0.5,161,48,0.5,1291,366,0.5,263,0.0,0.5,9233,902,8331
4663,9222,0,0.0,928,0,0.0,8294,0,0.0,264,0.0,0.7,694,58,636
801,2061,0,0.0,182,0,0.0,1879,0,0.0,265,0.0,0.9,56,5,51
5000,2509,1881,0.11213692590415689,262,178,0.10183454462184534,2247,1703,0.1132137455566827,266,0.8,0.1,8103,787,7316
5000,2708,1670,0.1208471590517836,274,165,0.11844327009912073,2434,1505,0.12111070833895264,267,0.8,0.3,7665,729,6936
5000,3440,1912,0.14565610301772794,350,177,0.15412663025002424,3090,1735,0.14479196277558581,268,0.8,0.5,7014,669,6345
5000,6705,872,0.23706708432655524,636,70,0.241175237823909,6069,802,0.2367085173130704,269,0.8,0.7,3747,358,3389
5000,6469,1103,0.1902676092791357,668,113,0.1992771328419949,5801,990,0.18923924951893067,270,0.8,0.9,3876,382,3494
5000,1917,2792,0.09999999999999995,188,288,0.10000000000000009,1729,2504,0.10000000000000006,271,0.0,0.1,8620,884,7736
5000,784,670,0.30000000000000043,72,76,0.30000000000000004,712,594,0.30000000000000016,272,0.0,0.3,9790,981,8809
5000,1333,482,0.5,140,39,0.5,1193,443,0.5,273,0.0,0.5,9260,969,8291
2114,4447,0,0.0,481,0,0.0,3966,0,0.0,274,0.0,0.7,233,20,213
919,2349,0,0.0,224,0,0.0,2125,0,0.0,275,0.0,0.9,63,8,55
5000,2570,1705,0.12588389342505854,245,198,0.11786892239385234,2325,1507,0.12693695531237026,276,0.8,0.1,7717,817,6900
5000,3723,1598,0.14811112267251852,398,159,0.15554888367547084,3325,1439,0.14728929918435357,277,0.8,0.3,6683,640,6043
5000,6711,1101,0.23089284279899505,655,88,0.23538079392623767,6056,1013,0.2305029714276256,278,0.8,0.5,3663,355,3308
5000,10293,17,0.11559335952849685,1044,0,0.0,9249,17,0.11559335952849685,279,0.8,0.7,253,17,236
5000,8959,525,0.1650711281633062,849,56,0.18051611117409574,8110,469,0.1632269510873911,280,0.8,0.9,1526,151,1375
5000,1635,2683,0.09999999999999994,163,261,0.10000000000000003,1472,2422,0.10000000000000009,281,0.0,0.1,8903,878,8025
5000,986,628,0.3000000000000002,115,59,0.30000000000000004,871,569,0.3000000000000002,282,0.0,0.3,9457,927,8530
5000,5566,705,0.5,595,79,0.5,4971,626,0.5,283,0.0,0.5,4973,523,4450
622,1696,0,0.0,161,0,0.0,1535,0,0.0,284,0.0,0.7,54,4,50
773,1892,0,0.0,191,0,0.0,1701,0,0.0,285,0.0,0.9,53,3,50
5000,2386,1773,0.11962701482704224,237,153,0.12263700182657765,2149,1620,0.11934273827708612,286,0.8,0.1,8219,796,7423
5000,3010,1810,0.1121914210606815,312,166,0.11827858321472691,2698,1644,0.1115767805998716,287,0.8,0.3,7479,714,6765
5000,7698,963,0.17169521069225246,790,81,0.18340755905979766,6908,882,0.17061958686257994,288,0.8,0.5,2824,259,2565
5000,9954,99,0.21542161304716573,981,9,0.326711720977242,8973,90,0.20429260225415816,289,0.8,0.7,377,37,340
925,2251,0,0.0,219,0,0.0,2032,0,0.0,290,0.8,0.9,53,0,53
5000,2453,3072,0.09999999999999988,250,318,0.10000000000000007,2203,2754,0.09999999999999991,291,0.0,0.1,8082,826,7256
5000,784,701,0.3000000000000004,68,55,0.3,716,646,0.3000000000000002,292,0.0,0.3,9665,961,8704
5000,1238,426,0.5,135,54,0.5,1103,372,0.5,293,0.0,0.5,9143,898,8245
1549,3495,0,0.0,322,0,0.0,3173,0,0.0,294,0.0,0.7,127,12,115
713,1921,0,0.0,185,0,0.0,1736,0,0.0,295,0.0,0.9,55,6,49
5000,3299,1953,0.11561628749400574,345,213,0.09783955698712107,2954,1740,0.11779240450433129,296,0.8,0.1,7283,741,6542
5000,2549,1660,0.11753258284072374,264,163,0.10862414423722659,2285,1497,0.11850257314958815,297,0.8,0.3,8011,777,7234
5000,2839,1818,0.1356281461422116,264,175,0.13334889719969897,2575,1643,0.13587091459317918,298,0.8,0.5,7488,739,6749
5000,3434,1912,0.12724295909281275,348,211,0.12533307016675446,3086,1701,0.12747987065271768,299,0.8,0.7,7117,726,6391
5000,10279,32,0.31250712403145053,1022,5,0.3117597225033746,9257,27,0.3126455317218349,300,0.8,0.9,195,15,180
5000,2598,3102,0.09999999999999994,256,328,0.10000000000000003,2342,2774,0.09999999999999999,301,0.0,0.1,7936,800,7136
5000,951,596,0.3000000000000002,100,60,0.30000000000000004,851,536,0.30000000000000016,302,0.0,0.3,9532,930,8602
5000,4841,738,0.5,488,74,0.5,4353,664,0.5,303,0.0,0.5,5574,525,5049
2077,4544,0,0.0,428,0,0.0,4116,0,0.0,304,0.0,0.7,102,7,95
950,2293,0,0.0,230,0,0.0,2063,0,0.0,305,0.0,0.9,97,7,90
5000,3994,1936,0.11983044445375433,381,187,0.11435466001674184,3613,1749,0.12041590568286889,306,0.8,0.1,6607,651,5956
5000,2566,1869,0.1313153732911267,269,186,0.13969511164402149,2297,1683,0.13038927030025418,307,0.8,0.3,7877,772,7105
5000,8431,541,0.20906688777665314,881,49,0.19675606970973392,7550,492,0.2102929651857569,308,0.8,0.5,2082,218,1864
1784,4041,0,0.0,386,0,0.0,3655,0,0.0,309,0.8,0.7,45,3,42
5000,2313,1658,0.13023133948996438,204,167,0.1342329186896708,2109,1491,0.12978314114901807,310,0.8,0.9,8022,811,7211
5000,1798,2690,0.09999999999999992,178,264,0.10000000000000005,1620,2426,0.10000000000000007,311,0.0,0.1,8560,865,7695
5000,947,637,0.3000000000000003,84,61,0.30000000000000004,863,576,0.3000000000000004,312,0.0,0.3,9597,947,8650
5000,1976,635,0.5,201,70,0.5,1775,565,0.5,313,0.0,0.5,8428,875,7553
2435,5066,0,0.0,533,0,0.0,4533,0,0.0,314,0.0,0.7,178,20,158
433,1296,0,0.0,122,0,0.0,1174,0,0.0,315,0.0,0.9,31,1,30
5000,2696,1903,0.12667443201638043,270,180,0.11578784265343965,2426,1723,0.1278117425708374,316,0.8,0.1,7628,758,6870
5000,4110,1767,0.16661685834251483,433,166,0.17338649035395567,3677,1601,0.1659149477154698,317,0.8,0.3,6548,694,5854
5000,3405,1751,0.15206213650601205,346,201,0.15621805979827,3059,1550,0.1515232070984353,318,0.8,0.5,6785,684,6101
5000,4797,1649,0.1639058638797596,484,160,0.17724056451299094,4313,1489,0.16247298805617527,319,0.8,0.7,5884,570,5314
1202,2804,0,0.0,287,0,0.0,2517,0,0.0,320,0.8,0.9,128,17,111
5000,1613,2644,0.10000000000000002,143,286,0.10000000000000007,1470,2358,0.10000000000000007,321,0.0,0.1,8916,909,8007
5000,908,648,0.30000000000000027,96,53,0.3,812,595,0.3000000000000002,322,0.0,0.3,9546,1013,8533
5000,2071,540,0.5,232,54,0.5,1839,486,0.5,323,0.0,0.5,8290,824,7466
5000,9477,5,0.7,941,0,0.0,8536,5,0.7,324,0.0,0.7,914,88,826
1713,3717,0,0.0,387,0,0.0,3330,0,0.0,325,0.0,0.9,187,21,166
5000,3086,1823,0.15531069587798682,334,195,0.1546807992027011,2752,1628,0.15538614418982996,326,0.8,0.1,7348,797,6551
5000,9447,226,0.16094750650023124,956,22,0.17677388513952338,8491,204,0.15924074017638595,327,0.8,0.3,1013,87,926
5000,2697,1988,0.12295576796266355,256,203,0.11549073778040862,2441,1785,0.123804732179469,328,0.8,0.5,7894,821,7073
5000,7732,802,0.195580596209167,775,87,0.2018132210878415,6957,715,0.19482222087427936,329,0.8,0.7,2633,272,2361
5000,6782,916,0.1919275480295654,693,85,0.1999408291592591,6089,831,0.19110789833519234,330,0.8,0.9,3703,375,3328
5000,1968,3170,0.09999999999999992,201,326,0.10000000000000002,1767,2844,0.09999999999999998,331,0.0,0.1,8653,896,7757
5000,887,674,0.3000000000000002,85,69,0.3,802,605,0.3000000000000004,332,0.0,0.3,9658,953,8705
5000,4905,742,0.5,537,82,0.5,4368,660,0.5,333,0.0,0.5,5549,543,5006
5000,7187,147,0.7000000000000002,743,18,0.7,6444,129,0.7000000000000004,334,0.0,0.7,3137,324,2813
504,1517,0,0.0,127,0,0.0,1390,0,0.0,335,0.0,0.9,16,1,15
5000,3301,1727,0.14271794447347355,348,167,0.15584489953939323,2953,1560,0.14131268710423728,336,0.8,0.1,7139,688,6451
5000,4170,1724,0.1552455766242941,400,159,0.15739512716502654,3770,1565,0.1550271877834145,337,0.8,0.3,6330,615,5715
5000,8848,489,0.1948648260582033,880,44,0.20239211910407676,7968,445,0.19412055438625178,338,0.8,0.5,1597,147,1450
5000,4624,1323,0.18060154460481206,467,124,0.17701466540714156,4157,1199,0.18097249791633097,339,0.8,0.7,5786,572,5214
2060,4413,0,0.0,454,0,0.0,3959,0,0.0,340,0.8,0.9,324,41,283
5000,1736,2733,0.09999999999999994,194,259,0.10000000000000002,1542,2474,0.10000000000000006,341,0.0,0.1,8861,904,7957
5000,888,666,0.3000000000000004,91,84,0.30000000000000004,797,582,0.3000000000000002,342,0.0,0.3,9633,949,8684
5000,2734,745,0.5,248,63,0.5,2486,682,0.5,343,0.0,0.5,7731,754,6977
5000,6615,29,0.6999999999999997,619,2,0.7,5996,27,0.6999999999999998,344,0.0,0.7,3878,389,3489
922,2251,0,0.0,226,0,0.0,2025,0,0.0,345,0.0,0.9,106,9,97
5000,3532,2119,0.1292481511936529,361,194,0.12461227179028982,3171,1925,0.12971535150755029,346,0.8,0.1,7017,673,6344
5000,2820,1758,0.12447541804002127,287,157,0.13772590936577467,2533,1601,0.12317602569889491,347,0.8,0.3,7714,704,7010
5000,3088,1868,0.14074455662602514,330,207,0.13737286707790738,2758,1661,0.14116474912238894,348,0.8,0.5,7302,762,6540
1365,3069,0,0.0,313,0,0.0,2756,0,0.0,349,0.8,0.7,129,14,115
5000,4016,1401,0.15084911788366165,426,139,0.15450792377041805,3590,1262,0.15044612737790958,350,0.8,0.9,6520,629,5891
5000,2384,3173,0.09999999999999991,213,291,0.10000000000000003,2171,2882,0.0999999999999999,351,0.0,0.1,8161,757,7404
5000,970,680,0.30000000000000027,112,66,0.29999999999999993,858,614,0.3000000000000002,352,0.0,0.3,9398,920,8478
5000,2226,721,0.5,198,76,0.5,2028,645,0.5,353,0.0,0.5,8335,839,7496
1505,3366,0,0.0,327,0,0.0,3039,0,0.0,354,0.0,0.7,160,20,140
933,2204,0,0.0,206,0,0.0,1998,0,0.0,355,0.0,0.9,79,10,69
5000,2440,1864,0.1226650862699317,259,178,0.11149921535344372,2181,1686,0.12384392673442447,356,0.8,0.1,7947,795,7152
5000,3049,1828,0.14556864399079256,275,168,0.13179379212228087,2774,1660,0.14696272538471425,357,0.8,0.3,7495,682,6813
5000,4834,1755,0.15983805126256662,489,190,0.15701576553698018,4345,1565,0.16018069298004986,358,0.8,0.5,5773,581,5192
5000,7328,902,0.27154277113192404,721,99,0.3371323295705129,6607,803,0.2634563872148377,359,0.8,0.7,3068,337,2731
5000,9691,198,0.17623543411693018,971,19,0.13396855803328547,8720,179,0.18072186230457962,360,0.8,0.9,659,64,595
5000,1973,3043,0.09999999999999995,188,317,0.10000000000000007,1785,2726,0.09999999999999996,361,0.0,0.1,8650,877,7773
5000,886,635,0.3000000000000003,96,69,0.3,790,566,0.30000000000000016,362,0.0,0.3,9407,941,8466
5000,1436,438,0.5,130,44,0.5,1306,394,0.5,363,0.0,0.5,9261,994,8267
2243,4747,0,0.0,467,0,0.0,4280,0,0.0,364,0.0,0.7,200,18,182
1361,2911,0,0.0,284,0,0.0,2627,0,0.0,365,0.0,0.9,194,23,171
5000,2312,1893,0.13228845255280014,206,185,0.1394556411249374,2106,1708,0.13151214699902647,366,0.8,0.1,8313,838,7475
5000,2324,1895,0.12133762113238417,220,173,0.13489218204235495,2104,1722,0.11997586791669022,367,0.8,0.3,8250,817,7433
5000,6397,1317,0.18096511466705933,622,154,0.18822042331606917,5775,1163,0.18000439451921102,368,0.8,0.5,3877,399,3478
5000,10385,7,0.341664057979609,1037,0,0.0,9348,7,0.341664057979609,369,0.8,0.7,110,7,103
5000,6475,1245,0.1812760036051045,668,134,0.19691899499207063,5807,1111,0.17938927017049291,370,0.8,0.9,3880,384,3496
5000,1474,2651,0.1,137,252,0.10000000000000006,1337,2399,0.10000000000000007,371,0.0,0.1,9051,865,8186
5000,875,695,0.30000000000000027,89,70,0.3,786,625,0.30000000000000043,372,0.0,0.3,9702,1008,8694
5000,2861,743,0.5,310,70,0.5,2551,673,0.5,373,0.0,0.5,7575,756,6819
804,2073,0,0.0,203,0,0.0,1870,0,0.0,374,0.0,0.7,37,1,36
1165,2744,0,0.0,276,0,0.0,2468,0,0.0,375,0.0,0.9,66,4,62
5000,2981,1788,0.11444993596941469,291,165,0.11550412464392239,2690,1623,0.11434276336849432,376,0.8,0.1,7442,693,6749
5000,6685,1109,0.21057573512696584,691,115,0.22109427178983035,5994,994,0.20935880181083977,377,0.8,0.3,3589,341,3248
5000,6471,1198,0.19243919210195354,654,98,0.21707026404535912,5817,1100,0.19024478751063198,378,0.8,0.5,3997,381,3616
5000,2318,1960,0.13505676831525296,208,167,0.12003816384137175,2110,1793,0.13645560096842535,379,0.8,0.7,8162,808,7354
796,2048,0,0.0,215,0,0.0,1833,0,0.0,380,0.8,0.9,51,2,49
5000,2067,3070,0.0999999999999999,190,268,0.10000000000000007,1877,2802,0.09999999999999994,381,0.0,0.1,8377,806,7571
5000,1002,667,0.3000000000000004,83,63,0.3000000000000001,919,604,0.3000000000000004,382,0.0,0.3,9550,990,8560
5000,1981,802,0.5,192,82,0.5,1789,720,0.5,383,0.0,0.5,8535,868,7667
5000,9454,101,0.7000000000000001,916,11,0.7000000000000001,8538,90,0.7000000000000003,384,0.0,0.7,1211,128,1083
1126,2701,0,0.0,265,0,0.0,2436,0,0.0,385,0.0,0.9,85,5,80
5000,2945,2004,0.12458810615216705,313,208,0.13048754175476854,2632,1796,0.12390487530286799,386,0.8,0.1,7525,757,6768
5000,3319,1746,0.15341379772514152,342,154,0.1450671479941393,2977,1592,0.15422119977198473,387,0.8,0.3,6977,671,6306
5000,2545,1616,0.12493373933208507,254,149,0.11846058352568231,2291,1467,0.12559120369142657,388,0.8,0.5,8087,804,7283
675,1800,0,0.0,185,0,0.0,1615,0,0.0,389,0.8,0.7,61,5,56
528,1502,0,0.0,140,0,0.0,1362,0,0.0,390,0.8,0.9,30,3,27
5000,1663,2635,0.10000000000000005,162,271,0.10000000000000009,1501,2364,0.10000000000000007,391,0.0,0.1,8840,920,7920
5000,895,608,0.30000000000000043,101,53,0.3,794,555,0.30000000000000027,392,0.0,0.3,9597,883,8714
5000,1664,477,0.5,183,38,0.5,1481,439,0.5,393,0.0,0.5,8747,834,7913
1921,3950,0,0.0,409,0,0.0,3541,0,0.0,394,0.0,0.7,290,25,265
1259,2771,0,0.0,252,0,0.0,2519,0,0.0,395,0.0,0.9,234,31,203
5000,3427,2064,0.15410265870639236,341,206,0.14777809671087036,3086,1858,0.15480387494486259,396,0.8,0.1,6898,712,6186
5000,3896,1867,0.1478997167823915,402,200,0.13165114316002174,3494,1667,0.14984915572928645,397,0.8,0.3,6405,642,5763
5000,4391,1716,0.1781700143742312,457,197,0.21591804443698573,3934,1519,0.1732744502383769,398,0.8,0.5,6130,620,5510
5000,10194,12,0.1434287416201048,1068,0,0.0,9126,12,0.1434287416201048,399,0.8,0.7,285,26,259
3538,7249,0,0.0,739,0,0.0,6510,0,0.0,400,0.8,0.9,105,12,93
5000,2444,3083,0.09999999999999999,271,309,0.10000000000000005,2173,2774,0.09999999999999999,401,0.0,0.1,8152,837,7315
5000,993,662,0.30000000000000027,101,55,0.3,892,607,0.30000000000000043,402,0.0,0.3,9540,901,8639
5000,1663,558,0.5,170,52,0.5,1493,506,0.5,403,0.0,0.5,8713,847,7866
848,2103,0,0.0,189,0,0.0,1914,0,0.0,404,0.0,0.7,54,1,53
1254,2858,0,0.0,279,0,0.0,2579,0,0.0,405,0.0,0.9,138,20,118
5000,4507,1709,0.13574220649364063,444,163,0.11521474247366134,4063,1546,0.13790648633533312,406,0.8,0.1,6011,579,5432
5000,5057,1417,0.1671936012330686,518,138,0.1426129762234807,4539,1279,0.16984577187522892,407,0.8,0.3,5252,513,4739
5000,3945,1762,0.14823910649113756,406,179,0.15257976765875736,3539,1583,0.14774827999145088,408,0.8,0.5,6655,652,6003
5000,5948,1453,0.1829950978698703,587,162,0.1953644874676079,5361,1291,0.18144293589091326,409,0.8,0.7,4552,466,4086
696,1778,0,0.0,180,0,0.0,1598,0,0.0,410,0.8,0.9,69,8,61
5000,2351,3008,0.0999999999999999,240,268,0.10000000000000007,2111,2740,0.09999999999999994,411,0.0,0.1,8133,754,7379
5000,880,681,0.3000000000000003,92,92,0.3000000000000001,788,589,0.3000000000000003,412,0.0,0.3,9523,1006,8517
5000,2670,776,0.5,256,75,0.5,2414,701,0.5,413,0.0,0.5,7900,790,7110
5000,9638,7,0.7000000000000001,952,0,0.0,8686,7,0.7000000000000001,414,0.0,0.7,903,98,805
1382,3076,0,0.0,297,0,0.0,2779,0,0.0,415,0.0,0.9,144,14,130
5000,3931,1935,0.1449674114357863,370,209,0.13660125483453134,3561,1726,0.1459804628434701,416,0.8,0.1,6522,661,5861
5000,3153,1970,0.12474119511366472,319,198,0.11725667105587574,2834,1772,0.12557750197790976,417,0.8,0.3,7298,751,6547
5000,9541,285,0.22656407505710846,921,31,0.20990350888371376,8620,254,0.22859745124362515,418,0.8,0.5,876,78,798
5000,8743,551,0.2024844337484348,842,51,0.22921701083912335,7901,500,0.1997577108851846,419,0.8,0.7,1728,164,1564
1327,3097,0,0.0,308,0,0.0,2789,0,0.0,420,0.8,0.9,35,3,32
5000,2197,3166,0.09999999999999994,216,297,0.10000000000000006,1981,2869,0.09999999999999991,421,0.0,0.1,8321,805,7516
5000,989,638,0.3000000000000004,101,60,0.30000000000000004,888,578,0.3000000000000001,422,0.0,0.3,9587,960,8627
5000,4633,617,0.5,479,67,0.5,4154,550,0.5,423,0.0,0.5,5809,613,5196
1496,3359,0,0.0,335,0,0.0,3024,0,0.0,424,0.0,0.7,78,5,73
1245,2720,0,0.0,257,0,0.0,2463,0,0.0,425,0.0,0.9,220,21,199
5000,3696,2092,0.14545346617455915,355,227,0.1367784332372474,3341,1865,0.14650935490204975,426,0.8,0.1,6858,731,6127
5000,2405,1797,0.1245776780620943,224,187,0.11230206094894754,2181,1610,0.12600347955287594,427,0.8,0.3,8006,774,7232
5000,3202,1620,0.15085744945359972,297,164,0.15797792463150737,2905,1456,0.15005541790883542,428,0.8,0.5,7329,703,6626
5000,8217,731,0.1736879546033059,801,72,0.1640297606806881,7416,659,0.17474317457664199,429,0.8,0.7,2092,196,1896
5000,9970,129,0.21410042255463707,991,14,0.14542310122437802,8979,115,0.22246113993397285,430,0.8,0.9,474,49,425
5000,1940,3122,0.09999999999999991,197,332,0.10000000000000005,1743,2790,0.09999999999999996,431,0.0,0.1,8654,883,7771
5000,950,699,0.3000000000000003,96,73,0.30000000000000004,854,626,0.30000000000000016,432,0.0,0.3,9549,921,8628
5000,1416,341,0.5,139,27,0.5,1277,314,0.5,433,0.0,0.5,9112,912,8200
1538,3542,0,0.0,362,0,0.0,3180,0,0.0,434,0.0,0.7,64,4,60
569,1559,0,0.0,128,0,0.0,1431,0,0.0,435,0.0,0.9,29,3,26
5000,3867,1809,0.14269283502462976,433,174,0.13610959700567854,3434,1635,0.1433934365018759,436,0.8,0.1,6635,652,5983
5000,1997,1566,0.11091365037777663,223,139,0.109272439968221,1774,1427,0.11107351600281395,437,0.8,0.3,8445,830,7615
5000,2519,1717,0.11226715891308336,230,180,0.1020879431478173,2289,1537,0.11345925965332271,438,0.8,0.5,7881,811,7070
5000,3254,1719,0.12422536853127251,325,181,0.12367829371820734,2929,1538,0.12428975119782958,439,0.8,0.7,7164,737,6427
5000,3957,1601,0.16389824363635783,393,132,0.17213224554790177,3564,1469,0.16315836055104546,440,0.8,0.9,6371,572,5799
5000,2592,3259,0.0999999999999999,240,328,0.10000000000000003,2352,2931,0.09999999999999994,441,0.0,0.1,8060,818,7242
5000,971,624,0.3000000000000004,93,56,0.3,878,568,0.3000000000000002,442,0.0,0.3,9598,983,8615
5000,4829,679,0.5,494,71,0.5,4335,608,0.5,443,0.0,0.5,5758,570,5188
5000,9550,22,0.6999999999999998,991,2,0.7,8559,20,0.7,444,0.0,0.7,859,80,779
919,2227,0,0.0,219,0,0.0,2008,0,0.0,445,0.0,0.9,128,11,117
5000,3156,1896,0.13793531965934797,362,181,0.14876569192045444,2794,1715,0.13679228911750527,446,0.8,0.1,7399,751,6648
5000,2337,1659,0.11291534870018959,229,168,0.11097788893358851,2108,1491,0.1131336540260038,447,0.8,0.3,8057,801,7256
5000,10287,40,0.14185647057078185,1092,6,0.13932496208593143,9195,34,0.14230320736222604,448,0.8,0.5,191,8,183
1193,2770,0,0.0,262,0,0.0,2508,0,0.0,449,0.8,0.7,45,2,43
858,2156,0,0.0,219,0,0.0,1937,0,0.0,450,0.8,0.9,30,3,27
5000,2081,2942,0.0999999999999999,216,305,0.10000000000000009,1865,2637,0.10000000000000002,451,0.0,0.1,8464,841,7623
5000,888,723,0.30000000000000027,79,59,0.30000000000000004,809,664,0.3000000000000003,452,0.0,0.3,9530,977,8553
5000,1245,505,0.5,105,40,0.5,1140,465,0.5,453,0.0,0.5,9353,882,8471
1154,2738,0,0.0,272,0,0.0,2466,0,0.0,454,0.0,0.7,41,0,41
902,2309,0,0.0,222,0,0.0,2087,0,0.0,455,0.0,0.9,31,0,31
5000,5141,1737,0.15361563506618336,511,175,0.15105825890274927,4630,1562,0.15390215288218906,456,0.8,0.1,5513,569,4944
5000,2391,1636,0.12674013285426486,233,176,0.12763774471304526,2158,1460,0.12663192758909683,457,0.8,0.3,8028,795,7233
5000,3321,1783,0.15298724514641993,315,195,0.15430724605116314,3006,1588,0.15282515435522026,458,0.8,0.5,7151,752,6399
1412,3150,0,0.0,321,0,0.0,2829,0,0.0,459,0.8,0.7,124,13,111
5000,9749,237,0.17497627293668563,1018,16,0.19231900151475168,8731,221,0.17372069077718763,460,0.8,0.9,635,61,574
5000,1813,2929,0.09999999999999991,194,274,0.10000000000000002,1619,2655,0.1,461,0.0,0.1,8685,882,7803
5000,1025,593,0.3000000000000004,107,47,0.30000000000000016,918,546,0.3000000000000001,462,0.0,0.3,9298,904,8394
5000,1876,487,0.5,188,34,0.5,1688,453,0.5,463,0.0,0.5,8776,852,7924
5000,7873,55,0.7000000000000002,761,6,0.7000000000000001,7112,49,0.7,464,0.0,0.7,2652,257,2395
2155,4258,0,0.0,459,0,0.0,3799,0,0.0,465,0.0,0.9,577,61,516
5000,4375,1570,0.15948045478046943,406,148,0.1403547416279109,3969,1422,0.16147103533361895,466,0.8,0.1,6095,551,5544
5000,2257,1751,0.12078279458390451,212,169,0.14111394518001585,2045,1582,0.11861088279456015,467,0.8,0.3,8217,841,7376
5000,4034,1762,0.162544395169546,390,169,0.18033532136212452,3644,1593,0.16065697111019514,468,0.8,0.5,6310,619,5691
5000,7447,852,0.19393561426460315,803,89,0.20815618875274222,6644,763,0.1922768578695253,469,0.8,0.7,3010,305,2705
5000,10300,1,0.0030546294695705523,1046,0,0.0,9254,1,0.0030546294695705523,470,0.8,0.9,85,9,76
5000,1777,2762,0.10000000000000002,185,270,0.10000000000000007,1592,2492,0.10000000000000007,471,0.0,0.1,8587,859,7728
5000,962,622,0.3000000000000004,112,52,0.3,850,570,0.30000000000000027,472,0.0,0.3,9655,957,8698
4037,8166,0,0.0,851,0,0.0,7315,0,0.0,473,0.0,0.5,298,22,276
685,1753,0,0.0,181,0,0.0,1572,0,0.0,474,0.0,0.7,36,2,34
439,1323,0,0.0,131,0,0.0,1192,0,0.0,475,0.0,0.9,30,1,29
5000,3179,1973,0.13943828158434335,308,174,0.15515660669286435,2871,1799,0.13791799888902218,476,0.8,0.1,7225,715,6510
5000,2733,1811,0.1338770254339754,263,167,0.1268875787291524,2470,1644,0.13458702397394218,477,0.8,0.3,7757,739,7018
5000,1957,1706,0.10837571062667947,170,151,0.09400864839217105,1787,1555,0.10977084014269926,478,0.8,0.5,8401,787,7614
5000,4359,1753,0.16370947277271786,419,182,0.1501801350795648,3940,1571,0.16527684353029498,479,0.8,0.7,5890,601,5289
1554,3415,0,0.0,346,0,0.0,3069,0,0.0,480,0.8,0.9,124,16,108
5000,2748,3148,0.09999999999999996,270,300,0.10000000000000007,2478,2848,0.09999999999999996,481,0.0,0.1,7557,737,6820
5000,1012,638,0.3000000000000004,107,69,0.3,905,569,0.3000000000000002,482,0.0,0.3,9443,947,8496
5000,2362,574,0.5,258,66,0.5,2104,508,0.5,483,0.0,0.5,8013,780,7233
4329,8921,0,0.0,869,0,0.0,8052,0,0.0,484,0.0,0.7,317,34,283
1453,3284,0,0.0,332,0,0.0,2952,0,0.0,485,0.0,0.9,92,11,81
5000,2888,1929,0.11512073305435411,284,190,0.09420804079461031,2604,1739,0.11740561604995581,486,0.8,0.1,7592,783,6809
5000,2532,1745,0.12749007356941394,248,159,0.12381523288645559,2284,1586,0.12785848445755416,487,0.8,0.3,7920,810,7110
5000,5731,1618,0.16200645366683508,583,161,0.17039374106499403,5148,1457,0.1610796497745196,488,0.8,0.5,4660,448,4212
5000,8446,560,0.26758071322704197,828,57,0.30599494314646447,7618,503,0.2632276096377634,489,0.8,0.7,2032,196,1836
5000,10273,5,0.05183954313746146,1020,0,0.0,9253,5,0.05183954313746146,490,0.8,0.9,173,17,156
5000,1818,2902,0.09999999999999998,172,301,0.10000000000000007,1646,2601,0.09999999999999996,491,0.0,0.1,8678,902,7776
5000,1015,634,0.3000000000000003,107,68,0.3,908,566,0.30000000000000016,492,0.0,0.3,9426,919,8507
1210,2835,0,0.0,255,0,0.0,2580,0,0.0,493,0.0,0.5,53,2,51
5000,7341,79,0.7000000000000005,733,13,0.7,6608,66,0.7000000000000001,494,0.0,0.7,3236,334,2902
3765,7292,0,0.0,736,0,0.0,6556,0,0.0,495,0.0,0.9,582,72,510
5000,4009,2016,0.15124549919146457,398,214,0.1417144176548798,3611,1802,0.15237738123853953,496,0.8,0.1,6488,684,5804
5000,2589,1898,0.12473822529406715,251,188,0.12708636980142493,2338,1710,0.12448006671665007,497,0.8,0.3,7723,752,6971
5000,4370,1640,0.15289000853641152,439,179,0.1578761129940081,3931,1461,0.15227911688828705,498,0.8,0.5,6199,623,5576
5000,3085,1901,0.1311555155702953,294,171,0.1302285168689778,2791,1730,0.13124714376562785,499,0.8,0.7,7228,684,6544
688,1816,0,0.0,167,0,0.0,1649,0,0.0,500,0.8,0.9,54,3,51
5000,3910,2893,0.09999999999999998,409,311,0.10000000000000005,3501,2582,0.10000000000000002,501,0.0,0.1,6332,663,5669
5000,927,631,0.30000000000000027,87,53,0.3,840,578,0.3000000000000001,502,0.0,0.3,9491,928,8563
5000,6141,692,0.5,607,78,0.5,5534,614,0.5,503,0.0,0.5,4391,445,3946
5000,7278,221,0.6999999999999994,739,30,0.6999999999999997,6539,191,0.6999999999999996,504,0.0,0.7,3340,362,2978
683,1758,0,0.0,196,0,0.0,1562,0,0.0,505,0.0,0.9,46,5,41
5000,3032,1792,0.1331627369021337,299,178,0.13556206882876837,2733,1614,0.13289812656573907,506,0.8,0.1,7415,738,6677
5000,2487,1893,0.12704261691062477,271,199,0.12678578912155689,2216,1694,0.1270727873533783,507,0.8,0.3,7930,830,7100
5000,4669,1382,0.17936513910827423,478,141,0.1764345420232673,4191,1241,0.1796981078342903,508,0.8,0.5,5750,567,5183
5000,7459,990,0.20045681433509838,745,112,0.2191776883353447,6714,878,0.1980687301801694,509,0.8,0.7,2829,294,2535
5000,8833,560,0.24992365999366417,877,62,0.24550993225311465,7956,498,0.25047316023445537,510,0.8,0.9,1591,161,1430
5000,1639,2609,0.09999999999999995,171,259,0.10000000000000002,1468,2350,0.10000000000000007,511,0.0,0.1,8510,854,7656
5000,947,585,0.30000000000000027,98,61,0.30000000000000004,849,524,0.30000000000000027,512,0.0,0.3,9445,959,8486
5000,5896,636,0.5,630,59,0.5,5266,577,0.5,513,0.0,0.5,4541,447,4094
1881,4214,0,0.0,427,0,0.0,3787,0,0.0,514,0.0,0.7,104,7,97
894,2217,0,0.0,209,0,0.0,2008,0,0.0,515,0.0,0.9,68,7,61
5000,4417,1914,0.1518706756377452,418,195,0.15936310303452667,3999,1719,0.1510207493187385,516,0.8,0.1,6043,587,5456
5000,6649,1146,0.1706390180184239,692,107,0.17577113706965786,5957,1039,0.17011049372729584,517,0.8,0.3,3790,353,3437
5000,4598,1597,0.13289597118282045,472,164,0.1279941236541915,4126,1433,0.1334569642007515,518,0.8,0.5,5790,589,5201
5000,7868,778,0.1801295016013489,773,75,0.16034728261479395,7095,703,0.1822399801561023,519,0.8,0.7,2651,255,2396
5000,10151,38,0.1667563012864132,1030,5,0.08953544025304684,9121,33,0.17845643174601422,520,0.8,0.9,212,19,193
5000,1514,2763,0.10000000000000002,146,252,0.10000000000000006,1368,2511,0.10000000000000006,521,0.0,0.1,9022,861,8161
5000,915,617,0.30000000000000027,94,52,0.3,821,565,0.30000000000000016,522,0.0,0.3,9581,883,8698
5000,2764,575,0.5,304,67,0.5,2460,508,0.5,523,0.0,0.5,7668,745,6923
5000,8360,29,0.6999999999999997,810,0,0.0,7550,29,0.6999999999999997,524,0.0,0.7,1852,187,1665
1085,2431,0,0.0,256,0,0.0,2175,0,0.0,525,0.0,0.9,171,13,158
5000,3463,1814,0.15140524416920167,292,171,0.18040838508201695,3171,1643,0.14838665798777048,526,0.8,0.1,6901,643,6258
5000,3971,1876,0.15142076656132095,392,197,0.1486890307054058,3579,1679,0.15174128589641042,527,0.8,0.3,6505,647,5858
5000,5298,1503,0.17527243444933466,573,155,0.16879644275519648,4725,1348,0.17601707741119765,528,0.8,0.5,5234,548,4686
5000,2949,1948,0.1338959728703959,294,184,0.12267004756146029,2655,1764,0.13506693106588574,529,0.8,0.7,7453,728,6725
1177,2834,0,0.0,302,0,0.0,2532,0,0.0,530,0.8,0.9,86,11,75
5000,1881,2920,0.09999999999999994,185,336,0.10000000000000006,1696,2584,0.10000000000000002,531,0.0,0.1,8540,907,7633
5000,992,704,0.30000000000000043,102,69,0.3,890,635,0.3000000000000003,532,0.0,0.3,9721,952,8769
5000,3005,681,0.5,306,69,0.5,2699,612,0.5,533,0.0,0.5,7422,764,6658
632,1737,0,0.0,177,0,0.0,1560,0,0.0,534,0.0,0.7,29,2,27
3446,7135,0,0.0,718,0,0.0,6417,0,0.0,535,0.0,0.9,278,21,257
5000,2901,2083,0.12215770232431217,288,205,0.10657089001188354,2613,1878,0.12385913817311295,536,0.8,0.1,7634,752,6882
5000,4038,1576,0.18894091384492043,400,143,0.2088097775268342,3638,1433,0.18695818704344547,537,0.8,0.3,6467,622,5845
5000,8582,644,0.2100601192566714,857,76,0.1984331100464359,7725,568,0.2116158458411395,538,0.8,0.5,1783,198,1585
5000,9636,238,0.2301961860546844,968,21,0.22228251513201003,8668,217,0.23096202517623357,539,0.8,0.7,763,63,700
5000,7257,1070,0.17388406032963033,705,114,0.15410302991362781,6552,956,0.17624288613237546,540,0.8,0.9,3075,293,2782
5000,2531,3121,0.0999999999999999,243,279,0.10000000000000005,2288,2842,0.09999999999999998,541,0.0,0.1,7842,732,7110
5000,752,862,0.3000000000000005,78,91,0.3000000000000001,674,771,0.30000000000000027,542,0.0,0.3,9675,939,8736
2011,4283,0,0.0,422,0,0.0,3861,0,0.0,543,0.0,0.5,211,20,191
2867,5652,0,0.0,592,0,0.0,5060,0,0.0,544,0.0,0.7,700,60,640
726,1785,0,0.0,177,0,0.0,1608,0,0.0,545,0.0,0.9,100,10,90
5000,2568,1919,0.12453929622000996,258,183,0.12174385684843286,2310,1736,0.12483397675284325,546,0.8,0.1,7945,774,7171
5000,2987,1764,0.134475090669396,321,172,0.13504521223384958,2666,1592,0.1344134946209751,547,0.8,0.3,7662,744,6918
5000,3740,1522,0.13604882289893733,390,151,0.11857430720098004,3350,1371,0.13797344133102454,548,0.8,0.5,6622,667,5955
5000,4986,1681,0.1962757235559589,516,206,0.18693765363644493,4470,1475,0.19757988789726053,549,0.8,0.7,5545,612,4933
5000,10264,18,0.12043578974669261,1093,1,0.2100766237353764,9171,17,0.11516279951206417,550,0.8,0.9,166,14,152
5000,1810,2846,0.09999999999999996,182,282,0.10000000000000006,1628,2564,0.10000000000000007,551,0.0,0.1,8526,828,7698
5000,927,646,0.3000000000000002,94,72,0.30000000000000004,833,574,0.3000000000000003,552,0.0,0.3,9641,999,8642
5000,3948,433,0.5,426,40,0.5,3522,393,0.5,553,0.0,0.5,6452,618,5834
5000,6392,176,0.7000000000000003,620,22,0.6999999999999998,5772,154,0.7000000000000003,554,0.0,0.7,4097,439,3658
862,2189,0,0.0,223,0,0.0,1966,0,0.0,555,0.0,0.9,50,2,48
5000,5674,1645,0.1743580631752379,566,180,0.18726179903839157,5108,1465,0.17277262122618145,556,0.8,0.1,4842,477,4365
5000,2894,1881,0.12441972323505675,289,215,0.12294026808827324,2605,1666,0.12461064931942556,557,0.8,0.3,7634,789,6845
5000,10320,1,0.026899251518819556,1026,0,0.0,9294,1,0.026899251518819556,558,0.8,0.5,39,1,38
5000,9959,131,0.2047080750746363,982,9,0.15182375543557802,8977,122,0.20860937734309148,559,0.8,0.7,538,53,485
1231,2814,0,0.0,274,0,0.0,2540,0,0.0,560,0.8,0.9,68,6,62
5000,1945,2839,0.09999999999999999,216,249,0.10000000000000005,1729,2590,0.1,561,0.0,0.1,8432,836,7596
5000,993,644,0.3000000000000002,117,66,0.29999999999999993,876,578,0.3000000000000001,562,0.0,0.3,9488,961,8527
2327,5007,0,0.0,492,0,0.0,4515,0,0.0,563,0.0,0.5,183,14,169
5000,8532,35,0.6999999999999998,872,0,0.0,7660,35,0.6999999999999998,564,0.0,0.7,1975,209,1766
840,2041,0,0.0,181,0,0.0,1860,0,0.0,565,0.0,0.9,34,2,32
5000,4206,1873,0.14915572137144448,406,191,0.15992264705644516,3800,1682,0.14793307998866492,566,0.8,0.1,6319,629,5690
5000,3218,1796,0.14177772858684987,305,169,0.13191543030785974,2913,1627,0.14280214678546654,567,0.8,0.3,7422,746,6676
5000,2057,1596,0.1324793198176584,193,163,0.13594667523101583,1864,1433,0.13208491721306856,568,0.8,0.5,8409,853,7556
960,2323,0,0.0,243,0,0.0,2080,0,0.0,569,0.8,0.7,120,10,110
5000,4906,1551,0.166245480595093,501,153,0.17127202345419995,4405,1398,0.16569536538948262,570,0.8,0.9,5554,558,4996
5000,3287,3047,0.09999999999999994,361,335,0.10000000000000006,2926,2712,0.09999999999999999,571,0.0,0.1,7157,748,6409
5000,792,691,0.3000000000000002,72,71,0.3,720,620,0.3000000000000003,572,0.0,0.3,9674,1016,8658
5000,1646,548,0.5,161,64,0.5,1485,484,0.5,573,0.0,0.5,8703,877,7826
1283,2972,0,0.0,278,0,0.0,2694,0,0.0,574,0.0,0.7,38,5,33
1085,2625,0,0.0,266,0,0.0,2359,0,0.0,575,0.0,0.9,58,4,54
5000,2019,1811,0.11175764255580185,186,184,0.12411730573507251,1833,1627,0.11035986872360411,576,0.8,0.1,8396,861,7535
5000,3107,1771,0.13323477778611284,326,177,0.1481813556102402,2781,1594,0.13157508878054786,577,0.8,0.3,7196,726,6470
5000,4519,1601,0.15406635504929195,434,139,0.14463908022680166,4085,1462,0.15496265545991175,578,0.8,0.5,5928,532,5396
5000,3548,1665,0.15458135962104316,360,170,0.14469805917237943,3188,1495,0.1557052131837674,579,0.8,0.7,7049,724,6325
5000,4163,1530,0.15486364532263133,416,163,0.14243625202444996,3747,1367,0.1563454778812294,580,0.8,0.9,6336,636,5700
5000,1677,2889,0.09999999999999999,163,302,0.10000000000000007,1514,2587,0.10000000000000002,581,0.0,0.1,8916,899,8017
5000,888,675,0.3000000000000002,107,66,0.29999999999999993,781,609,0.30000000000000043,582,0.0,0.3,9587,1002,8585
5000,1262,436,0.5,132,43,0.5,1130,393,0.5,583,0.0,0.5,9188,902,8286
1292,2987,0,0.0,284,0,0.0,2703,0,0.0,584,0.0,0.7,135,17,118
1033,2558,0,0.0,247,0,0.0,2311,0,0.0,585,0.0,0.9,82,8,74
5000,3287,1760,0.13383311736965556,338,184,0.11799488554581494,2949,1576,0.13568225103436793,586,0.8,0.1,7171,705,6466
5000,2311,1988,0.11116046706711434,212,179,0.11116816731164463,2099,1809,0.11115970513025922,587,0.8,0.3,8362,803,7559
5000,3991,1984,0.15817567388832116,415,217,0.180360650287974,3576,1767,0.15545120310239877,588,0.8,0.5,6530,683,5847
5000,10434,5,0.03823974226197699,1060,0,0.0,9374,5,0.03823974226197699,589,0.8,0.7,109,8,101
5000,9522,310,0.30359638952853435,909,24,0.36538384540889307,8613,286,0.2984114281959168,590,0.8,0.9,935,92,843
5000,1954,2902,0.09999999999999998,206,313,0.10000000000000006,1748,2589,0.09999999999999999,591,0.0,0.1,8467,877,7590
5000,754,711,0.3000000000000003,60,70,0.3,694,641,0.30000000000000043,592,0.0,0.3,9726,975,8751
5000,1711,499,0.5,172,42,0.5,1539,457,0.5,593,0.0,0.5,8755,861,7894
2280,4741,0,0.0,464,0,0.0,4277,0,0.0,594,0.0,0.7,415,39,376
824,2078,0,0.0,192,0,0.0,1886,0,0.0,595,0.0,0.9,107,15,92
5000,2709,1864,0.13014854162718711,279,178,0.12688465646755095,2430,1686,0.1304931273676469,596,0.8,0.1,7762,760,7002
5000,2849,1804,0.1538799310720337,272,195,0.15330608460406087,2577,1609,0.1539494774121547,597,0.8,0.3,7699,772,6927
5000,2230,1796,0.13005729367327376,219,168,0.1290753541918185,2011,1628,0.1301586240374534,598,0.8,0.5,8247,847,7400
3319,6811,0,0.0,666,0,0.0,6145,0,0.0,599,0.8,0.7,135,11,124
5000,10336,4,0.07720078645274152,970,0,0.0,9366,4,0.07720078645274152,600,0.8,0.9,166,14,152
5000,2105,3010,0.09999999999999988,197,271,0.10000000000000009,1908,2739,0.09999999999999995,601,0.0,0.1,8439,790,7649
5000,907,620,0.3000000000000003,87,62,0.3000000000000001,820,558,0.3000000000000003,602,0.0,0.3,9472,955,8517
5000,7187,515,0.5,703,52,0.5,6484,463,0.5,603,0.0,0.5,3258,322,2936
1026,2549,0,0.0,233,0,0.0,2316,0,0.0,604,0.0,0.7,50,5,45
1129,2570,0,0.0,265,0,0.0,2305,0,0.0,605,0.0,0.9,164,12,152
5000,2917,1974,0.1314472621638536,301,197,0.12240250891509745,2616,1777,0.13244997256903357,606,0.8,0.1,7612,773,6839
5000,2911,1890,0.13683250261379407,314,165,0.12968155214888286,2597,1725,0.13751650657130723,607,0.8,0.3,7680,742,6938
5000,2900,1872,0.13157355800936757,273,173,0.13822493415081277,2627,1699,0.13089628427630692,608,0.8,0.5,7509,728,6781
2416,5225,0,0.0,517,0,0.0,4708,0,0.0,609,0.8,0.7,75,3,72
5000,8697,563,0.23883961188297126,872,52,0.2675191150224286,7825,511,0.23592114972396583,610,0.8,0.9,1792,178,1614
5000,2144,3056,0.09999999999999991,222,332,0.10000000000000005,1922,2724,0.09999999999999996,611,0.0,0.1,8415,838,7577
5000,1051,602,0.3000000000000003,109,57,0.30000000000000004,942,545,0.3000000000000004,612,0.0,0.3,9216,900,8316
5000,4230,763,0.5,431,72,0.5,3799,691,0.5,613,0.0,0.5,6135,582,5553
5000,8858,45,0.6999999999999997,919,4,0.7,7939,41,0.6999999999999998,614,0.0,0.7,1400,130,1270
889,2156,0,0.0,215,0,0.0,1941,0,0.0,615,0.0,0.9,103,8,95
5000,3475,1732,0.15811995931634443,357,194,0.16834164477416966,3118,1538,0.15683061797771103,616,0.8,0.1,7014,738,6276
5000,2764,1887,0.11617229422554103,298,173,0.11764341534018932,2466,1714,0.11602380883882336,617,0.8,0.3,7678,760,6918
5000,3039,1945,0.12007300794358632,297,183,0.11478584576420037,2742,1762,0.1206221286466667,618,0.8,0.5,7540,745,6795
5000,8391,713,0.1855791422344173,853,67,0.22703972901900854,7538,646,0.18127905041620113,619,0.8,0.7,2102,190,1912
5000,6222,1242,0.20439850754164138,598,127,0.20569648124993314,5624,1115,0.2042506665901139,620,0.8,0.9,4315,449,3866
5000,3036,2898,0.09999999999999998,331,286,0.10000000000000007,2705,2612,0.09999999999999995,621,0.0,0.1,7363,701,6662
5000,975,684,0.3000000000000004,112,66,0.29999999999999993,863,618,0.30000000000000027,622,0.0,0.3,9579,924,8655
5000,2541,645,0.5,268,71,0.5,2273,574,0.5,623,0.0,0.5,7910,824,7086
1173,2733,0,0.0,257,0,0.0,2476,0,0.0,624,0.0,0.7,77,3,74
3017,6000,0,0.0,599,0,0.0,5401,0,0.0,625,0.0,0.9,479,44,435
5000,2338,2003,0.12372153686697175,210,207,0.1293285920184067,2128,1796,0.12307528941911705,626,0.8,0.1,8153,803,7350
5000,4888,1483,0.18757840988598212,494,140,0.1768659275712643,4394,1343,0.18869512434916935,627,0.8,0.3,5617,558,5059
5000,7758,779,0.15490861058900574,757,74,0.14464563193905633,7001,705,0.1559858594118373,628,0.8,0.5,2522,243,2279
5000,6521,1209,0.16018109450786663,653,128,0.14672894829614552,5868,1081,0.1617739480833526,629,0.8,0.7,4027,393,3634
762,1993,0,0.0,212,0,0.0,1781,0,0.0,630,0.8,0.9,34,1,33
5000,1874,2713,0.09999999999999998,217,245,0.10000000000000003,1657,2468,0.10000000000000006,631,0.0,0.1,8528,840,7688
5000,898,739,0.30000000000000027,99,56,0.3,799,683,0.3000000000000003,632,0.0,0.3,9504,953,8551
5000,1134,384,0.5,107,42,0.5,1027,342,0.5,633,0.0,0.5,9519,997,8522
936,2239,0,0.0,222,0,0.0,2017,0,0.0,634,0.0,0.7,108,14,94
1146,2670,0,0.0,273,0,0.0,2397,0,0.0,635,0.0,0.9,100,9,91
5000,3090,1978,0.13780199122203607,292,184,0.14481306702008553,2798,1794,0.13708290652480015,636,0.8,0.1,7496,733,6763
5000,5767,1239,0.17303562872187525,560,140,0.18810921398169114,5207,1099,0.17111542677794978,637,0.8,0.3,4593,472,4121
5000,2952,1823,0.12683631082827398,295,180,0.12361203803399808,2657,1643,0.12718954826160916,638,0.8,0.5,7458,729,6729
5000,7019,1056,0.1701517851717902,720,107,0.1534731812963092,6299,949,0.17203230215248205,639,0.8,0.7,3709,374,3335
5000,4424,1567,0.16721000797645694,432,143,0.17529734518936618,3992,1424,0.16639786666926168,640,0.8,0.9,6061,585,5476
5000,1574,2611,0.09999999999999996,169,281,0.10000000000000006,1405,2330,0.10000000000000005,641,0.0,0.1,8936,896,8040
5000,903,638,0.3000000000000004,85,64,0.3000000000000001,818,574,0.3000000000000003,642,0.0,0.3,9474,950,8524
5000,1862,564,0.5,182,52,0.5,1680,512,0.5,643,0.0,0.5,8536,839,7697
3066,6317,0,0.0,609,0,0.0,5708,0,0.0,644,0.0,0.7,217,26,191
875,2225,0,0.0,229,0,0.0,1996,0,0.0,645,0.0,0.9,36,1,35
5000,4170,1815,0.1601235275258115,381,168,0.18288342915312505,3789,1647,0.15780193464579403,646,0.8,0.1,6204,573,5631
5000,3257,1736,0.15357380140921034,335,175,0.15699227003649233,2922,1561,0.15319056501601727,647,0.8,0.3,7189,714,6475
5000,3513,1752,0.13688812352110422,339,165,0.14388668715348502,3174,1587,0.13616048458011942,648,0.8,0.5,6975,694,6281
982,2337,0,0.0,241,0,0.0,2096,0,0.0,649,0.8,0.7,47,5,42
1114,2645,0,0.0,284,0,0.0,2361,0,0.0,650,0.8,0.9,80,7,73
5000,1769,2808,0.09999999999999992,176,271,0.10000000000000009,1593,2537,0.10000000000000007,651,0.0,0.1,8669,872,7797
5000,1079,633,0.30000000000000027,122,59,0.30000000000000004,957,574,0.3000000000000003,652,0.0,0.3,9670,949,8721
5000,6996,423,0.5,725,47,0.5,6271,376,0.5,653,0.0,0.5,3583,349,3234
5000,8673,93,0.7000000000000003,878,7,0.7000000000000001,7795,86,0.7000000000000001,654,0.0,0.7,1920,190,1730
778,1894,0,0.0,200,0,0.0,1694,0,0.0,655,0.0,0.9,82,3,79
5000,3456,1822,0.12197917937483696,364,198,0.10187673075454931,3092,1624,0.12443009367706415,656,0.8,0.1,7061,701,6360
5000,2431,2052,0.1219129084480412,254,202,0.11891437636154517,2177,1850,0.1222403157353235,657,0.8,0.3,8054,814,7240
5000,2695,1821,0.13637801609879996,260,162,0.1424407013735468,2435,1659,0.13578599981518993,658,0.8,0.5,7850,729,7121
5000,3854,1802,0.15827394628947114,370,176,0.1691731876675212,3484,1626,0.1570942006052542,659,0.8,0.7,6508,675,5833
1354,3144,0,0.0,332,0,0.0,2812,0,0.0,660,0.8,0.9,63,5,58
5000,2963,2937,0.0999999999999999,303,309,0.10000000000000005,2660,2628,0.09999999999999992,661,0.0,0.1,7436,753,6683
5000,820,750,0.30000000000000043,81,79,0.3000000000000001,739,671,0.30000000000000043,662,0.0,0.3,9718,924,8794
5000,1604,627,0.5,152,51,0.5,1452,576,0.5,663,0.0,0.5,8952,880,8072
1104,2592,0,0.0,263,0,0.0,2329,0,0.0,664,0.0,0.7,96,7,89
1064,2508,0,0.0,256,0,0.0,2252,0,0.0,665,0.0,0.9,92,12,80
5000,2346,1826,0.12552712489215426,229,169,0.12143210138750994,2117,1657,0.1259447826907571,666,0.8,0.1,8149,819,7330
5000,3738,1902,0.1400937292256817,378,180,0.13831686446714414,3360,1722,0.14027946421786325,667,0.8,0.3,6946,687,6259
5000,8586,709,0.2045608737684032,872,86,0.22024856615340124,7714,623,0.20239531751622042,668,0.8,0.5,2042,218,1824
5000,5831,1478,0.18270930928743995,557,151,0.17538060662165958,5274,1327,0.18354324606402836,669,0.8,0.7,4704,460,4244
1967,4370,0,0.0,448,0,0.0,3922,0,0.0,670,0.8,0.9,52,4,48
5000,1782,2753,0.0999999999999999,181,268,0.10000000000000007,1601,2485,0.10000000000000007,671,0.0,0.1,8692,837,7855
5000,1020,728,0.3000000000000004,111,66,0.29999999999999993,909,662,0.30000000000000027,672,0.0,0.3,9387,903,8484
5000,1459,410,0.5,126,31,0.5,1333,379,0.5,673,0.0,0.5,8951,909,8042
1136,2648,0,0.0,286,0,0.0,2362,0,0.0,674,0.0,0.7,71,10,61
1737,3608,0,0.0,346,0,0.0,3262,0,0.0,675,0.0,0.9,356,38,318
5000,4066,1883,0.13365116211681385,420,215,0.12970781316575888,3646,1668,0.13415944750319084,676,0.8,0.1,6511,635,5876
5000,8936,416,0.17850426916422518,939,43,0.1901425196812724,7997,373,0.17716259417164332,677,0.8,0.3,1342,124,1218
5000,4504,1604,0.17051974417110277,443,145,0.1774700121294801,4061,1459,0.16982900472356008,678,0.8,0.5,5925,554,5371
5000,5934,1486,0.18123625423536266,585,150,0.17608124479191417,5349,1336,0.1818150352357498,679,0.8,0.7,4438,414,4024
5000,3110,1661,0.15055702848736544,309,163,0.1446344125973016,2801,1498,0.1512014786810105,680,0.8,0.9,7407,784,6623
5000,1871,2989,0.09999999999999992,181,305,0.10000000000000009,1690,2684,0.09999999999999992,681,0.0,0.1,8642,850,7792
5000,1000,684,0.3000000000000004,88,77,0.30000000000000004,912,607,0.30000000000000043,682,0.0,0.3,9541,994,8547
5000,1633,456,0.5,151,41,0.5,1482,415,0.5,683,0.0,0.5,8871,885,7986
3155,6246,0,0.0,655,0,0.0,5591,0,0.0,684,0.0,0.7,502,43,459
709,1843,0,0.0,194,0,0.0,1649,0,0.0,685,0.0,0.9,33,2,31
5000,2934,1988,0.13222532514641921,300,200,0.15026541268614627,2634,1788,0.13020741826278084,686,0.8,0.1,7411,720,6691
5000,2566,1614,0.14191683310356265,255,144,0.13990653172560077,2311,1470,0.14211376058548544,687,0.8,0.3,7847,778,7069
5000,4716,1527,0.17329721073653184,512,177,0.17341446155402046,4204,1350,0.1732818378515721,688,0.8,0.5,5669,626,5043
5000,4261,1488,0.17519581629448602,419,138,0.16734848841261085,3842,1350,0.17599798758907764,689,0.8,0.7,6285,634,5651
5000,7117,1123,0.19318201921928568,731,104,0.17776944505318745,6386,1019,0.19475503954634588,690,0.8,0.9,3315,325,2990
5000,1581,2799,0.09999999999999995,152,298,0.10000000000000006,1429,2501,0.10000000000000007,691,0.0,0.1,9104,961,8143
5000,796,783,0.30000000000000043,77,73,0.30000000000000004,719,710,0.30000000000000027,692,0.0,0.3,9574,934,8640
5000,1521,344,0.5,147,31,0.5,1374,313,0.5,693,0.0,0.5,8964,873,8091
5000,8526,69,0.7000000000000002,897,9,0.7000000000000001,7629,60,0.7000000000000004,694,0.0,0.7,1970,204,1766
841,2192,0,0.0,207,0,0.0,1985,0,0.0,695,0.0,0.9,30,3,27
5000,2580,1934,0.12849405421200105,268,188,0.11860216926027961,2312,1746,0.12955915980817725,696,0.8,0.1,8065,824,7241
5000,2590,1795,0.1405410733547452,252,175,0.139813460177184,2338,1620,0.14061967354367927,697,0.8,0.3,7767,823,6944
5000,2758,1640,0.1391939504953914,261,148,0.15335374210069017,2497,1492,0.13778935990719823,698,0.8,0.5,7649,733,6916
5000,5485,1266,0.18721901023741297,532,110,0.18026255874030542,4953,1156,0.18788095631412738,699,0.8,0.7,5098,472,4626
5000,2100,1665,0.15299368083727868,207,157,0.1531329709957892,1893,1508,0.1529791791430571,700,0.8,0.9,8352,875,7477
5000,1897,2963,0.09999999999999998,188,300,0.10000000000000007,1709,2663,0.09999999999999998,701,0.0,0.1,8575,888,7687
5000,984,929,0.3000000000000005,103,99,0.3,881,830,0.30000000000000043,702,0.0,0.3,9569,918,8651
5000,1624,396,0.5,157,36,0.5,1467,360,0.5,703,0.0,0.5,8846,852,7994
2244,4823,0,0.0,469,0,0.0,4354,0,0.0,704,0.0,0.7,146,19,127
1165,2745,0,0.0,301,0,0.0,2444,0,0.0,705,0.0,0.9,92,5,87
5000,6145,1576,0.17632538555534244,611,138,0.18549485542180105,5534,1438,0.1754454225222608,706,0.8,0.1,4292,413,3879
5000,2565,1765,0.10876231344041004,251,190,0.1041232295710993,2314,1575,0.10932194895480309,707,0.8,0.3,7731,781,6950
5000,2189,1632,0.11845204155991718,225,172,0.11027290147156138,1964,1460,0.11941561148813445,708,0.8,0.5,8339,840,7499
5000,8286,769,0.1845664581933227,795,59,0.17120848544780168,7491,710,0.1856764869144293,709,0.8,0.7,2130,196,1934
5000,10299,2,0.028203719861270064,989,0,0.0,9310,2,0.028203719861270064,710,0.8,0.9,194,15,179
5000,1831,2929,0.09999999999999991,175,282,0.10000000000000006,1656,2647,0.10000000000000002,711,0.0,0.1,8688,868,7820
5000,899,675,0.3000000000000002,87,62,0.3000000000000001,812,613,0.3000000000000002,712,0.0,0.3,9510,971,8539
3068,6360,0,0.0,672,0,0.0,5688,0,0.0,713,0.0,0.5,192,17,175
588,1623,0,0.0,145,0,0.0,1478,0,0.0,714,0.0,0.7,24,3,21
879,2201,0,0.0,212,0,0.0,1989,0,0.0,715,0.0,0.9,22,1,21
5000,2422,1708,0.11986998700122267,217,165,0.10195411976098229,2205,1543,0.12178581207875973,716,0.8,0.1,7989,780,7209
5000,6837,1054,0.18248630982445757,726,115,0.2093889389213246,6111,939,0.1791915256432652,717,0.8,0.3,3653,368,3285
5000,2288,1668,0.11770572934762989,245,173,0.1101403380768622,2043,1495,0.1185811893408358,718,0.8,0.5,8193,862,7331
5000,4755,1592,0.1741904371229439,495,167,0.17268419402056545,4260,1425,0.17436695824441562,719,0.8,0.7,5746,569,5177
743,1889,0,0.0,175,0,0.0,1714,0,0.0,720,0.8,0.9,34,0,34
5000,1993,3010,0.09999999999999988,174,276,0.10000000000000003,1819,2734,0.09999999999999995,721,0.0,0.1,8603,810,7793
5000,916,676,0.3000000000000002,107,70,0.3,809,606,0.3000000000000004,722,0.0,0.3,9619,948,8671
5000,3489,784,0.5,331,83,0.5,3158,701,0.5,723,0.0,0.5,7004,684,6320
1202,2741,0,0.0,259,0,0.0,2482,0,0.0,724,0.0,0.7,145,8,137
1128,2600,0,0.0,285,0,0.0,2315,0,0.0,725,0.0,0.9,98,11,87
5000,2727,1888,0.12052980300539794,253,188,0.11898107986275318,2474,1700,0.1207010735647022,726,0.8,0.1,7890,766,7124
5000,3287,1766,0.12851658998184615,337,184,0.12542766964401317,2950,1582,0.12887585758118952,727,0.8,0.3,7287,728,6559
5000,4669,1667,0.15367415602366288,471,156,0.1836657740377322,4198,1511,0.150577734838888,728,0.8,0.5,5930,535,5395
5000,4675,1441,0.1779027439561071,453,143,0.16316213293483747,4222,1298,0.1795267095770944,729,0.8,0.7,5818,568,5250
486,1442,0,0.0,137,0,0.0,1305,0,0.0,730,0.8,0.9,27,3,24
5000,2134,3002,0.09999999999999991,200,308,0.10000000000000003,1934,2694,0.09999999999999996,731,0.0,0.1,8413,873,7540
5000,827,666,0.3000000000000004,80,59,0.30000000000000004,747,607,0.30000000000000043,732,0.0,0.3,9608,969,8639
5000,1414,402,0.5,134,44,0.5,1280,358,0.5,733,0.0,0.5,9011,928,8083
1080,2405,0,0.0,251,0,0.0,2154,0,0.0,734,0.0,0.7,106,11,95
811,2039,0,0.0,197,0,0.0,1842,0,0.0,735,0.0,0.9,73,8,65
5000,2982,1995,0.14218022024504856,290,199,0.1422088033056497,2692,1796,0.1421770531910064,736,0.8,0.1,7514,742,6772
5000,4035,1804,0.15037167306444885,372,189,0.1496680179101153,3663,1615,0.15045402032399624,737,0.8,0.3,6460,623,5837
2415,5121,0,0.0,526,0,0.0,4595,0,0.0,738,0.8,0.5,74,5,69
5000,6120,1309,0.20532675299267553,598,133,0.2034310015893108,5522,1176,0.2055411534490084,739,0.8,0.7,4366,465,3901
1599,3475,0,0.0,340,0,0.0,3135,0,0.0,740,0.8,0.9,113,10,103
5000,2049,2937,0.0999999999999999,209,294,0.10000000000000005,1840,2643,0.10000000000000002,741,0.0,0.1,8445,861,7584
5000,1037,604,0.3000000000000004,116,55,0.3,921,549,0.30000000000000016,742,0.0,0.3,9407,903,8504
5000,1361,329,0.5,135,36,0.5,1226,293,0.5,743,0.0,0.5,9072,932,8140
5000,8178,24,0.6999999999999998,813,2,0.7,7365,22,0.6999999999999998,744,0.0,0.7,2261,235,2026
1136,2602,0,0.0,254,0,0.0,2348,0,0.0,745,0.0,0.9,134,22,112
5000,3456,1876,0.1356866143916153,358,195,0.13991598057408333,3098,1681,0.13519599785051997,746,0.8,0.1,7275,744,6531
5000,3201,1739,0.14452841358671872,336,190,0.16162511767410936,2865,1549,0.1424313356160252,747,0.8,0.3,7261,758,6503
5000,4325,1613,0.15908952722203915,440,158,0.16052948335049047,3885,1455,0.15893316085207673,748,0.8,0.5,6166,664,5502
5000,9918,145,0.1711922205194257,956,17,0.21196555069734402,8962,128,0.16577701260517091,749,0.8,0.7,516,50,466
633,1698,0,0.0,178,0,0.0,1520,0,0.0,750,0.8,0.9,24,3,21
5000,1634,2869,0.09999999999999991,163,306,0.10000000000000003,1471,2563,0.10000000000000007,751,0.0,0.1,8719,901,7818
5000,8799,696,0.3000000000000003,858,65,0.3000000000000001,7941,631,0.30000000000000027,752,0.0,0.3,1625,145,1480
5000,4680,692,0.5,438,63,0.5,4242,629,0.5,753,0.0,0.5,5757,537,5220
5000,6647,161,0.7000000000000004,654,11,0.7000000000000001,5993,150,0.7000000000000002,754,0.0,0.7,3790,407,3383
2252,4239,0,0.0,409,0,0.0,3830,0,0.0,755,0.0,0.9,670,68,602
5000,4005,1729,0.15873079915662977,387,177,0.14548043884688172,3618,1552,0.160241954939378,756,0.8,0.1,6392,625,5767
5000,3768,1728,0.13612395472126262,379,159,0.12356316676640298,3389,1569,0.13739684527882964,757,0.8,0.3,6743,662,6081
5000,6461,1172,0.17991845172455861,640,121,0.1822488912316456,5821,1051,0.17965015183839542,758,0.8,0.5,4079,404,3675
5000,4483,1465,0.15287059467601505,469,142,0.1410867878788299,4014,1323,0.154135372125146,759,0.8,0.7,5958,588,5370
5000,8912,400,0.20906061509474905,897,34,0.18780253329930097,8015,366,0.21103540957847924,760,0.8,0.9,1468,135,1333
5000,2006,3039,0.09999999999999995,189,304,0.10000000000000009,1817,2735,0.09999999999999996,761,0.0,0.1,8550,856,7694
5000,1012,653,0.3000000000000004,100,65,0.3000000000000001,912,588,0.3000000000000003,762,0.0,0.3,9514,946,8568
5000,1949,729,0.5,192,74,0.5,1757,655,0.5,763,0.0,0.5,8391,830,7561
2497,4984,0,0.0,462,0,0.0,4522,0,0.0,764,0.0,0.7,470,39,431
1692,3842,0,0.0,363,0,0.0,3479,0,0.0,765,0.0,0.9,84,8,76
5000,2626,2100,0.13132769155211127,238,205,0.1265632379172352,2388,1895,0.13184310738068628,766,0.8,0.1,7725,715,7010
5000,2045,1740,0.13189017020028118,195,176,0.14292572132101442,1850,1564,0.13064831790024983,767,0.8,0.3,8432,829,7603
5000,5573,1290,0.16440410762010915,550,130,0.149590253176228,5023,1160,0.1660642809629579,768,0.8,0.5,4776,461,4315
5000,7310,1053,0.1844706491878124,692,103,0.19550926124545925,6618,950,0.18327383124893082,769,0.8,0.7,3125,299,2826
1403,3185,0,0.0,320,0,0.0,2865,0,0.0,770,0.8,0.9,88,6,82
5000,1737,2855,0.09999999999999996,178,302,0.10000000000000007,1559,2553,0.10000000000000009,771,0.0,0.1,8843,888,7955
5000,917,666,0.3000000000000004,98,71,0.3,819,595,0.3000000000000002,772,0.0,0.3,9665,963,8702
2018,4387,0,0.0,441,0,0.0,3946,0,0.0,773,0.0,0.5,88,8,80
1192,2866,0,0.0,257,0,0.0,2609,0,0.0,774,0.0,0.7,57,5,52
812,2029,0,0.0,216,0,0.0,1813,0,0.0,775,0.0,0.9,92,7,85
5000,2447,2083,0.11339257222961147,245,207,0.10789435586548354,2202,1876,0.11399925175379827,776,0.8,0.1,7953,798,7155
5000,3852,1873,0.1608297918853218,387,197,0.18148673070117796,3465,1676,0.15840173881448424,777,0.8,0.3,6565,679,5886
5000,3272,1613,0.16769686646896678,322,159,0.17683477291644406,2950,1454,0.16669760434713116,778,0.8,0.5,7246,736,6510
5000,3745,1772,0.16491658402631296,360,181,0.1658130470827275,3385,1591,0.16481459797149772,779,0.8,0.7,6753,704,6049
5000,9816,101,0.1803743385622942,963,11,0.14313591518223603,8853,90,0.18492570141985684,780,0.8,0.9,558,57,501
5000,3861,3062,0.09999999999999991,401,311,0.10000000000000005,3460,2751,0.09999999999999992,781,0.0,0.1,6680,660,6020
5000,1007,657,0.30000000000000043,97,79,0.3000000000000001,910,578,0.3000000000000001,782,0.0,0.3,9480,930,8550
5000,2307,738,0.5,208,66,0.5,2099,672,0.5,783,0.0,0.5,8071,786,7285
1605,3598,0,0.0,379,0,0.0,3219,0,0.0,784,0.0,0.7,121,16,105
1105,2464,0,0.0,246,0,0.0,2218,0,0.0,785,0.0,0.9,212,19,193
5000,2240,1939,0.11243388486576548,223,190,0.11033826837494728,2017,1749,0.11266153903000532,786,0.8,0.1,8197,837,7360
5000,4012,1627,0.1452231985005338,417,160,0.14515463479951712,3595,1467,0.14523067647746815,787,0.8,0.3,6536,640,5896
5000,6390,1250,0.1783856342253427,675,123,0.18110516558211887,5715,1127,0.17808882645525984,788,0.8,0.5,4213,408,3805
5000,5711,1367,0.1623747395845672,591,140,0.15112847249454336,5120,1227,0.1636579322435756,789,0.8,0.7,4630,456,4174
912,2249,0,0.0,206,0,0.0,2043,0,0.0,790,0.8,0.9,25,2,23
5000,1604,2708,0.1,169,259,0.10000000000000002,1435,2449,0.10000000000000005,791,0.0,0.1,8697,813,7884
5000,944,757,0.30000000000000027,92,77,0.30000000000000004,852,680,0.30000000000000027,792,0.0,0.3,9497,987,8510
5000,1615,408,0.5,164,50,0.5,1451,358,0.5,793,0.0,0.5,8966,904,8062
4730,8923,0,0.0,893,0,0.0,8030,0,0.0,794,0.0,0.7,935,96,839
1805,3785,0,0.0,365,0,0.0,3420,0,0.0,795,0.0,0.9,272,26,246
5000,2172,1749,0.11442832845232521,215,184,0.11994126381867208,1957,1565,0.11378016224950874,796,0.8,0.1,8286,811,7475
5000,2394,1671,0.13033324523888679,221,137,0.12018904263286925,2173,1534,0.13123921378975018,797,0.8,0.3,8149,812,7337
5000,7935,720,0.21135326992840348,836,80,0.22884477366716824,7099,640,0.20916683196105784,798,0.8,0.5,2458,231,2227
5000,6864,1096,0.2038534830584061,708,92,0.2179586541197428,6156,1004,0.2025609773436224,799,0.8,0.7,3593,345,3248
3286,6904,0,0.0,695,0,0.0,6209,0,0.0,800,0.8,0.9,155,8,147
5000,3546,3155,0.09999999999999996,356,326,0.10000000000000002,3190,2829,0.09999999999999999,801,0.0,0.1,6842,697,6145
5000,885,845,0.30000000000000043,80,97,0.3000000000000001,805,748,0.3000000000000004,802,0.0,0.3,9568,1020,8548
5000,1713,449,0.5,183,41,0.5,1530,408,0.5,803,0.0,0.5,8832,883,7949
1005,2434,0,0.0,240,0,0.0,2194,0,0.0,804,0.0,0.7,33,2,31
4725,9231,0,0.0,905,0,0.0,8326,0,0.0,805,0.0,0.9,718,78,640
5000,2467,1943,0.09557191228325419,247,191,0.08802974620597602,2220,1752,0.09639414614213553,806,0.8,0.1,7987,805,7182
5000,2452,1533,0.142095376606564,233,153,0.16431537108178187,2219,1380,0.13963185547996376,807,0.8,0.3,8112,797,7315
5000,10094,138,0.29783972019638777,1022,10,0.23092235224674687,9072,128,0.30306763956745353,808,0.8,0.5,410,33,377
5000,3808,1804,0.140211727749121,368,188,0.14752273183614126,3440,1616,0.13936119014493792,809,0.8,0.7,6681,660,6021
5000,4114,1632,0.16232220755307233,419,151,0.15677930416434077,3695,1481,0.16288735165280116,810,0.8,0.9,6221,595,5626
5000,1503,2647,0.10000000000000002,139,271,0.10000000000000009,1364,2376,0.10000000000000006,811,0.0,0.1,8971,962,8009
5000,809,695,0.30000000000000027,73,72,0.30000000000000004,736,623,0.3000000000000004,812,0.0,0.3,9600,959,8641
1315,3045,0,0.0,309,0,0.0,2736,0,0.0,813,0.0,0.5,70,4,66
971,2344,0,0.0,226,0,0.0,2118,0,0.0,814,0.0,0.7,60,7,53
714,1910,0,0.0,184,0,0.0,1726,0,0.0,815,0.0,0.9,39,1,38
5000,5521,1595,0.15521132720003702,555,180,0.17971344134718367,4966,1415,0.15209445048873924,816,0.8,0.1,4909,483,4426
5000,3992,1607,0.14214821173846773,433,159,0.14162688703307177,3559,1448,0.14220545664741657,817,0.8,0.3,6220,632,5588
5000,4621,1785,0.17217301169089336,479,162,0.19499571444425315,4142,1623,0.16989496002974463,818,0.8,0.5,5840,590,5250
5000,2227,1832,0.1070114897940306,229,163,0.1050614190004366,1998,1669,0.10720194008723362,819,0.8,0.7,8353,814,7539
918,2228,0,0.0,241,0,0.0,1987,0,0.0,820,0.8,0.9,45,4,41
5000,2491,3046,0.09999999999999994,250,310,0.10000000000000005,2241,2736,0.09999999999999995,821,0.0,0.1,8005,786,7219
5000,898,684,0.3000000000000004,84,56,0.3,814,628,0.3000000000000002,822,0.0,0.3,9722,952,8770
5000,1432,459,0.5,159,53,0.5,1273,406,0.5,823,0.0,0.5,9008,941,8067
573,1568,0,0.0,143,0,0.0,1425,0,0.0,824,0.0,0.7,13,0,13
837,2071,0,0.0,198,0,0.0,1873,0,0.0,825,0.0,0.9,93,8,85
5000,3562,1772,0.16147645375250091,333,161,0.1640170328986316,3229,1611,0.16122255353988327,826,0.8,0.1,6826,692,6134
5000,2530,1599,0.12653446770351287,256,170,0.11795712800264026,2274,1429,0.1275548650087252,827,0.8,0.3,7903,797,7106
5000,2510,1672,0.11901839461214934,270,160,0.1179563328940616,2240,1512,0.1191307820955449,828,0.8,0.5,8022,798,7224
5000,3160,1989,0.13131499171504837,272,178,0.10635247853691925,2888,1811,0.13376851316491417,829,0.8,0.7,7347,717,6630
5000,6939,1203,0.20733665787172384,687,118,0.20989378339177509,6252,1085,0.20705855574143245,830,0.8,0.9,3573,329,3244
5000,2074,2865,0.09999999999999992,217,305,0.10000000000000009,1857,2560,0.10000000000000009,831,0.0,0.1,8419,884,7535
5000,915,715,0.3000000000000004,84,71,0.3,831,644,0.3000000000000002,832,0.0,0.3,9469,939,8530
5000,2003,369,0.5,209,36,0.5,1794,333,0.5,833,0.0,0.5,8461,841,7620
5000,8312,8,0.7000000000000001,822,0,0.0,7490,8,0.7000000000000001,834,0.0,0.7,2113,223,1890
623,1662,0,0.0,155,0,0.0,1507,0,0.0,835,0.0,0.9,42,1,41
5000,3383,1857,0.1458885638578942,326,159,0.14651631546143032,3057,1698,0.14582978146392336,836,0.8,0.1,7056,670,6386
5000,5373,1396,0.17510325707448968,527,135,0.1676086382465541,4846,1261,0.1759056151567825,837,0.8,0.3,5020,530,4490
5000,3595,1737,0.12808678915604824,375,185,0.12423124977334458,3220,1552,0.12854637342524938,838,0.8,0.5,6816,664,6152
5000,2900,1917,0.16460957644378363,264,189,0.17802809436081793,2636,1728,0.16314192604660796,839,0.8,0.7,7516,805,6711
5000,8997,266,0.13019830411205674,890,23,0.11902669446727193,8107,243,0.13125569926362074,840,0.8,0.9,1327,114,1213
5000,2111,2915,0.09999999999999996,221,290,0.10000000000000002,1890,2625,0.09999999999999991,841,0.0,0.1,8330,781,7549
5000,812,648,0.30000000000000027,69,62,0.3000000000000001,743,586,0.30000000000000027,842,0.0,0.3,9730,969,8761
5000,1493,613,0.5,153,58,0.5,1340,555,0.5,843,0.0,0.5,8969,878,8091
1656,3644,0,0.0,328,0,0.0,3316,0,0.0,844,0.0,0.7,160,16,144
1414,3189,0,0.0,331,0,0.0,2858,0,0.0,845,0.0,0.9,118,8,110
5000,4616,1641,0.1559267596572613,452,164,0.16457497964751105,4164,1477,0.15496649690952877,846,0.8,0.1,6044,594,5450
5000,2725,1801,0.1207806906479982,280,176,0.1294866737056038,2445,1625,0.11983776571375906,847,0.8,0.3,7994,789,7205
5000,3789,1718,0.14410699007155697,380,174,0.1451529663982832,3409,1544,0.14398911450105806,848,0.8,0.5,6647,637,6010
3271,6778,0,0.0,703,0,0.0,6075,0,0.0,849,0.8,0.7,142,9,133
2145,4633,0,0.0,444,0,0.0,4189,0,0.0,850,0.8,0.9,47,4,43
5000,1756,2841,0.09999999999999996,155,281,0.10000000000000006,1601,2560,0.10000000000000009,851,0.0,0.1,8679,826,7853
5000,990,676,0.3000000000000002,86,76,0.30000000000000004,904,600,0.30000000000000027,852,0.0,0.3,9317,966,8351
5000,1872,592,0.5,184,65,0.5,1688,527,0.5,853,0.0,0.5,8472,861,7611
1265,2929,0,0.0,292,0,0.0,2637,0,0.0,854,0.0,0.7,54,2,52
1308,2912,0,0.0,281,0,0.0,2631,0,0.0,855,0.0,0.9,148,15,133
5000,4837,1688,0.1636278862335588,482,195,0.16209762344182166,4355,1493,0.163827753108568,856,0.8,0.1,5495,554,4941
5000,5117,1724,0.18321813509370996,502,165,0.18277083134375716,4615,1559,0.18326547641426302,857,0.8,0.3,5516,539,4977
5000,3268,1605,0.14810433617920626,319,148,0.14373141706914563,2949,1457,0.14854853111969288,858,0.8,0.5,7204,704,6500
5000,9445,197,0.24309397528939986,952,17,0.2905315650861247,8493,180,0.23861375847526475,859,0.8,0.7,1110,107,1003
260,985,0,0.0,103,0,0.0,882,0,0.0,860,0.8,0.9,12,1,11
5000,1790,2684,0.09999999999999992,183,268,0.10000000000000007,1607,2416,0.10000000000000007,861,0.0,0.1,8396,819,7577
5000,903,730,0.3000000000000004,95,72,0.30000000000000004,808,658,0.3000000000000002,862,0.0,0.3,9526,944,8582
3171,6785,0,0.0,700,0,0.0,6085,0,0.0,863,0.0,0.5,98,4,94
1629,3632,0,0.0,368,0,0.0,3264,0,0.0,864,0.0,0.7,88,7,81
2139,4463,0,0.0,440,0,0.0,4023,0,0.0,865,0.0,0.9,292,35,257
5000,4096,1932,0.1545727989859323,424,226,0.1342193734323976,3672,1706,0.15726909099947206,866,0.8,0.1,6255,683,5572
5000,4867,1525,0.18625180000693842,492,139,0.18448498703147448,4375,1386,0.18642899120721937,867,0.8,0.3,5690,549,5141
5000,7402,975,0.2247623062855244,719,90,0.2157903458215121,6683,885,0.22567470904457637,868,0.8,0.5,3081,303,2778
5000,4253,1601,0.2111142546203876,412,145,0.20161662791993143,3841,1456,0.21206010343327636,869,0.8,0.7,6164,598,5566
1234,2803,0,0.0,291,0,0.0,2512,0,0.0,870,0.8,0.9,105,10,95
5000,3123,3041,0.09999999999999994,328,270,0.10000000000000007,2795,2771,0.1,871,0.0,0.1,7369,706,6663
5000,748,814,0.30000000000000043,69,97,0.3000000000000001,679,717,0.3000000000000004,872,0.0,0.3,9952,958,8994
2161,4759,0,0.0,482,0,0.0,4277,0,0.0,873,0.0,0.5,64,4,60
1259,2883,0,0.0,291,0,0.0,2592,0,0.0,874,0.0,0.7,112,5,107
884,2166,0,0.0,225,0,0.0,1941,0,0.0,875,0.0,0.9,50,3,47
5000,3003,1936,0.1281703305463352,307,190,0.12846320033469036,2696,1746,0.12813846040899987,876,0.8,0.1,7713,765,6948
5000,4467,1679,0.14731867703969315,447,157,0.13893223885720649,4020,1522,0.14818376954603374,877,0.8,0.3,5981,596,5385
5000,3734,1712,0.14291617167159287,385,173,0.14895483312339822,3349,1539,0.14223736177480123,878,0.8,0.5,6623,661,5962
1281,2966,0,0.0,308,0,0.0,2658,0,0.0,879,0.8,0.7,62,4,58
763,1942,0,0.0,176,0,0.0,1766,0,0.0,880,0.8,0.9,8,1,7
5000,2221,2904,0.09999999999999998,237,304,0.10000000000000009,1984,2600,0.09999999999999998,881,0.0,0.1,8294,887,7407
5000,885,691,0.3000000000000002,90,62,0.3000000000000001,795,629,0.3000000000000002,882,0.0,0.3,9659,995,8664
5000,1722,420,0.5,167,55,0.5,1555,365,0.5,883,0.0,0.5,8653,899,7754
3226,6369,0,0.0,649,0,0.0,5720,0,0.0,884,0.0,0.7,499,52,447
996,2253,0,0.0,214,0,0.0,2039,0,0.0,885,0.0,0.9,168,15,153
5000,3586,1732,0.13390317967698673,364,167,0.13934350520188143,3222,1565,0.13332264653790848,886,0.8,0.1,6805,681,6124
5000,5557,1451,0.1711788258922436,588,134,0.16301279106775246,4969,1317,0.17200969048334594,887,0.8,0.3,4982,472,4510
5000,3059,1774,0.14310312995874264,318,182,0.14012376066766274,2741,1592,0.14344373624704446,888,0.8,0.5,7417,739,6678
5000,2390,1793,0.11354021526392907,257,179,0.11258528387633385,2133,1614,0.11364612153306138,889,0.8,0.7,7950,788,7162
5000,5533,1533,0.1870934353631044,563,162,0.1880032554456873,4970,1371,0.1869859292701952,890,0.8,0.9,4881,508,4373
5000,2781,3210,0.09999999999999996,284,326,0.10000000000000002,2497,2884,0.0999999999999999,891,0.0,0.1,7796,809,6987
5000,1033,631,0.30000000000000027,104,66,0.29999999999999993,929,565,0.30000000000000016,892,0.0,0.3,9346,945,8401
5000,2396,754,0.5,242,81,0.5,2154,673,0.5,893,0.0,0.5,8016,760,7256
652,1731,0,0.0,193,0,0.0,1538,0,0.0,894,0.0,0.7,15,2,13
2096,4294,0,0.0,410,0,0.0,3884,0,0.0,895,0.0,0.9,347,43,304
5000,3284,1957,0.12569042930173518,339,203,0.11866249869191427,2945,1754,0.12650381009637238,896,0.8,0.1,7214,753,6461
5000,4157,1716,0.14244930698287478,423,146,0.14546157060468862,3734,1570,0.14216918565243858,897,0.8,0.3,6408,621,5787
5000,4102,1602,0.1431465893516295,435,138,0.12665710750582498,3667,1464,0.1447009257551275,898,0.8,0.5,6405,633,5772
5000,7404,989,0.18166523961533,753,113,0.16709054734903198,6651,876,0.18354530836657615,899,0.8,0.7,3136,330,2806
5000,4004,1830,0.1602252435634664,394,216,0.14826320484286662,3610,1614,0.16182611119893706,900,0.8,0.9,6404,650,5754
5000,1529,2689,0.09999999999999991,136,258,0.10000000000000002,1393,2431,0.10000000000000009,901,0.0,0.1,8934,857,8077
5000,941,682,0.3000000000000003,105,77,0.30000000000000004,836,605,0.3000000000000004,902,0.0,0.3,9583,929,8654
1484,3337,0,0.0,335,0,0.0,3002,0,0.0,903,0.0,0.5,98,5,93
996,2308,0,0.0,218,0,0.0,2090,0,0.0,904,0.0,0.7,123,12,111
722,1794,0,0.0,177,0,0.0,1617,0,0.0,905,0.0,0.9,54,2,52
5000,3158,1769,0.15496341062236763,326,181,0.15472347284642107,2832,1588,0.1549907586938073,906,0.8,0.1,7207,711,6496
5000,2304,1834,0.11638097268548055,223,163,0.10999659205766302,2081,1671,0.117003745900522,907,0.8,0.3,8255,781,7474
5000,2442,1944,0.13841769339564647,226,199,0.13902283867249166,2216,1745,0.13834868255891739,908,0.8,0.5,8038,865,7173
5000,2628,1788,0.12820889988968173,284,174,0.13903772950947843,2344,1614,0.1270414795960977,909,0.8,0.7,7804,762,7042
5000,8698,493,0.2023362310852811,852,50,0.17636952371598302,7846,443,0.20526701069806869,910,0.8,0.9,1669,158,1511
5000,2914,3181,0.0999999999999999,289,311,0.10000000000000005,2625,2870,0.09999999999999992,911,0.0,0.1,7749,786,6963
5000,923,604,0.3000000000000004,102,45,0.30000000000000016,821,559,0.3000000000000003,912,0.0,0.3,9487,939,8548
5000,3131,866,0.5,325,86,0.5,2806,780,0.5,913,0.0,0.5,7371,731,6640
4868,9444,0,0.0,939,0,0.0,8505,0,0.0,914,0.0,0.7,784,82,702
973,2344,0,0.0,238,0,0.0,2106,0,0.0,915,0.0,0.9,67,8,59
5000,3783,1598,0.1808847966725304,377,171,0.1873688036788914,3406,1427,0.18010780634450813,916,0.8,0.1,6569,685,5884
5000,3527,1817,0.1234593361521868,343,163,0.1087950813167088,3184,1654,0.12490448339413536,917,0.8,0.3,7187,704,6483
5000,5080,1682,0.16112579869478164,535,166,0.15508369544767706,4545,1516,0.16178740102922715,918,0.8,0.5,5471,531,4940
5000,3161,1898,0.13798638255756163,287,190,0.14477780410198657,2874,1708,0.13723089655437617,919,0.8,0.7,7199,746,6453
5000,6821,1144,0.19305466611675662,679,104,0.19581563495877183,6142,1040,0.19277856923255512,920,0.8,0.9,3651,354,3297
5000,1673,2832,0.09999999999999999,151,272,0.10000000000000009,1522,2560,0.10000000000000009,921,0.0,0.1,8872,874,7998
5000,868,682,0.3000000000000003,68,54,0.3,800,628,0.3000000000000002,922,0.0,0.3,9623,1001,8622
5000,6052,596,0.5,604,65,0.5,5448,531,0.5,923,0.0,0.5,4335,430,3905
492,1462,0,0.0,152,0,0.0,1310,0,0.0,924,0.0,0.7,12,0,12
649,1740,0,0.0,177,0,0.0,1563,0,0.0,925,0.0,0.9,82,9,73
5000,5446,1639,0.1498448652480844,555,182,0.15779558537042218,4891,1457,0.14885170734673545,926,0.8,0.1,4918,494,4424
5000,7515,1124,0.18156603463485638,751,118,0.1828043587881902,6764,1006,0.18142078388923674,927,0.8,0.3,3068,305,2763
5000,3886,1732,0.1606849996950599,347,170,0.17115526829161004,3539,1562,0.15954546982219595,928,0.8,0.5,6644,680,5964
5000,4132,1432,0.18116405631683125,404,130,0.1630217594973322,3728,1302,0.18297549916363218,929,0.8,0.7,6426,612,5814
1087,2547,0,0.0,256,0,0.0,2291,0,0.0,930,0.8,0.9,143,20,123
5000,2449,3006,0.0999999999999999,268,301,0.10000000000000007,2181,2705,0.1,931,0.0,0.1,8144,819,7325
5000,943,659,0.30000000000000027,99,65,0.3000000000000001,844,594,0.30000000000000016,932,0.0,0.3,9413,917,8496
5000,1823,636,0.5,178,62,0.5,1645,574,0.5,933,0.0,0.5,8716,844,7872
4994,7523,0,0.0,714,0,0.0,6809,0,0.0,934,0.0,0.7,2881,284,2597
508,1494,0,0.0,149,0,0.0,1345,0,0.0,935,0.0,0.9,39,0,39
5000,3047,1879,0.12222006804020384,306,194,0.12745881982950502,2741,1685,0.12161691204784514,936,0.8,0.1,7441,757,6684
5000,2458,2040,0.1327716068607585,264,206,0.13361821718997444,2194,1834,0.13267651322508864,937,0.8,0.3,8029,811,7218
5000,5156,1563,0.15541297283459163,512,140,0.14795717259609112,4644,1423,0.1561465020217948,938,0.8,0.5,5401,495,4906
5000,3643,1609,0.1752506266223829,349,161,0.17855746235405556,3294,1448,0.17488294668260435,939,0.8,0.7,6864,700,6164
706,1763,0,0.0,175,0,0.0,1588,0,0.0,940,0.8,0.9,65,5,60
5000,1527,2669,0.09999999999999995,158,271,0.10000000000000009,1369,2398,0.10000000000000007,941,0.0,0.1,8851,903,7948
5000,1088,582,0.3000000000000002,125,66,0.29999999999999993,963,516,0.3000000000000001,942,0.0,0.3,9337,934,8403
5000,1724,483,0.5,172,51,0.5,1552,432,0.5,943,0.0,0.5,8877,906,7971
2296,4803,0,0.0,478,0,0.0,4325,0,0.0,944,0.0,0.7,272,26,246
1111,2668,0,0.0,265,0,0.0,2403,0,0.0,945,0.0,0.9,48,3,45
5000,6004,1529,0.16820371519354002,606,144,0.18099650141914428,5398,1385,0.1668736348928274,946,0.8,0.1,4530,426,4104
5000,2100,1604,0.11274373553071722,223,119,0.10051196884683654,1877,1485,0.11372392424141207,947,0.8,0.3,8575,851,7724
1126,2718,0,0.0,262,0,0.0,2456,0,0.0,948,0.8,0.5,35,2,33
750,1935,0,0.0,179,0,0.0,1756,0,0.0,949,0.8,0.7,44,3,41
5000,6014,1262,0.18876277994163634,610,150,0.19842430689772203,5404,1112,0.18745951641338737,950,0.8,0.9,4234,450,3784
5000,1717,2840,0.09999999999999998,155,266,0.10000000000000006,1562,2574,0.10000000000000003,951,0.0,0.1,8610,878,7732
5000,804,777,0.3000000000000004,76,81,0.3000000000000001,728,696,0.3000000000000003,952,0.0,0.3,9629,977,8652
5000,1943,634,0.5,194,73,0.5,1749,561,0.5,953,0.0,0.5,8559,878,7681
5000,8562,22,0.6999999999999998,819,1,0.7,7743,21,0.6999999999999998,954,0.0,0.7,2016,188,1828
678,1825,0,0.0,179,0,0.0,1646,0,0.0,955,0.0,0.9,43,4,39
5000,2635,1897,0.12405347377507339,248,185,0.11504146713370268,2387,1712,0.1250273179506888,956,0.8,0.1,7882,771,7111
5000,2728,1585,0.13315231518088605,286,146,0.13689884464701144,2442,1439,0.1327721947486037,957,0.8,0.3,7644,737,6907
5000,2396,1791,0.13601417616433925,250,186,0.11883924609780963,2146,1605,0.13800454189167544,958,0.8,0.5,8092,857,7235
5000,6814,1097,0.1616096097223097,720,112,0.16964101907339277,6094,985,0.16069639363365867,959,0.8,0.7,3629,345,3284
5000,5551,1450,0.16530834674920755,582,157,0.15624727113768014,4969,1293,0.16640857016066138,960,0.8,0.9,4847,496,4351
5000,1518,2634,0.10000000000000003,153,285,0.10000000000000007,1365,2349,0.10000000000000006,961,0.0,0.1,8924,926,7998
5000,901,727,0.3000000000000003,74,68,0.3,827,659,0.30000000000000027,962,0.0,0.3,9646,952,8694
5000,1384,404,0.5,142,37,0.5,1242,367,0.5,963,0.0,0.5,9129,922,8207
1683,3728,0,0.0,395,0,0.0,3333,0,0.0,964,0.0,0.7,137,19,118
593,1564,0,0.0,149,0,0.0,1415,0,0.0,965,0.0,0.9,32,0,32
5000,2594,1944,0.1440439844902432,262,201,0.14928132171508088,2332,1743,0.14344002305467668,966,0.8,0.1,8040,846,7194
5000,2604,1772,0.12922673816496044,278,175,0.1405187295665373,2326,1597,0.12798935651481896,967,0.8,0.3,7813,784,7029
5000,8058,706,0.2241217192906664,813,89,0.19187141971894578,7245,617,0.22877370739744626,968,0.8,0.5,2458,268,2190
5000,10426,12,0.08033854274276579,1020,0,0.0,9406,12,0.08033854274276579,969,0.8,0.7,108,5,103
2725,5861,0,0.0,563,0,0.0,5298,0,0.0,970,0.8,0.9,66,9,57
5000,1676,3039,0.09999999999999995,183,325,0.10000000000000002,1493,2714,0.09999999999999999,971,0.0,0.1,8642,894,7748
5000,987,674,0.3000000000000002,106,81,0.3000000000000001,881,593,0.3000000000000004,972,0.0,0.3,9545,1003,8542
5000,1462,599,0.5,140,69,0.5,1322,530,0.5,973,0.0,0.5,9151,930,8221
2554,5307,0,0.0,471,0,0.0,4836,0,0.0,974,0.0,0.7,289,30,259
939,2217,0,0.0,216,0,0.0,2001,0,0.0,975,0.0,0.9,133,13,120
5000,4148,1763,0.15471497249888683,413,183,0.17320525568840775,3735,1580,0.15257337640794863,976,0.8,0.1,6434,634,5800
5000,3014,1907,0.13306139869140515,290,191,0.11009469147730924,2724,1716,0.13561771633586456,977,0.8,0.3,7377,745,6632
5000,3254,1900,0.14868621594417633,353,207,0.1519703878297649,2901,1693,0.14828466628066966,978,0.8,0.5,7284,721,6563
5000,5226,1422,0.17664125609914869,542,144,0.17170392441395654,4684,1278,0.17719757516226892,979,0.8,0.7,5067,502,4565
5000,2733,1786,0.14077232365584508,280,171,0.13841546901378834,2453,1615,0.1410218729708864,980,0.8,0.9,7892,837,7055
5000,1896,2970,0.09999999999999996,184,311,0.10000000000000005,1712,2659,0.09999999999999999,981,0.0,0.1,8372,832,7540
5000,843,657,0.30000000000000043,86,58,0.30000000000000004,757,599,0.30000000000000027,982,0.0,0.3,9707,1034,8673
5000,1786,578,0.5,168,61,0.5,1618,517,0.5,983,0.0,0.5,8497,862,7635
875,2169,0,0.0,197,0,0.0,1972,0,0.0,984,0.0,0.7,57,1,56
816,2079,0,0.0,207,0,0.0,1872,0,0.0,985,0.0,0.9,43,5,38
5000,3038,1922,0.13925789411495018,298,186,0.14219666701239553,2740,1736,0.1389430255902238,986,0.8,0.1,7418,740,6678
5000,2660,1643,0.11823685273675245,253,186,0.11547107291639673,2407,1457,0.11858993101169146,987,0.8,0.3,7757,818,6939
5000,2967,1594,0.12476254185346251,330,151,0.11173526870133504,2637,1443,0.1261257561611349,988,0.8,0.5,7425,736,6689
854,2152,0,0.0,222,0,0.0,1930,0,0.0,989,0.8,0.7,32,0,32
5000,9722,149,0.13783864119403985,998,18,0.11704241812133745,8724,131,0.14069613749410587,990,0.8,0.9,787,79,708
5000,1579,2751,0.09999999999999992,150,275,0.10000000000000002,1429,2476,0.10000000000000006,991,0.0,0.1,8817,852,7965
5000,975,610,0.30000000000000016,100,65,0.3000000000000001,875,545,0.3000000000000004,992,0.0,0.3,9619,914,8705
5000,1669,580,0.5,160,51,0.5,1509,529,0.5,993,0.0,0.5,8857,864,7993
1430,3282,0,0.0,370,0,0.0,2912,0,0.0,994,0.0,0.7,85,7,78
556,1522,0,0.0,171,0,0.0,1351,0,0.0,995,0.0,0.9,58,4,54
5000,4090,1889,0.1374320704318169,401,192,0.12975483420693776,3689,1697,0.13830067936238657,996,0.8,0.1,6416,618,5798
5000,2718,1917,0.13030294973432857,270,226,0.13276844197622184,2448,1691,0.12997343983091764,997,0.8,0.3,7837,852,6985
5000,2940,1821,0.16380328912064634,296,172,0.1604918563897625,2644,1649,0.16414869023023523,998,0.8,0.5,7574,782,6792
5000,4160,1874,0.1657416377332303,447,184,0.18207114401618152,3713,1690,0.1639637506586368,999,0.8,0.7,6214,635,5579
5000,10560,2,0.02985461381327998,1079,0,0.0,9481,2,0.02985461381327998,1000,0.8,0.9,96,12,84
