step,susceptible_status,infected_status,filtermeanvirulence_pathogen,susceptible_status_is_minority,infected_status_is_minority,filtermeanvirulence_pathogen_is_minority,susceptible_status_#84_f=is_minority,infected_status_#84_f=is_minority,filtermeanvirulence_pathogen_#84_f=is_minority,ensemble,mutation_rate,virulence_init,total_infected,total_minority_infected,total_majority_infected
5000,1751,2823,0.09999999999999998,171,292,0.10000000000000003,1580,2531,0.10000000000000007,1,0.0,0.1,8757,938,7819
5000,923,624,0.3000000000000004,87,68,0.3,836,556,0.30000000000000027,2,0.0,0.3,9560,972,8588
5000,2249,635,0.5,263,72,0.5,1986,563,0.5,3,0.0,0.5,8215,825,7390
5000,7608,159,0.7000000000000003,763,8,0.7000000000000001,6845,151,0.7000000000000002,4,0.0,0.7,2949,249,2700
2175,4738,0,0.0,451,0,0.0,4287,0,0.0,5,0.0,0.9,125,14,111
5000,2462,1828,0.11713625823734103,233,172,0.12268386850332647,2229,1656,0.11656005717106716,6,0.8,0.1,7948,841,7107
5000,4034,1680,0.1527853278437977,401,155,0.14959841782066374,3633,1525,0.15310924328877193,7,0.8,0.3,6581,602,5979
5000,2894,1870,0.14391180837540044,336,215,0.11898529123668652,2558,1655,0.1471499964024841,8,0.8,0.5,7443,732,6711
5000,2811,1772,0.14330369199115522,290,156,0.14398563158229694,2521,1616,0.14323786118904006,9,0.8,0.7,7747,745,7002
766,1834,0,0.0,181,0,0.0,1653,0,0.0,10,0.8,0.9,84,4,80
5000,1934,2836,0.09999999999999999,190,276,0.10000000000000003,1744,2560,0.10000000000000009,11,0.0,0.1,8494,854,7640
5000,850,759,0.3000000000000003,90,91,0.3000000000000001,760,668,0.3000000000000004,12,0.0,0.3,9794,991,8803
5000,1492,534,0.5,127,42,0.5,1365,492,0.5,13,0.0,0.5,9173,931,8242
776,1843,0,0.0,200,0,0.0,1643,0,0.0,14,0.0,0.7,112,7,105
1930,4278,0,0.0,432,0,0.0,3846,0,0.0,15,0.0,0.9,114,11,103
5000,2717,1976,0.12677966863598997,271,196,0.10662740070235006,2446,1780,0.1289986824084582,16,0.8,0.1,7838,789,7049
5000,2195,1858,0.12183830399851495,224,158,0.11711899351229474,1971,1700,0.12227692226723427,17,0.8,0.3,8275,796,7479
5000,3773,1697,0.15444784903163206,371,174,0.14758066816793894,3402,1523,0.15523241204560612,18,0.8,0.5,6696,679,6017
5000,5969,1406,0.1818800923409109,615,152,0.18859729434031475,5354,1254,0.18106588603795287,19,0.8,0.7,4512,434,4078
2000,4378,0,0.0,414,0,0.0,3964,0,0.0,20,0.8,0.9,80,15,65
5000,1878,2982,0.09999999999999994,189,310,0.10000000000000005,1689,2672,0.09999999999999995,21,0.0,0.1,8594,894,7700
5000,958,686,0.3000000000000004,97,76,0.30000000000000004,861,610,0.30000000000000016,22,0.0,0.3,9349,919,8430
5000,3196,716,0.5,340,72,0.5,2856,644,0.5,23,0.0,0.5,7315,721,6594
5000,9943,13,0.7,973,1,0.7,8970,12,0.7000000000000001,24,0.0,0.7,475,32,443
1373,3055,0,0.0,331,0,0.0,2724,0,0.0,25,0.0,0.9,128,7,121
5000,2691,1806,0.12436447533609515,255,156,0.12974474941982267,2436,1650,0.12385579487727,26,0.8,0.1,7755,750,7005
5000,2763,1727,0.13606237952838984,312,170,0.13550442189225026,2451,1557,0.1361232997584115,27,0.8,0.3,7732,757,6975
5000,6258,1198,0.1798922757857466,582,111,0.18267697903701005,5676,1087,0.17960791326422842,28,0.8,0.5,4202,421,3781
5000,5365,1533,0.1663113911180848,493,128,0.19721073461634028,4872,1405,0.16349636195952483,29,0.8,0.7,5109,486,4623
947,2335,0,0.0,226,0,0.0,2109,0,0.0,30,0.8,0.9,72,5,67
5000,2183,3074,0.09999999999999988,211,298,0.10000000000000006,1972,2776,0.09999999999999999,31,0.0,0.1,8299,808,7491
5000,916,711,0.3000000000000003,103,90,0.3000000000000001,813,621,0.3000000000000003,32,0.0,0.3,9451,950,8501
5000,4257,676,0.5,446,81,0.5,3811,595,0.5,33,0.0,0.5,6242,665,5577
3634,7564,0,0.0,755,0,0.0,6809,0,0.0,34,0.0,0.7,305,40,265
1560,3468,0,0.0,333,0,0.0,3135,0,0.0,35,0.0,0.9,177,18,159
5000,3549,1992,0.14056491184057623,319,186,0.1262822773854466,3230,1806,0.14203588083761615,36,0.8,0.1,6897,657,6240
5000,2478,1769,0.12180263986049546,232,197,0.11595612002820838,2246,1572,0.12253531441963067,37,0.8,0.3,8062,821,7241
5000,4700,1633,0.18479323277719445,474,173,0.1960572922929312,4226,1460,0.18345851887567213,38,0.8,0.5,5931,593,5338
5000,6538,1222,0.1960146781073555,640,91,0.13958418463452277,5898,1131,0.2005550626396524,39,0.8,0.7,3879,398,3481
968,2385,0,0.0,246,0,0.0,2139,0,0.0,40,0.8,0.9,62,2,60
5000,2319,3072,0.09999999999999988,236,294,0.10000000000000005,2083,2778,0.09999999999999998,41,0.0,0.1,8197,830,7367
5000,913,695,0.30000000000000027,61,75,0.30000000000000004,852,620,0.3000000000000003,42,0.0,0.3,9748,1010,8738
5000,2002,482,0.5,216,35,0.5,1786,447,0.5,43,0.0,0.5,8459,831,7628
3140,6461,0,0.0,635,0,0.0,5826,0,0.0,44,0.0,0.7,339,44,295
1549,3369,0,0.0,326,0,0.0,3043,0,0.0,45,0.0,0.9,169,19,150
5000,3590,1998,0.133007264876945,332,216,0.11931329363021899,3258,1782,0.13466714017957843,46,0.8,0.1,6937,710,6227
5000,2890,1881,0.14013811143675906,270,191,0.14426321586385366,2620,1690,0.13967190140979144,47,0.8,0.3,7606,816,6790
5000,2291,1666,0.12616215063069228,236,172,0.13081503602877026,2055,1494,0.1256264770774999,48,0.8,0.5,8142,767,7375
5000,6170,1280,0.1980366736006157,652,111,0.23391835996737986,5518,1169,0.1946296015846099,49,0.8,0.7,4459,401,4058
5000,6913,1002,0.2124968249794371,694,101,0.2503492402943784,6219,901,0.20825365744690755,50,0.8,0.9,3658,376,3282
5000,1766,2900,0.09999999999999998,175,292,0.10000000000000003,1591,2608,0.09999999999999996,51,0.0,0.1,8753,848,7905
5000,929,724,0.3000000000000003,98,77,0.30000000000000004,831,647,0.30000000000000027,52,0.0,0.3,9785,976,8809
5000,3605,831,0.5,396,92,0.5,3209,739,0.5,53,0.0,0.5,6872,685,6187
5000,9181,38,0.6999999999999998,912,5,0.7,8269,33,0.6999999999999997,54,0.0,0.7,1298,147,1151
1076,2508,0,0.0,266,0,0.0,2242,0,0.0,55,0.0,0.9,73,3,70
5000,3035,1841,0.13088163156759508,265,225,0.13128568709160346,2770,1616,0.13082537383683898,56,0.8,0.1,7188,754,6434
5000,3130,1742,0.13570336344332212,324,174,0.14941141585784856,2806,1568,0.13418218925956726,57,0.8,0.3,7285,715,6570
5000,4763,1647,0.16527214225006076,506,170,0.16032912960387272,4257,1477,0.16584107396966266,58,0.8,0.5,5744,558,5186
5000,5151,1380,0.17930443390838754,509,140,0.17423263997675345,4642,1240,0.17987705580389457,59,0.8,0.7,5341,524,4817
5000,6983,1154,0.20782565879219994,676,123,0.19310515481988028,6307,1031,0.20958183918850967,60,0.8,0.9,3530,366,3164
5000,3879,3045,0.09999999999999992,382,295,0.10000000000000005,3497,2750,0.09999999999999992,61,0.0,0.1,6611,685,5926
5000,953,626,0.30000000000000016,104,61,0.30000000000000004,849,565,0.30000000000000016,62,0.0,0.3,9585,922,8663
5000,1643,486,0.5,162,57,0.5,1481,429,0.5,63,0.0,0.5,8881,892,7989
5000,9820,11,0.7000000000000001,1037,0,0.0,8783,11,0.7000000000000001,64,0.0,0.7,663,70,593
683,1802,0,0.0,184,0,0.0,1618,0,0.0,65,0.0,0.9,39,1,38
5000,3520,1797,0.1283337143106572,377,186,0.1460185126810633,3143,1611,0.12629189401463267,66,0.8,0.1,6853,676,6177
5000,4301,1732,0.1931409577217205,353,188,0.2060083253198927,3948,1544,0.19157420570847145,67,0.8,0.3,6289,641,5648
5000,2993,1709,0.1331076009108761,304,168,0.1173999416205023,2689,1541,0.1348200517614814,68,0.8,0.5,7527,751,6776
5000,3986,1615,0.15717604623698433,428,151,0.17101967539636573,3558,1464,0.15574818557915193,69,0.8,0.7,6698,638,6060
5000,7279,1083,0.1616568436921882,739,119,0.17381687231114812,6540,964,0.1601557613211755,70,0.8,0.9,3121,335,2786
5000,1900,2919,0.09999999999999995,214,242,0.1,1686,2677,0.09999999999999994,71,0.0,0.1,8570,822,7748
5000,953,622,0.3000000000000004,98,56,0.3,855,566,0.30000000000000016,72,0.0,0.3,9456,976,8480
5000,1384,473,0.5,128,58,0.5,1256,415,0.5,73,0.0,0.5,9025,905,8120
2462,5082,0,0.0,531,0,0.0,4551,0,0.0,74,0.0,0.7,325,22,303
3023,6069,0,0.0,581,0,0.0,5488,0,0.0,75,0.0,0.9,556,54,502
5000,2557,1941,0.12565658766416826,248,233,0.14839766424321107,2309,1708,0.1225543213626946,76,0.8,0.1,7841,803,7038
5000,2445,1819,0.125514524043874,248,205,0.11976383663313848,2197,1614,0.12624493973111117,77,0.8,0.3,8053,857,7196
5000,2940,1771,0.12711066207506833,269,184,0.14055952105464672,2671,1587,0.12555137407743608,78,0.8,0.5,7455,750,6705
5000,4761,1487,0.18760177735771313,482,127,0.16594797662094699,4279,1360,0.1896238602206317,79,0.8,0.7,5557,553,5004
5000,4550,1699,0.16767628532636777,434,159,0.15509380135971484,4116,1540,0.16897538594370404,80,0.8,0.9,6059,627,5432
5000,1895,3031,0.09999999999999996,178,337,0.10000000000000007,1717,2694,0.09999999999999996,81,0.0,0.1,8590,837,7753
5000,913,642,0.30000000000000016,71,69,0.3,842,573,0.3000000000000003,82,0.0,0.3,9534,912,8622
5000,1736,467,0.5,207,49,0.5,1529,418,0.5,83,0.0,0.5,8654,874,7780
1829,3961,0,0.0,383,0,0.0,3578,0,0.0,84,0.0,0.7,106,8,98
1047,2502,0,0.0,247,0,0.0,2255,0,0.0,85,0.0,0.9,106,5,101
5000,2295,1923,0.11666874053785985,257,189,0.1360156726912152,2038,1734,0.11455999187754605,86,0.8,0.1,8146,781,7365
5000,3910,1726,0.14719157792733414,383,177,0.12649772198782044,3527,1549,0.14955620833488348,87,0.8,0.3,6490,684,5806
5000,2836,1798,0.13773457037170184,295,163,0.15687211732997228,2541,1635,0.13582666813671831,88,0.8,0.5,7429,694,6735
5000,3958,1553,0.1536644058489896,316,158,0.17900935563010673,3642,1395,0.15079379504940787,89,0.8,0.7,6601,707,5894
5000,10180,23,0.12632770038266614,1000,5,0.2089830116706691,9180,18,0.10336789169155422,90,0.8,0.9,221,23,198
5000,1639,2743,0.09999999999999994,124,274,0.10000000000000002,1515,2469,0.10000000000000006,91,0.0,0.1,8895,860,8035
5000,1001,653,0.3000000000000004,83,71,0.3,918,582,0.3000000000000002,92,0.0,0.3,9578,980,8598
5000,1837,472,0.5,219,50,0.5,1618,422,0.5,93,0.0,0.5,8675,893,7782
1050,2522,0,0.0,247,0,0.0,2275,0,0.0,94,0.0,0.7,60,5,55
1277,2889,0,0.0,268,0,0.0,2621,0,0.0,95,0.0,0.9,128,11,117
5000,3422,1868,0.13011851012580844,349,212,0.12187296068558652,3073,1656,0.13117409978844558,96,0.8,0.1,7124,757,6367
5000,2758,1711,0.1459167944687321,276,189,0.12336116853679135,2482,1522,0.14871772305029368,97,0.8,0.3,7543,764,6779
5000,5185,1428,0.1759846715116111,520,111,0.1880298853969383,4665,1317,0.1749694712524833,98,0.8,0.5,5144,494,4650
5000,9815,186,0.1519151889441461,980,17,0.1950135720040642,8835,169,0.14757984863634369,99,0.8,0.7,734,61,673
5000,8611,659,0.19347378874134757,900,57,0.16995684830225594,7711,602,0.1957004757928895,100,0.8,0.9,1869,175,1694
5000,1744,2677,0.09999999999999994,189,293,0.10000000000000003,1555,2384,0.10000000000000006,101,0.0,0.1,8835,916,7919
5000,992,658,0.3000000000000002,105,76,0.30000000000000004,887,582,0.3000000000000002,102,0.0,0.3,9494,947,8547
5000,1853,523,0.5,195,61,0.5,1658,462,0.5,103,0.0,0.5,8584,878,7706
5000,8590,80,0.7000000000000005,792,7,0.7000000000000001,7798,73,0.7000000000000003,104,0.0,0.7,2049,236,1813
3349,6836,0,0.0,647,0,0.0,6189,0,0.0,105,0.0,0.9,314,47,267
5000,3073,1971,0.12954718003905077,272,221,0.12735758073540004,2801,1750,0.12982369515111178,106,0.8,0.1,7391,785,6606
5000,2369,1756,0.11672173201976242,238,160,0.11919307374218739,2131,1596,0.11647397846362957,107,0.8,0.3,8025,760,7265
5000,5919,1352,0.18113377842382825,662,141,0.19492918993290193,5257,1211,0.17952754141079813,108,0.8,0.5,4627,423,4204
5000,6736,1197,0.1992434069938963,665,111,0.23240266545900645,6071,1086,0.1958542010181806,109,0.8,0.7,3712,345,3367
5000,3542,1931,0.15577317593306042,361,212,0.14274078443451463,3181,1719,0.1573804284040853,110,0.8,0.9,6679,675,6004
5000,2526,3165,0.09999999999999992,272,317,0.10000000000000007,2254,2848,0.09999999999999996,111,0.0,0.1,8087,802,7285
5000,967,699,0.3000000000000003,100,76,0.30000000000000004,867,623,0.3000000000000004,112,0.0,0.3,9538,935,8603
5000,1744,531,0.5,179,52,0.5,1565,479,0.5,113,0.0,0.5,8526,855,7671
5000,8828,44,0.6999999999999997,937,7,0.7000000000000001,7891,37,0.6999999999999998,114,0.0,0.7,1860,192,1668
1060,2547,0,0.0,273,0,0.0,2274,0,0.0,115,0.0,0.9,76,3,73
5000,4416,1788,0.15573071062970892,426,180,0.1559107666551553,3990,1608,0.15571055510447232,116,0.8,0.1,6093,599,5494
5000,2579,1756,0.13022594100146415,265,162,0.12265000942842588,2314,1594,0.1309958913871807,117,0.8,0.3,7873,739,7134
5000,3694,1824,0.14108246801498164,434,186,0.12719656055559295,3260,1638,0.1426592560415056,118,0.8,0.5,6751,606,6145
5000,4146,1630,0.17407361637700544,416,141,0.1544981774957444,3730,1489,0.17592730132143644,119,0.8,0.7,6443,627,5816
5000,8139,898,0.22627143216467596,825,109,0.25279336175725814,7314,789,0.22260743935657523,120,0.8,0.9,2420,246,2174
5000,1837,2946,0.0999999999999999,160,291,0.10000000000000003,1677,2655,0.1,121,0.0,0.1,8658,841,7817
5000,888,616,0.30000000000000027,89,64,0.3000000000000001,799,552,0.3000000000000002,122,0.0,0.3,9507,972,8535
5000,1878,541,0.5,199,42,0.5,1679,499,0.5,123,0.0,0.5,8687,928,7759
5000,9433,30,0.6999999999999997,956,2,0.7,8477,28,0.6999999999999998,124,0.0,0.7,969,86,883
2189,4818,0,0.0,488,0,0.0,4330,0,0.0,125,0.0,0.9,140,14,126
5000,3215,1960,0.1407491112484021,302,225,0.14631156550020435,2913,1735,0.14002775550969576,126,0.8,0.1,7294,755,6539
5000,2556,1847,0.13044290374394343,225,188,0.10288644234253992,2331,1659,0.13356563716375286,127,0.8,0.3,7767,759,7008
5000,3104,1863,0.13557073716044743,261,194,0.13620242409083722,2843,1669,0.13549731159753817,128,0.8,0.5,7441,750,6691
5000,8359,602,0.2273922709387192,868,55,0.21866150711010604,7491,547,0.2282701356746858,129,0.8,0.7,2003,175,1828
5000,7788,953,0.20792401069242722,800,86,0.2179396344917735,6988,867,0.2069305347446258,130,0.8,0.9,2839,260,2579
5000,1535,2780,0.09999999999999998,162,283,0.10000000000000006,1373,2497,0.10000000000000007,131,0.0,0.1,8882,893,7989
5000,956,655,0.3000000000000004,106,60,0.30000000000000004,850,595,0.3000000000000002,132,0.0,0.3,9426,901,8525
5000,1538,494,0.5,136,45,0.5,1402,449,0.5,133,0.0,0.5,8856,857,7999
5000,9118,33,0.6999999999999997,950,3,0.6999999999999998,8168,30,0.6999999999999997,134,0.0,0.7,1432,146,1286
648,1706,0,0.0,160,0,0.0,1546,0,0.0,135,0.0,0.9,71,3,68
5000,2578,1890,0.12404147953878848,249,189,0.13212219811555126,2329,1701,0.12314362191914818,136,0.8,0.1,7923,783,7140
5000,3012,1951,0.1349545329521862,310,168,0.11746820101934652,2702,1783,0.13660215144052995,137,0.8,0.3,7545,751,6794
5000,2805,1761,0.14279167039228055,255,183,0.12635193750677776,2550,1578,0.14469817933907841,138,0.8,0.5,7689,773,6916
5000,4770,1589,0.16280677248520523,497,188,0.17268305063507147,4273,1401,0.16148147605966998,139,0.8,0.7,5671,597,5074
5000,10182,80,0.14037305202209463,1087,7,0.17781977740271976,9095,73,0.13678227013628125,140,0.8,0.9,252,32,220
5000,2849,3170,0.09999999999999992,295,310,0.10000000000000005,2554,2860,0.09999999999999994,141,0.0,0.1,7654,752,6902
5000,861,665,0.3000000000000003,102,46,0.30000000000000016,759,619,0.3000000000000003,142,0.0,0.3,9575,941,8634
5000,1436,490,0.5,135,49,0.5,1301,441,0.5,143,0.0,0.5,8908,857,8051
2456,4865,0,0.0,508,0,0.0,4357,0,0.0,144,0.0,0.7,377,38,339
1311,2991,0,0.0,288,0,0.0,2703,0,0.0,145,0.0,0.9,102,12,90
5000,4433,1943,0.14665926474652277,465,185,0.1487688536861649,3968,1758,0.14643726591043985,146,0.8,0.1,6346,624,5722
5000,3577,2038,0.1510872607361523,382,184,0.18073977779178013,3195,1854,0.148144400359542,147,0.8,0.3,6936,682,6254
5000,4159,1743,0.16886338860555472,413,177,0.16045045610892544,3746,1566,0.16981427561187873,148,0.8,0.5,6125,610,5515
5000,3397,1620,0.14310734168369094,353,161,0.1603010173855137,3044,1459,0.14121002722996,149,0.8,0.7,6921,681,6240
5000,6757,1130,0.18994880134127504,642,119,0.22745991421067213,6115,1011,0.1855335467107526,150,0.8,0.9,3712,431,3281
5000,2062,3092,0.09999999999999996,211,316,0.10000000000000007,1851,2776,0.09999999999999999,151,0.0,0.1,8438,876,7562
5000,842,724,0.3000000000000003,78,82,0.30000000000000004,764,642,0.30000000000000016,152,0.0,0.3,9699,981,8718
5000,2324,689,0.5,249,62,0.5,2075,627,0.5,153,0.0,0.5,8265,831,7434
1728,3825,0,0.0,392,0,0.0,3433,0,0.0,154,0.0,0.7,111,9,102
741,1889,0,0.0,183,0,0.0,1706,0,0.0,155,0.0,0.9,37,3,34
5000,3381,1952,0.14162682558410727,330,188,0.1404830139567384,3051,1764,0.14174872841060682,156,0.8,0.1,7098,716,6382
5000,2825,1655,0.13015187890964255,307,158,0.1275144625093537,2518,1497,0.13043024349965301,157,0.8,0.3,7675,780,6895
5000,2994,1785,0.12373855402646644,315,166,0.11615737838122249,2679,1619,0.12451587036810359,158,0.8,0.5,7542,734,6808
5000,8776,491,0.20026995725348765,831,51,0.18828904745466843,7945,440,0.20165865361653254,159,0.8,0.7,1673,178,1495
5000,4279,1637,0.1804759115086614,403,159,0.16927929146018778,3876,1478,0.18168041934878812,160,0.8,0.9,6265,613,5652
5000,1653,2790,0.09999999999999996,166,253,0.10000000000000007,1487,2537,0.10000000000000007,161,0.0,0.1,8682,820,7862
5000,908,714,0.3000000000000003,74,73,0.30000000000000004,834,641,0.30000000000000043,162,0.0,0.3,9502,933,8569
5000,1596,428,0.5,181,35,0.5,1415,393,0.5,163,0.0,0.5,8915,878,8037
1332,2887,0,0.0,306,0,0.0,2581,0,0.0,164,0.0,0.7,194,21,173
2618,5393,0,0.0,567,0,0.0,4826,0,0.0,165,0.0,0.9,183,14,169
5000,2988,1863,0.1329929965719509,237,199,0.13434462769037614,2751,1664,0.132831353186995,166,0.8,0.1,7369,810,6559
5000,2927,1814,0.13194330206006769,305,184,0.12473155272312017,2622,1630,0.13275738910178447,167,0.8,0.3,7570,724,6846
5000,5858,1317,0.17701689465188458,573,165,0.13891703958582974,5285,1152,0.1824739051431164,168,0.8,0.5,4544,496,4048
5000,4215,1686,0.16586104682455538,474,168,0.17308580731505982,3741,1518,0.1650614685884521,169,0.8,0.7,6313,585,5728
612,1634,0,0.0,178,0,0.0,1456,0,0.0,170,0.8,0.9,33,5,28
5000,1826,2793,0.09999999999999994,194,283,0.10000000000000006,1632,2510,0.10000000000000006,171,0.0,0.1,8666,874,7792
5000,888,686,0.3000000000000004,100,54,0.3,788,632,0.30000000000000027,172,0.0,0.3,9526,933,8593
5000,1797,672,0.5,179,46,0.5,1618,626,0.5,173,0.0,0.5,8735,864,7871
2482,5236,0,0.0,479,0,0.0,4757,0,0.0,174,0.0,0.7,225,48,177
1542,3334,0,0.0,315,0,0.0,3019,0,0.0,175,0.0,0.9,184,23,161
5000,2554,1879,0.14612412011076156,205,192,0.1408628457183966,2349,1687,0.1467229136397088,176,0.8,0.1,7948,837,7111
5000,2421,1848,0.12815129243890153,209,188,0.10735993285167003,2212,1660,0.13050597653673257,177,0.8,0.3,8005,829,7176
5000,2962,1763,0.12812369042014016,330,161,0.12795150047280046,2632,1602,0.1281409954023634,178,0.8,0.5,7492,701,6791
5000,3181,1883,0.15028470889057483,251,193,0.1386599626764053,2930,1690,0.151612268665329,179,0.8,0.7,7423,780,6643
5000,9269,382,0.25464768370278107,948,39,0.24006203167752263,8321,343,0.25630611060944314,180,0.8,0.9,1260,150,1110
5000,1761,2923,0.09999999999999995,175,278,0.10000000000000005,1586,2645,0.1,181,0.0,0.1,8835,859,7976
5000,885,641,0.30000000000000043,77,71,0.3,808,570,0.30000000000000027,182,0.0,0.3,9568,954,8614
5000,1887,677,0.5,174,69,0.5,1713,608,0.5,183,0.0,0.5,8689,926,7763
5000,9094,7,0.7000000000000001,890,0,0.0,8204,7,0.7000000000000001,184,0.0,0.7,1309,108,1201
871,2153,0,0.0,190,0,0.0,1963,0,0.0,185,0.0,0.9,111,19,92
5000,2631,1805,0.13042759342276802,256,180,0.13660969505834997,2375,1625,0.12974280678005742,186,0.8,0.1,7957,777,7180
5000,4389,1678,0.1650912072032168,473,158,0.17829479979958013,3916,1520,0.1637187284991211,187,0.8,0.3,6165,581,5584
5000,3022,1810,0.139454940217669,321,181,0.13511047794194206,2701,1629,0.13993765824830534,188,0.8,0.5,7448,738,6710
5000,4169,1519,0.1812537255431633,431,153,0.23549305497092696,3738,1366,0.1751786029937871,189,0.8,0.7,6224,594,5630
5000,3992,1762,0.14884284739773437,428,174,0.14895171203146307,3564,1588,0.14883091890512168,190,0.8,0.9,6753,699,6054
5000,1792,2828,0.1,160,302,0.10000000000000007,1632,2526,0.10000000000000007,191,0.0,0.1,8527,874,7653
5000,953,701,0.3000000000000004,86,70,0.3,867,631,0.30000000000000027,192,0.0,0.3,9499,948,8551
5000,1680,519,0.5,185,39,0.5,1495,480,0.5,193,0.0,0.5,8692,856,7836
5000,9719,26,0.6999999999999998,926,6,0.7000000000000001,8793,20,0.7,194,0.0,0.7,654,62,592
520,1485,0,0.0,143,0,0.0,1342,0,0.0,195,0.0,0.9,26,3,23
5000,4161,1845,0.1531121907592,432,170,0.14751278829295308,3729,1675,0.1536804883229384,196,0.8,0.1,6421,609,5812
5000,3810,1769,0.1470284868035145,385,143,0.12975336236287163,3425,1626,0.14854776281520693,197,0.8,0.3,6610,657,5953
5000,4416,1660,0.158646680562069,373,181,0.15109995895030695,4043,1479,0.15957024825086472,198,0.8,0.5,6004,660,5344
5000,8113,667,0.19752587786827677,811,55,0.1771332318381644,7302,612,0.19935855030562336,199,0.8,0.7,2352,214,2138
5000,8983,471,0.21624780020961706,960,32,0.31624791330612523,8023,439,0.2089584981160219,200,0.8,0.9,1424,100,1324
5000,2011,2927,0.09999999999999994,203,293,0.10000000000000003,1808,2634,0.10000000000000003,201,0.0,0.1,8416,808,7608
5000,854,700,0.3000000000000004,90,77,0.30000000000000004,764,623,0.3000000000000004,202,0.0,0.3,9596,925,8671
5000,1856,705,0.5,184,83,0.5,1672,622,0.5,203,0.0,0.5,8541,863,7678
4294,8404,0,0.0,833,0,0.0,7571,0,0.0,204,0.0,0.7,511,53,458
1195,2759,0,0.0,285,0,0.0,2474,0,0.0,205,0.0,0.9,94,19,75
5000,2335,1892,0.1223002787752812,205,220,0.1353521708719503,2130,1672,0.12058292455203524,206,0.8,0.1,8041,838,7203
5000,2740,1742,0.12126418071986167,299,194,0.1292838277471176,2441,1548,0.1202591345161875,207,0.8,0.3,7730,783,6947
5000,3734,1809,0.13628777018929605,357,176,0.1279756106644563,3377,1633,0.13718363061573313,208,0.8,0.5,6652,648,6004
5000,2663,1653,0.14056458599740726,246,167,0.14139146759411456,2417,1486,0.14047165919616222,209,0.8,0.7,7811,804,7007
5000,8866,541,0.21746395350238468,926,45,0.24453584183542437,7940,496,0.21500783460120163,210,0.8,0.9,1568,148,1420
5000,1782,2806,0.09999999999999992,168,264,0.10000000000000005,1614,2542,0.10000000000000009,211,0.0,0.1,8664,851,7813
5000,925,649,0.30000000000000027,92,63,0.3000000000000001,833,586,0.30000000000000027,212,0.0,0.3,9514,904,8610
5000,1388,550,0.5,137,51,0.5,1251,499,0.5,213,0.0,0.5,9174,917,8257
3530,7236,0,0.0,748,0,0.0,6488,0,0.0,214,0.0,0.7,268,15,253
1885,4088,0,0.0,391,0,0.0,3697,0,0.0,215,0.0,0.9,149,9,140
5000,2646,1826,0.1268885070730575,263,215,0.10482729000085758,2383,1611,0.12983274150541194,216,0.8,0.1,7839,818,7021
5000,2388,1941,0.12952371619180206,235,186,0.11781344147205135,2153,1755,0.1307648051364594,217,0.8,0.3,7994,820,7174
5000,5711,1494,0.18443494377774988,599,162,0.20587598094864895,5112,1332,0.18182725006777556,218,0.8,0.5,4745,491,4254
5000,5409,1404,0.17366667965536176,499,155,0.1685700913433206,4910,1249,0.17429916259240447,219,0.8,0.7,5048,534,4514
5000,6907,1051,0.17806652809154902,722,92,0.1423551517715068,6185,959,0.1814924369773092,220,0.8,0.9,3533,316,3217
5000,2679,3146,0.09999999999999998,253,309,0.10000000000000005,2426,2837,0.09999999999999998,221,0.0,0.1,7833,785,7048
5000,857,734,0.30000000000000043,81,70,0.3,776,664,0.3000000000000003,222,0.0,0.3,9741,966,8775
5000,3205,802,0.5,336,77,0.5,2869,725,0.5,223,0.0,0.5,7524,718,6806
5000,9523,24,0.6999999999999998,924,1,0.7,8599,23,0.7,224,0.0,0.7,1000,97,903
1589,3401,0,0.0,325,0,0.0,3076,0,0.0,225,0.0,0.9,149,13,136
5000,5287,1673,0.1525626360995335,527,173,0.1592222050192091,4760,1500,0.15179456581746423,226,0.8,0.1,5232,492,4740
5000,2533,1829,0.12765170707840692,263,186,0.14211787649561303,2270,1643,0.12601402752174207,227,0.8,0.3,8007,820,7187
5000,2771,1836,0.13743493108749455,260,179,0.1541534696072001,2511,1657,0.13562888498307252,228,0.8,0.5,7817,774,7043
5000,9340,377,0.2585403344719541,959,29,0.32566230664989704,8381,348,0.2529468367904589,229,0.8,0.7,1271,114,1157
5000,4410,1694,0.18655964872250097,450,167,0.20549702770616698,3960,1527,0.1844885666725519,230,0.8,0.9,5894,613,5281
5000,2006,3096,0.09999999999999995,200,317,0.10000000000000007,1806,2779,0.09999999999999999,231,0.0,0.1,8494,853,7641
5000,920,692,0.3000000000000002,92,72,0.30000000000000004,828,620,0.3000000000000003,232,0.0,0.3,9584,986,8598
5000,3526,800,0.5,331,67,0.5,3195,733,0.5,233,0.0,0.5,6979,677,6302
708,1842,0,0.0,177,0,0.0,1665,0,0.0,234,0.0,0.7,38,0,38
1031,2452,0,0.0,238,0,0.0,2214,0,0.0,235,0.0,0.9,43,8,35
5000,3309,1912,0.14039932125275253,331,180,0.1286862361986956,2978,1732,0.14161661646622253,236,0.8,0.1,7157,698,6459
5000,2934,1827,0.14213480182970872,297,178,0.13903291469856482,2637,1649,0.14246963258128156,237,0.8,0.3,7430,737,6693
5000,4959,1614,0.16852116096446262,490,200,0.16502335315824035,4469,1414,0.16901590039957182,238,0.8,0.5,5516,609,4907
5000,2990,1595,0.15079137355961938,304,150,0.14552436724418927,2686,1445,0.15133812162004465,239,0.8,0.7,7378,737,6641
1231,2840,0,0.0,253,0,0.0,2587,0,0.0,240,0.8,0.9,73,10,63
5000,1832,2882,0.0999999999999999,178,305,0.10000000000000009,1654,2577,0.10000000000000002,241,0.0,0.1,8572,884,7688
5000,807,784,0.30000000000000043,81,70,0.3,726,714,0.3000000000000003,242,0.0,0.3,9631,1006,8625
5000,1352,478,0.5,147,56,0.5,1205,422,0.5,243,0.0,0.5,9129,854,8275
5000,9129,32,0.6999999999999997,923,5,0.7,8206,27,0.6999999999999998,244,0.0,0.7,1375,160,1215
2490,5291,0,0.0,534,0,0.0,4757,0,0.0,245,0.0,0.9,244,18,226
5000,2943,1821,0.13166475640429592,298,172,0.1252851767377898,2645,1649,0.13233018254294907,246,0.8,0.1,7510,750,6760
5000,3417,1813,0.14550524898983971,307,166,0.17075460977078943,3110,1647,0.14296038324021146,247,0.8,0.3,7060,676,6384
5000,2981,1803,0.12417798634065222,281,166,0.10306782550749205,2700,1637,0.12631866239337342,248,0.8,0.5,7572,749,6823
5000,4207,1759,0.15780907155938287,453,186,0.14800677892210654,3754,1573,0.158968147484706,249,0.8,0.7,6456,650,5806
5000,8536,597,0.22247922390660405,826,72,0.16948352612657386,7710,525,0.22974720531643678,250,0.8,0.9,1994,203,1791
5000,1627,2635,0.10000000000000005,178,252,0.10000000000000006,1449,2383,0.10000000000000006,251,0.0,0.1,8790,830,7960
5000,985,675,0.3000000000000002,117,70,0.3,868,605,0.3000000000000004,252,0.0,0.3,9450,945,8505
5000,2250,604,0.5,220,58,0.5,2030,546,0.5,253,0.0,0.5,8097,809,7288
797,2068,0,0.0,216,0,0.0,1852,0,0.0,254,0.0,0.7,35,1,34
1582,3420,0,0.0,337,0,0.0,3083,0,0.0,255,0.0,0.9,171,18,153
5000,3865,1667,0.1607034686560658,338,175,0.18813321252553333,3527,1492,0.1574861729609204,256,0.8,0.1,6623,671,5952
5000,3191,1830,0.1435396642385715,332,182,0.1408727902148259,2859,1648,0.14383418552032012,257,0.8,0.3,7256,732,6524
5000,4376,1609,0.1822669641803206,421,175,0.1935121736962879,3955,1434,0.1808946408432953,258,0.8,0.5,6182,656,5526
5000,3168,1755,0.14826505980381174,251,184,0.14342838240482897,2917,1571,0.14883154525346978,259,0.8,0.7,7251,770,6481
5000,7329,849,0.2171068403132109,742,87,0.17778296438454583,6587,762,0.22159657417908202,260,0.8,0.9,3167,322,2845
5000,1664,2645,0.1,160,260,0.10000000000000003,1504,2385,0.10000000000000006,261,0.0,0.1,8713,875,7838
5000,902,633,0.30000000000000027,85,66,0.29999999999999993,817,567,0.3000000000000002,262,0.0,0.3,9658,989,8669
5000,2780,585,0.5,294,81,0.5,2486,504,0.5,263,0.0,0.5,7773,744,7029
3368,6706,0,0.0,671,0,0.0,6035,0,0.0,264,0.0,0.7,580,48,532
1703,3801,0,0.0,351,0,0.0,3450,0,0.0,265,0.0,0.9,131,24,107
5000,3324,1937,0.14136218250842408,351,216,0.15118864523095057,2973,1721,0.14012887864551538,266,0.8,0.1,7118,761,6357
5000,3724,1816,0.14225889571298336,372,179,0.14252263648430552,3352,1637,0.1422300566182572,267,0.8,0.3,6995,682,6313
5000,2527,1620,0.14074176425470292,271,142,0.1556644599194742,2256,1478,0.1393080546576816,268,0.8,0.5,7913,741,7172
5000,4383,1626,0.15990512286138575,486,149,0.1957949639994455,3897,1477,0.1562845498555828,269,0.8,0.7,6124,623,5501
5000,7052,1087,0.2110511319174148,699,119,0.1941692877536768,6353,968,0.21312648259456873,270,0.8,0.9,3313,354,2959
5000,1735,2819,0.09999999999999991,182,289,0.10000000000000009,1553,2530,0.10000000000000006,271,0.0,0.1,8927,885,8042
5000,929,608,0.30000000000000043,105,46,0.30000000000000016,824,562,0.3000000000000001,272,0.0,0.3,9523,895,8628
5000,2549,598,0.5,299,52,0.5,2250,546,0.5,273,0.0,0.5,7884,766,7118
1975,4195,0,0.0,428,0,0.0,3767,0,0.0,274,0.0,0.7,192,13,179
1250,2954,0,0.0,301,0,0.0,2653,0,0.0,275,0.0,0.9,63,8,55
5000,3326,2033,0.1331332538799324,326,192,0.1336413817282027,3000,1841,0.13308026064426276,276,0.8,0.1,7294,742,6552
5000,3493,1638,0.12740371195568184,355,156,0.12904304335353936,3138,1482,0.12723115075590738,277,0.8,0.3,6997,709,6288
5000,3441,1774,0.16578750739573433,383,169,0.1702253402023363,3058,1605,0.16532022157373072,278,0.8,0.5,7240,690,6550
5000,9326,508,0.21160576655997745,900,75,0.20876702022018706,8426,433,0.2120974662724123,279,0.8,0.7,1388,194,1194
5000,9317,342,0.21395712214431703,964,28,0.1766352162695828,8353,314,0.21728519018410225,280,0.8,0.9,1164,130,1034
5000,1884,2807,0.09999999999999994,195,265,0.10000000000000005,1689,2542,0.10000000000000009,281,0.0,0.1,8660,832,7828
5000,910,692,0.3000000000000002,117,63,0.3000000000000001,793,629,0.3000000000000002,282,0.0,0.3,9569,890,8679
5000,1413,461,0.5,137,49,0.5,1276,412,0.5,283,0.0,0.5,8990,930,8060
4152,8296,0,0.0,812,0,0.0,7484,0,0.0,284,0.0,0.7,494,49,445
1040,2489,0,0.0,277,0,0.0,2212,0,0.0,285,0.0,0.9,72,9,63
5000,2532,1981,0.11985286050055745,262,202,0.11141744391306388,2270,1779,0.12081067621200978,286,0.8,0.1,7903,786,7117
5000,2431,1795,0.12133496457189326,225,163,0.117598390301203,2206,1632,0.1217081640854487,287,0.8,0.3,8080,773,7307
5000,5998,1337,0.16713850340973624,580,131,0.16245009732249793,5418,1206,0.16764777471771986,288,0.8,0.5,4649,470,4179
5000,4957,1437,0.17567190290131005,550,131,0.1920815656563335,4407,1306,0.174025910695408,289,0.8,0.7,5624,504,5120
5000,6551,1142,0.19421193275496323,631,134,0.18282851465218766,5920,1008,0.19572520460592766,290,0.8,0.9,3889,419,3470
5000,1832,2842,0.09999999999999998,162,316,0.10000000000000007,1670,2526,0.10000000000000007,291,0.0,0.1,8514,900,7614
5000,1026,684,0.3000000000000004,99,53,0.3,927,631,0.30000000000000027,292,0.0,0.3,9328,961,8367
5000,2280,635,0.5,220,57,0.5,2060,578,0.5,293,0.0,0.5,8153,799,7354
3390,6837,0,0.0,674,0,0.0,6163,0,0.0,294,0.0,0.7,354,20,334
581,1587,0,0.0,155,0,0.0,1432,0,0.0,295,0.0,0.9,22,1,21
5000,3344,1861,0.14999606803147256,262,178,0.13794892826753732,3082,1683,0.1512702159090605,296,0.8,0.1,7104,764,6340
5000,2571,1761,0.11753342515332066,256,140,0.1331601077851379,2315,1621,0.11618380419807427,297,0.8,0.3,7953,754,7199
5000,2651,1785,0.12079091138303434,280,199,0.11768210474256328,2371,1586,0.12118098232972649,298,0.8,0.5,7981,808,7173
5000,7043,1049,0.20184141731279967,700,111,0.19780429935247873,6343,938,0.20231915728465014,299,0.8,0.7,3526,355,3171
853,2182,0,0.0,231,0,0.0,1951,0,0.0,300,0.8,0.9,54,4,50
5000,1850,2890,0.1,187,311,0.10000000000000005,1663,2579,0.10000000000000003,301,0.0,0.1,8604,873,7731
5000,877,713,0.3000000000000003,91,74,0.30000000000000004,786,639,0.3000000000000004,302,0.0,0.3,9662,983,8679
5000,3089,722,0.5,312,83,0.5,2777,639,0.5,303,0.0,0.5,7337,714,6623
5000,8691,37,0.6999999999999998,834,6,0.7000000000000001,7857,31,0.6999999999999997,304,0.0,0.7,1790,218,1572
1852,4087,0,0.0,399,0,0.0,3688,0,0.0,305,0.0,0.9,96,9,87
5000,3026,1861,0.14170684071638612,313,185,0.143478293374877,2713,1676,0.1415113044742496,306,0.8,0.1,7388,730,6658
5000,3022,1748,0.13770976296796955,287,156,0.1517485096667813,2735,1592,0.13633410688441763,307,0.8,0.3,7498,709,6789
5000,8130,791,0.17358108097506497,760,90,0.1752039577502489,7370,701,0.1733727230438715,308,0.8,0.5,2320,260,2060
5000,3497,1746,0.1515938767719223,307,183,0.15422133888172587,3190,1563,0.15128624685119668,309,0.8,0.7,6966,749,6217
5000,6665,1017,0.1985582046650776,668,95,0.15901829019922523,5997,922,0.20263227394301245,310,0.8,0.9,3774,389,3385
5000,1608,2731,0.09999999999999996,164,284,0.10000000000000007,1444,2447,0.10000000000000005,311,0.0,0.1,9038,920,8118
5000,886,724,0.3000000000000003,82,70,0.3,804,654,0.3000000000000004,312,0.0,0.3,9663,1011,8652
5000,2499,725,0.5,256,50,0.5,2243,675,0.5,313,0.0,0.5,8143,754,7389
1289,2883,0,0.0,296,0,0.0,2587,0,0.0,314,0.0,0.7,58,3,55
641,1653,0,0.0,159,0,0.0,1494,0,0.0,315,0.0,0.9,53,6,47
5000,3209,1853,0.1403173860645429,281,193,0.15363352465841498,2928,1660,0.13876918440874933,316,0.8,0.1,7217,713,6504
5000,2721,1687,0.1336792229567534,256,175,0.1280725837465527,2465,1512,0.13432813953200812,317,0.8,0.3,7777,769,7008
5000,4876,1506,0.196710998187186,525,154,0.2055370835331827,4351,1352,0.19570566006345555,318,0.8,0.5,5610,526,5084
5000,10125,136,0.2608190228139849,1005,18,0.14075015499615043,9120,118,0.27913461282009533,319,0.8,0.7,374,41,333
5000,9812,232,0.22099635018633215,996,27,0.20009838887247322,8816,205,0.22374876460327942,320,0.8,0.9,765,93,672
5000,1889,3006,0.0999999999999999,183,317,0.10000000000000007,1706,2689,0.09999999999999991,321,0.0,0.1,8576,892,7684
5000,913,627,0.30000000000000016,85,52,0.3,828,575,0.3000000000000003,322,0.0,0.3,9372,960,8412
5000,1227,441,0.5,121,34,0.5,1106,407,0.5,323,0.0,0.5,9140,928,8212
5000,8356,53,0.7000000000000001,833,2,0.7,7523,51,0.7,324,0.0,0.7,2009,194,1815
1072,2582,0,0.0,245,0,0.0,2337,0,0.0,325,0.0,0.9,96,11,85
5000,3331,1898,0.1372854261771101,372,207,0.14835284347577624,2959,1691,0.1359306329300232,326,0.8,0.1,7121,712,6409
5000,5151,1489,0.1875957128644477,548,145,0.20629387477611688,4603,1344,0.1855784260510608,327,0.8,0.3,5188,504,4684
5000,3786,1788,0.1518702877672272,381,147,0.12085807123459272,3405,1641,0.15464834738349606,328,0.8,0.5,6750,642,6108
5000,7266,1060,0.2192367209100573,610,158,0.21002057214267147,6656,902,0.22085107956332445,329,0.8,0.7,3104,400,2704
5000,3107,1703,0.1464543613191789,288,183,0.15555524757494094,2819,1520,0.1453586625133865,330,0.8,0.9,7078,799,6279
5000,1946,3021,0.09999999999999996,185,278,0.10000000000000005,1761,2743,0.09999999999999994,331,0.0,0.1,8456,834,7622
5000,879,824,0.3000000000000004,84,94,0.3000000000000001,795,730,0.3000000000000004,332,0.0,0.3,9486,988,8498
5000,1605,505,0.5,173,44,0.5,1432,461,0.5,333,0.0,0.5,8910,877,8033
5000,8584,51,0.7,855,3,0.6999999999999998,7729,48,0.6999999999999998,334,0.0,0.7,1865,165,1700
1859,4074,0,0.0,390,0,0.0,3684,0,0.0,335,0.0,0.9,161,16,145
5000,3991,1858,0.1545280893991329,333,189,0.17313820993147425,3658,1669,0.15242065214292402,336,0.8,0.1,6541,732,5809
5000,2246,1873,0.12327820305384837,210,169,0.11788298019931222,2036,1704,0.12381329264446844,337,0.8,0.3,8272,860,7412
5000,3167,1781,0.13277271331816273,248,194,0.14094587106946618,2919,1587,0.1317736001462958,338,0.8,0.5,7135,719,6416
5000,5651,1317,0.20221739126866864,504,116,0.24036399934188873,5147,1201,0.19853295618416106,339,0.8,0.7,4681,474,4207
5000,6221,1267,0.1739774975824483,554,147,0.14130964430384133,5667,1120,0.1782651533252655,340,0.8,0.9,4247,474,3773
5000,1831,2917,0.09999999999999994,172,301,0.10000000000000007,1659,2616,0.09999999999999995,341,0.0,0.1,8664,913,7751
5000,871,652,0.3000000000000003,60,68,0.3,811,584,0.3000000000000002,342,0.0,0.3,9571,952,8619
5000,4080,897,0.5,399,83,0.5,3681,814,0.5,343,0.0,0.5,6249,685,5564
5000,9617,12,0.7000000000000001,910,3,0.6999999999999998,8707,9,0.7000000000000001,344,0.0,0.7,702,81,621
1357,3106,0,0.0,266,0,0.0,2840,0,0.0,345,0.0,0.9,111,15,96
5000,2985,1851,0.1409067674984406,301,199,0.14498471110526573,2684,1652,0.1404155382140833,346,0.8,0.1,7536,766,6770
5000,2732,1566,0.11990085017484854,322,142,0.12830533979398545,2410,1424,0.11906276202462565,347,0.8,0.3,7661,701,6960
5000,4049,1614,0.18791773877426218,413,156,0.20114409390518453,3636,1458,0.18650257320469857,348,0.8,0.5,6495,636,5859
934,2251,0,0.0,228,0,0.0,2023,0,0.0,349,0.8,0.7,64,5,59
5000,6772,1219,0.19986154461172329,618,113,0.19350874241518645,6154,1106,0.2005106102972646,350,0.8,0.9,3738,394,3344
5000,1688,2734,0.09999999999999995,183,280,0.10000000000000005,1505,2454,0.10000000000000006,351,0.0,0.1,8575,877,7698
5000,839,676,0.3000000000000002,105,65,0.3000000000000001,734,611,0.30000000000000016,352,0.0,0.3,9525,968,8557
5000,8128,418,0.5,800,42,0.5,7328,376,0.5,353,0.0,0.5,2395,271,2124
5000,9271,79,0.7000000000000005,889,14,0.7,8382,65,0.7000000000000005,354,0.0,0.7,1196,149,1047
2180,4523,0,0.0,464,0,0.0,4059,0,0.0,355,0.0,0.9,300,33,267
5000,2857,1948,0.12386921041650877,290,202,0.13103012380877455,2567,1746,0.12304074277318823,356,0.8,0.1,7582,785,6797
5000,2671,1995,0.12605818405198682,248,203,0.11174072160744891,2423,1792,0.1276800840945321,357,0.8,0.3,7881,792,7089
5000,2744,1875,0.14294377401267222,300,173,0.13773168483969342,2444,1702,0.14347355745974932,358,0.8,0.5,7525,744,6781
5000,4429,1650,0.16817637496814025,433,181,0.1701043709645897,3996,1469,0.16793882066224683,359,0.8,0.7,5921,603,5318
5000,3953,1780,0.17194791334905946,424,166,0.19279881972085064,3529,1614,0.16980339633684302,360,0.8,0.9,6543,657,5886
5000,1427,2634,0.10000000000000003,150,250,0.10000000000000006,1277,2384,0.10000000000000006,361,0.0,0.1,9095,861,8234
5000,941,649,0.30000000000000027,95,65,0.3000000000000001,846,584,0.3000000000000002,362,0.0,0.3,9589,975,8614
5000,3526,685,0.5,370,63,0.5,3156,622,0.5,363,0.0,0.5,7053,698,6355
5000,9303,45,0.6999999999999997,955,7,0.7000000000000001,8348,38,0.6999999999999998,364,0.0,0.7,1014,121,893
1286,2900,0,0.0,288,0,0.0,2612,0,0.0,365,0.0,0.9,114,11,103
5000,2818,1959,0.13305539878732428,285,202,0.1317388738113871,2533,1757,0.13320675794790438,366,0.8,0.1,7729,757,6972
5000,3357,1799,0.15947938006331894,333,167,0.18837242874021143,3024,1632,0.15652279971464178,367,0.8,0.3,7235,679,6556
5000,4440,1591,0.17391401381399726,499,148,0.1948990061785474,3941,1443,0.17176170690481257,368,0.8,0.5,6137,574,5563
5000,3117,1787,0.15118078012329372,325,183,0.16294254222274362,2792,1604,0.14983888332516437,369,0.8,0.7,7298,759,6539
5000,6202,1313,0.1809155204868525,635,115,0.1636663487028391,5567,1198,0.18257132579166183,370,0.8,0.9,4171,404,3767
5000,1764,2805,0.09999999999999992,177,309,0.10000000000000005,1587,2496,0.10000000000000007,371,0.0,0.1,8520,877,7643
5000,914,666,0.3000000000000004,71,65,0.3000000000000001,843,601,0.3000000000000003,372,0.0,0.3,9548,967,8581
5000,1927,578,0.5,192,56,0.5,1735,522,0.5,373,0.0,0.5,8496,885,7611
3857,7796,0,0.0,806,0,0.0,6990,0,0.0,374,0.0,0.7,364,52,312
3268,6832,0,0.0,655,0,0.0,6177,0,0.0,375,0.0,0.9,218,29,189
5000,2720,1913,0.13121647999177263,333,189,0.12536690779644902,2387,1724,0.13185776139833655,376,0.8,0.1,7737,750,6987
5000,2324,1750,0.12255934947645916,253,175,0.11337095417657056,2071,1575,0.1235802822875579,377,0.8,0.3,8206,817,7389
5000,3895,1650,0.16587156030595018,456,164,0.15986303115221356,3439,1486,0.16653468196221716,378,0.8,0.5,6556,602,5954
5000,8850,560,0.20919179240204813,869,60,0.28389652303311536,7981,500,0.20022722472632012,379,0.8,0.7,1750,172,1578
5000,6980,1154,0.1921057640880183,688,121,0.18682212472262497,6292,1033,0.19272466085782722,380,0.8,0.9,3525,335,3190
5000,1996,2844,0.09999999999999998,217,295,0.10000000000000005,1779,2549,0.10000000000000007,381,0.0,0.1,8577,832,7745
5000,901,706,0.3000000000000002,104,75,0.30000000000000004,797,631,0.30000000000000027,382,0.0,0.3,9823,1020,8803
5000,1488,437,0.5,162,46,0.5,1326,391,0.5,383,0.0,0.5,9136,908,8228
2077,4223,0,0.0,413,0,0.0,3810,0,0.0,384,0.0,0.7,365,29,336
1834,3956,0,0.0,393,0,0.0,3563,0,0.0,385,0.0,0.9,214,21,193
5000,2706,1748,0.13043523610288354,243,181,0.13028466489890522,2463,1567,0.13045262818196465,386,0.8,0.1,7744,830,6914
5000,2700,1757,0.12354396026867433,263,146,0.12017210600523937,2437,1611,0.12384954110198379,387,0.8,0.3,7690,748,6942
5000,3239,1766,0.13328173719422687,326,175,0.16002934593499912,2913,1591,0.13033966835096156,388,0.8,0.5,7204,699,6505
5000,2693,1763,0.12842288724726994,263,194,0.13014897273045734,2430,1569,0.1282094643130836,389,0.8,0.7,7810,788,7022
1069,2553,0,0.0,234,0,0.0,2319,0,0.0,390,0.8,0.9,96,20,76
5000,2199,3023,0.09999999999999999,230,319,0.10000000000000009,1969,2704,0.10000000000000002,391,0.0,0.1,8304,855,7449
5000,1007,713,0.3000000000000003,87,73,0.30000000000000004,920,640,0.3000000000000004,392,0.0,0.3,9487,938,8549
5000,3238,803,0.5,320,94,0.5,2918,709,0.5,393,0.0,0.5,7278,720,6558
5000,8372,64,0.7000000000000005,808,12,0.7000000000000001,7564,52,0.7,394,0.0,0.7,2107,258,1849
3241,6626,0,0.0,685,0,0.0,5941,0,0.0,395,0.0,0.9,397,46,351
5000,2504,1774,0.12322170224538448,235,184,0.12131466108239806,2269,1590,0.12344239128562946,396,0.8,0.1,7914,806,7108
5000,2576,1798,0.1309919053306387,224,188,0.10983693720998561,2352,1610,0.13346217490000686,397,0.8,0.3,7921,848,7073
5000,5162,1428,0.17906200335973896,546,155,0.16653347741479704,4616,1273,0.1805874719547633,398,0.8,0.5,5255,546,4709
5000,7211,1089,0.16540352015516893,735,133,0.1869750725685132,6476,956,0.16240245690101135,399,0.8,0.7,3347,362,2985
5000,8338,611,0.2156861244436364,873,50,0.242427176888535,7465,561,0.21330278643606967,400,0.8,0.9,2161,167,1994
5000,1823,2871,0.09999999999999992,192,269,0.10000000000000007,1631,2602,0.09999999999999998,401,0.0,0.1,8759,846,7913
5000,895,658,0.3000000000000002,88,70,0.3,807,588,0.3000000000000003,402,0.0,0.3,9616,980,8636
5000,1819,491,0.5,172,47,0.5,1647,444,0.5,403,0.0,0.5,8780,885,7895
5000,9065,36,0.6999999999999998,899,3,0.6999999999999998,8166,33,0.6999999999999997,404,0.0,0.7,1422,136,1286
1102,2598,0,0.0,257,0,0.0,2341,0,0.0,405,0.0,0.9,64,11,53
5000,3091,1927,0.12702004522227406,316,187,0.14136924559565756,2775,1740,0.12547791851547935,406,0.8,0.1,7200,701,6499
5000,2987,1832,0.136943248420341,325,211,0.12650219381864278,2662,1621,0.13830232462080883,407,0.8,0.3,7483,765,6718
5000,2839,1787,0.14731298750108107,290,184,0.14782928801787348,2549,1603,0.14725372406060083,408,0.8,0.5,7492,781,6711
5000,3467,1863,0.14980715050801982,365,175,0.147374599945636,3102,1688,0.15005934028788778,409,0.8,0.7,7064,687,6377
5000,5195,1390,0.18060738013610086,570,136,0.2014422767402099,4625,1254,0.17834777412480993,410,0.8,0.9,5354,552,4802
5000,2453,3138,0.09999999999999988,234,321,0.10000000000000009,2219,2817,0.0999999999999999,411,0.0,0.1,8093,841,7252
5000,874,670,0.30000000000000043,85,76,0.30000000000000004,789,594,0.30000000000000016,412,0.0,0.3,9717,973,8744
5000,1692,575,0.5,189,63,0.5,1503,512,0.5,413,0.0,0.5,8851,902,7949
1163,2727,0,0.0,299,0,0.0,2428,0,0.0,414,0.0,0.7,82,4,78
1160,2607,0,0.0,282,0,0.0,2325,0,0.0,415,0.0,0.9,132,12,120
5000,2714,1835,0.12077398490157344,254,192,0.12828926702060858,2460,1643,0.11989575351578233,416,0.8,0.1,7675,757,6918
5000,3219,1998,0.13905657934820206,297,202,0.1373584811557302,2922,1796,0.13924756812040656,417,0.8,0.3,7280,740,6540
5000,7025,950,0.19096039948613389,799,95,0.18793630832082664,6226,855,0.19129640961561242,418,0.8,0.5,3401,295,3106
5000,7913,811,0.1923971326357307,831,70,0.14166659044658347,7082,741,0.19718949154698612,419,0.8,0.7,2601,238,2363
605,1684,0,0.0,146,0,0.0,1538,0,0.0,420,0.8,0.9,41,7,34
5000,1904,2956,0.09999999999999999,173,281,0.10000000000000006,1731,2675,0.09999999999999996,421,0.0,0.1,8774,877,7897
5000,946,664,0.3000000000000003,103,77,0.30000000000000004,843,587,0.30000000000000027,422,0.0,0.3,9498,948,8550
5000,2989,769,0.5,291,59,0.5,2698,710,0.5,423,0.0,0.5,7539,738,6801
3423,6694,0,0.0,621,0,0.0,6073,0,0.0,424,0.0,0.7,708,73,635
2643,5468,0,0.0,542,0,0.0,4926,0,0.0,425,0.0,0.9,254,27,227
5000,5446,1496,0.1770331753081006,557,156,0.17802339816151175,4889,1340,0.17691789563262875,426,0.8,0.1,5260,504,4756
5000,3894,1684,0.1625818820382637,379,172,0.1535114868527707,3515,1512,0.16361369947999965,427,0.8,0.3,6524,666,5858
5000,3355,1844,0.14525860920332173,338,154,0.1407299629702578,3017,1690,0.14567127874171917,428,0.8,0.5,7008,663,6345
5000,3537,1693,0.15696281477603058,359,178,0.13761930467528255,3178,1515,0.1592355176129501,429,0.8,0.7,6911,704,6207
561,1569,0,0.0,157,0,0.0,1412,0,0.0,430,0.8,0.9,41,4,37
5000,2187,2999,0.09999999999999992,203,315,0.10000000000000006,1984,2684,0.09999999999999992,431,0.0,0.1,8296,833,7463
5000,949,596,0.3000000000000002,103,63,0.3000000000000001,846,533,0.3000000000000001,432,0.0,0.3,9488,908,8580
5000,2148,673,0.5,206,61,0.5,1942,612,0.5,433,0.0,0.5,8273,791,7482
3127,6361,0,0.0,650,0,0.0,5711,0,0.0,434,0.0,0.7,228,23,205
2071,4417,0,0.0,415,0,0.0,4002,0,0.0,435,0.0,0.9,231,37,194
5000,2603,1928,0.12018583954200462,244,182,0.13328412974097822,2359,1746,0.11882049657739226,436,0.8,0.1,7932,802,7130
5000,2695,1849,0.12561741175371427,234,162,0.12668498938614542,2461,1687,0.12551489392534804,437,0.8,0.3,7654,778,6876
5000,2993,1714,0.14961046160974104,296,163,0.1731946878788697,2697,1551,0.14713191300763404,438,0.8,0.5,7495,764,6731
5000,7191,934,0.17560443228826442,729,102,0.14296127159201766,6462,832,0.17960635823900617,439,0.8,0.7,3237,294,2943
1607,3640,0,0.0,398,0,0.0,3242,0,0.0,440,0.8,0.9,105,11,94
5000,1886,2890,0.1,203,274,0.10000000000000002,1683,2616,0.09999999999999995,441,0.0,0.1,8416,846,7570
5000,949,707,0.3000000000000002,127,56,0.3,822,651,0.3000000000000003,442,0.0,0.3,9548,896,8652
5000,1391,513,0.5,125,47,0.5,1266,466,0.5,443,0.0,0.5,8894,918,7976
5000,9847,9,0.7000000000000001,976,2,0.7,8871,7,0.7000000000000001,444,0.0,0.7,646,55,591
703,1851,0,0.0,174,0,0.0,1677,0,0.0,445,0.0,0.9,40,5,35
5000,3524,2127,0.12723585800385478,333,221,0.12315961185388113,3191,1906,0.12770849724789685,446,0.8,0.1,6897,690,6207
5000,2921,1669,0.13673736231367553,252,147,0.16173205019611636,2669,1522,0.1343232893053189,447,0.8,0.3,7534,735,6799
5000,3799,1645,0.17650371356747274,390,171,0.20121277724050216,3409,1474,0.1736371939690413,448,0.8,0.5,6701,695,6006
5000,7999,685,0.20424960638482675,794,65,0.20452543986994423,7205,620,0.2042206883581612,449,0.8,0.7,2269,217,2052
5000,7431,850,0.18114219567883635,740,64,0.14816103752316154,6691,786,0.18382768438362415,450,0.8,0.9,2949,240,2709
5000,2070,2879,0.09999999999999991,206,323,0.10000000000000002,1864,2556,0.10000000000000009,451,0.0,0.1,8151,825,7326
5000,963,703,0.30000000000000043,98,82,0.30000000000000004,865,621,0.3000000000000003,452,0.0,0.3,9643,985,8658
5000,1870,768,0.5,163,66,0.5,1707,702,0.5,453,0.0,0.5,8554,897,7657
1673,3685,0,0.0,363,0,0.0,3322,0,0.0,454,0.0,0.7,154,14,140
1712,3699,0,0.0,385,0,0.0,3314,0,0.0,455,0.0,0.9,167,19,148
5000,3183,1761,0.14691829789016433,305,179,0.16320871290365213,2878,1582,0.14507507141265846,456,0.8,0.1,7195,729,6466
5000,3318,1822,0.13293284496848126,356,180,0.14792676580605327,2962,1642,0.13128917520553185,457,0.8,0.3,7270,713,6557
5000,4444,1654,0.14733505963765955,442,169,0.14464314159334496,4002,1485,0.14764141260027855,458,0.8,0.5,5957,590,5367
5000,5902,1399,0.17109924775475344,610,124,0.12825740084069132,5292,1275,0.17526582737619947,459,0.8,0.7,4600,411,4189
1252,2921,0,0.0,272,0,0.0,2649,0,0.0,460,0.8,0.9,78,11,67
5000,1642,2660,0.09999999999999998,175,246,0.10000000000000003,1467,2414,0.10000000000000009,461,0.0,0.1,8833,850,7983
5000,913,678,0.30000000000000027,87,74,0.30000000000000004,826,604,0.3000000000000004,462,0.0,0.3,9608,1003,8605
5000,1578,474,0.5,158,43,0.5,1420,431,0.5,463,0.0,0.5,8839,915,7924
5000,9512,59,0.7000000000000003,964,4,0.7,8548,55,0.7000000000000002,464,0.0,0.7,826,72,754
902,2198,0,0.0,224,0,0.0,1974,0,0.0,465,0.0,0.9,87,13,74
5000,2947,1873,0.13793053130402735,318,213,0.1300344552387201,2629,1660,0.13894370250999746,466,0.8,0.1,7593,789,6804
5000,4768,1760,0.15684430678501393,455,207,0.15431856853904072,4313,1553,0.1571809634604269,467,0.8,0.3,5813,576,5237
5000,5712,1291,0.20499419106864125,544,126,0.2004548669120109,5168,1165,0.20548513943236257,468,0.8,0.5,4663,495,4168
5000,4658,1524,0.18230253075679048,441,143,0.18302093599296973,4217,1381,0.18222814122111078,469,0.8,0.7,5878,584,5294
5000,6720,1179,0.17846605143738922,729,102,0.22915754865105797,5991,1077,0.1736651854060111,470,0.8,0.9,3768,356,3412
5000,1813,2918,0.09999999999999995,189,317,0.10000000000000007,1624,2601,0.09999999999999996,471,0.0,0.1,8641,874,7767
5000,1010,683,0.3000000000000003,106,49,0.3000000000000002,904,634,0.3000000000000003,472,0.0,0.3,9622,929,8693
5000,2484,690,0.5,256,73,0.5,2228,617,0.5,473,0.0,0.5,7838,778,7060
4293,8366,0,0.0,804,0,0.0,7562,0,0.0,474,0.0,0.7,682,71,611
4577,9622,0,0.0,953,0,0.0,8669,0,0.0,475,0.0,0.9,296,46,250
5000,2920,1864,0.12347554496670742,297,174,0.13469322198394318,2623,1690,0.12232058887144172,476,0.8,0.1,7580,751,6829
5000,2993,1874,0.13854341234282508,295,183,0.15076392689238097,2698,1691,0.13722090840280807,477,0.8,0.3,7514,755,6759
5000,3113,1847,0.1455077758901052,314,161,0.1596580394961875,2799,1686,0.14415653482214588,478,0.8,0.5,7420,764,6656
5000,5429,1514,0.16508135482346556,529,151,0.15234125676306565,4900,1363,0.16649276700770646,479,0.8,0.7,4977,497,4480
5000,8093,846,0.22752267023900904,877,63,0.24257563739436985,7216,783,0.22631151196214094,480,0.8,0.9,2584,202,2382
5000,1834,2817,0.0999999999999999,184,272,0.10000000000000009,1650,2545,0.10000000000000007,481,0.0,0.1,8518,869,7649
5000,897,649,0.30000000000000027,89,54,0.3,808,595,0.3000000000000002,482,0.0,0.3,9431,936,8495
5000,1362,530,0.5,130,66,0.5,1232,464,0.5,483,0.0,0.5,9151,934,8217
1858,4027,0,0.0,421,0,0.0,3606,0,0.0,484,0.0,0.7,179,12,167
1107,2648,0,0.0,264,0,0.0,2384,0,0.0,485,0.0,0.9,42,2,40
5000,2973,1923,0.13884632986459608,251,206,0.14413916612300592,2722,1717,0.13821131281786775,486,0.8,0.1,7536,716,6820
5000,2989,1887,0.12983842703155912,318,174,0.11541273129092132,2671,1713,0.13130373412955737,487,0.8,0.3,7421,711,6710
5000,2638,1792,0.131822687163726,231,188,0.12938711919105567,2407,1604,0.13210815273658263,488,0.8,0.5,7769,806,6963
5000,2407,1700,0.1316376914133945,201,159,0.17549557345150024,2206,1541,0.12711244595975477,489,0.8,0.7,8008,841,7167
5000,5759,1432,0.1908362306040185,561,170,0.17601349527199517,5198,1262,0.19283295406395828,490,0.8,0.9,4848,497,4351
5000,2041,3094,0.09999999999999995,219,303,0.10000000000000009,1822,2791,0.09999999999999996,491,0.0,0.1,8466,832,7634
5000,918,654,0.3000000000000004,77,64,0.3000000000000001,841,590,0.3000000000000003,492,0.0,0.3,9428,909,8519
5000,1749,564,0.5,203,49,0.5,1546,515,0.5,493,0.0,0.5,8670,795,7875
2746,5795,0,0.0,593,0,0.0,5202,0,0.0,494,0.0,0.7,229,20,209
1150,2633,0,0.0,284,0,0.0,2349,0,0.0,495,0.0,0.9,70,4,66
5000,3370,1838,0.12946945872483262,362,168,0.13340661518207023,3008,1670,0.12907338550039194,496,0.8,0.1,7185,697,6488
5000,2250,1851,0.1219264074381141,247,178,0.13716747333416535,2003,1673,0.12030482361892876,497,0.8,0.3,8108,843,7265
5000,3437,1859,0.14406397763922588,379,187,0.14900521207823444,3058,1672,0.14351133957696827,498,0.8,0.5,7025,714,6311
5000,7221,1019,0.20700839379877226,720,121,0.22856326621653517,6501,898,0.2041040067580714,499,0.8,0.7,3388,358,3030
5000,9578,247,0.2546834748049302,962,19,0.5121583766686895,8616,228,0.23322723298295026,500,0.8,0.9,811,59,752
